tutuh	lop off, trim.
tutuk	1 tap, knock on. 2 strike with o.'s fingers (in martial arts).
tutukan	a knock, a tap.
tutul	1 pockmarked. 2 spotted, stained.
tutup	1 closed, shut. 2 cover, lid. 3 complete, full.
tutupan	1 cover, lid. 2 place where people are locked up (prison, etc.).
tutur	speech, talk.
tuturan	1. 1) story, narrative, discourse. 2) information, announcement. 2. lowest part of thatched roof.
tuyul	k.o. spirit that obtains wealth for its human master.
tv	(televisi) television.
tvri	(televisi republik indonesia) television service of the republic of indonesia.
twedehan	/twedehans/ (coll.) secondhand, used.
typis	/tipis/ typical.
u	u, the 21st. letter of the the alphabet.
ua	/uak/ 1. 1) (coll.) term of address for (java or sunda) men and women of o.'s parent's age. 2) (sunda) uncle or aunt, term of address for o.'s parents' elder siblings. 3) (china) term of address and reference for o.'s elder aunt. 2. see kuak 2.
uang	1 money. uang-kontan cash. uang-receh small change. uang-saku pocket money. uang-sogok/suap bribe. 2 coin.
uap	1. 1) steam, vapor. 2) fume. 2. see kuap.
uar	announcement, proclamation.
ub.	(untuk beliau) on behalf of him (used when signing on behalf of a higher authority).
uba	vessel for sago meal.
ubah	difference.
ubal	see ubel.
uban	gray hair.
ubanan	gray headed
ubar	1. 1) k.o. tree the bark of which is used for dye or paint. 2) dye or paint derived from such a tree. 2. unroll s.t. and spread it out.
ubat	see obat.
ubek	/ubek, ube/ stir vigorously by hand.
ubekan	s.t. stirred or mixed up with the hands.
ubel	/ubel-ubel/ 1 anything wrapped around part of the body. 2 head-wrap, turban.
uber	go after, pursue.
uber-uberan	chase e.o.
ubi	1 edible tuber. ubi-jalar/jawa sweet potato. ubi-kayu/kasbi/kaspe cassava. 2 sweet potato.
ubin	floortile.
ubrak-abrik	see obrak-obrik.
ubub	/ububan/ a pair of brllows.
ubudiah	(islam) matters pertaining to prayer ritual.
ubun	loom.
ubun-ubun	1. 1) fontanel. 2) crown of head. 2. (lit.) nun.
ubur-ubur	jellyfish.
ucap	saying, word.
ucapan	1 utterance, expression. 2 statement, communication. 3 pronounciation.
ucek	(jakarta, java) rub with o.'s hands.
ucus	see usus.
uda	1. (m) older brother or male cousin. 2. /udah/ (jakarta) see sudah.
udak	chase after, pursue.
udak-udak	stir.
udal-adul	rumple hair, string, or other hairlike material.
udan	k.o. batik pattern.
udang	shrimp. udang-galah 1 k.o. large peawn. 2 (coll.) lobster. udang-geragau/gerangau k.o. small shrimp used for shrimp.
udang-udangan	1 various k.o. shrimps. 2 imitation shrimp.
udap-udapan	salad made of various k.o. vegetables, often bought as a snack on the street.
udar	(java) reel.
udara	1 air. 2 atmosphere. 3 sky, air space. 4 weather.
ude	/udeh/ (jaakrta) see sudah.
udek	(jakarta, java) stir.
udel	(java) navel.
udeng	(java, jakarta) headcloth (for men).
udet	(java) belt.
udi	(m) unfortune.
udik	1 upper course of a river. 2 interior, inland country. 3 (jakarta) backward, countrified.
udikan	s.o. raised in a rural area.
udu	see wudhu.
uduh	see odoh.
uduk	see nasi.
udur	see uzur.
udut	smoke.
udutan	pipe to smoke.
udzur	see uzur.
uek	see uik.
ufuk	horizon.
ugahari	(lit.) moderate, frugal, temperate.
ugal-ugalan	1 mischievous, naughty. 2 reckless, inconsiderate.
ugama	see agama.
ugem	(java) property.
ugeran	(java) rule, norm.
ugm	((universitas gadjah mada) gadjah mada university in yogyakarta.
ugut	intimidation, threat.
uhu	sound of s.o. crying and sobbing.
ui	(universitas indonesia) university indonesia in jakarta.
uih	see with.
uik	squeal (of pigs).
uir-uir	k.o. locust.
uja	see oja.
ujan	see hujan.
ujang	(in some regions only) term of familiar address for boys.
ujar	1 statement. 2 (ling.) utterance.
ujaran	statement, pronouncement.
ujat	see hujat.
uji	test, experiment.
ujian	examination.
ujud	see wujud.
ujung	1 tip, point, top. 2 end. ujung-pangkal lower and upper ends.
ujur	see uzur.
ujut	see wujud.
ukhrowi	(islam) eschatological matters.
ukhuwah	(islam) 1 fraternity (of believers). 2 association, organization.
ukir	carved, engraved.
ukiran	carved object.
ukon	coin worth 1/2 rupiah.
ukup	1 incense, perfume. 2 scent.
ukupan	1 perfume, scent. 2 censer.
ukur	1 measure. 2 measuring tape.
ukuran	1 measurement, measure. 2 size, dimension. 3 format. 4 norm, criterion, standard. 5 measuring stick.
ulah	manner, way, act.
ulai	see kulai.
ulak	see uleg.
ulak-ulak	whirl, bubble (water, etc.). (anat.) ulak-ulak-pinggang pelvis, hollow above the hips.
ulam	raw vegetable side dish with rice.
ulam-ulam	concubine.
ulang	frequent, repeatedly. ulang-alik go back and forth. ulang-alik shuttle (aircrafts). ulang-aling to and fro. ulang-tahun birthday, anniversary.
ulangan	1 s.t. that is done again, repetition. 2 test. 3 refrain.
ulap-ulap	(java) k.o. hand gesture in traditional dances.
ular	snake. ular-patola (ambon) python. ular-sanca/sawa python. ular-sendok/tedung cobra.
ular-ularan	1. (m) cramp. 2. 1) toy snake. 2) all k.o. snakes.
ulas	1. 1) wrapper, covering. 2) (coll.) pillowcase 2. 1) section of citrus fruit. 2) clove (of garlic, shallot, etc.).
ulasan	1. 1) envelope, cover. 2) daubing (in painting). 2. 1) review, commentary. 2) remark.
ulat	1 caterpillar. ulat-sutera silkworm. 2 maggot, larva.
ulayah	see wilayah.
uleg	/ulek/ pestle.
ulegan	/ulekan/ 1 pestle. 2 s.t. crushed with a pestle.
ulem	(java) invitation.
uleman	invitation.
uler	(java) worm.
ulet	1. tough, persevering. 2. see ulat.
uli	1. knead (dough). 2. 1) glutinous rice. 2) k.o. sweetmeat made with cooked glutinous rice, sugar and coconut.
ulia	see aulia.
ulik	1. investigate. 2. see ulit.
ulin	k.o. very hard wood.
ulir	thread of a screw.
uliran	s.t. with a thread (screw, lightbulb, etc.).
ulit	sleep with lullabies.
ulos	traditional batak cloth worn covering shoulder.
ultah	(ulang tahun) anniversary, birthday.
ultah.	(ulang tahun) anniversary, birthday.
ultimatum	ultimatum.
ultra	ultra-, extremely.
ulu	see hulu 2.
ulu-ulu	(java) official responsible for irrigation.
ulubalang	see hulubalang.
uluhati	pit of the stomach, solar plexus.
uluk	(java) uluk-salam greetings.
ulung	1 capable, skilled, experienced. 2 excelent, superior.
ulup	(naut.) hawser.
ulur	1. 1) pay out. 2) extend. 3) make concessions. 2. (lit.) bondsman.
uluran	uluran
um	see ummi 2.
uma	see huma.
umak-umik	(java) silently mouth words.
umang-umang	1 hermit crab. 2 o. who likes to dress in fine, but borrowed, clothes.
umaro	(islam) gvt.
umat	the members of a religious community.
umbai	tassle, fringe. umbai-cacing (anat.) appendix.
umban	sling.
umbang	float.
umbang-ambing	see ombang-ambing.
umbar	free s.t., let loose.
umbi	tuber, root.
umbi-umbian	1 all k.o. tubers. 2 belonging to the tuber group.
umbuk	1 swindle. 2 persuade. 3 appease, talk in a friendly way to s.o.
umbul	1. bubble up, rise rapidly. 2 (java) children's game played with picture cards which are tossed in the air.
umbul-umbul	1 (java, bali) banner. 2 (java, bali) pennants or palm fronds decorating doorways on feast days. 3 tassle (of hat etc.).
umbun	see ubun.
umbut	edible topmost and innermost frond of a palm, palm-cabbage.
ummat	see umat.
ummi	1. illiterate. 2. term of address for mother in families of arab descent.
umpak	1 foot, step. 2 pedestal, fundament, base.
umpak-umpakan	praise, flattery.
umpama	1 example. 2 like, as.
umpan	bait, food. umpan-pancing fish bait. umpan-balik feed back. umpan-keris/pisau doomed to death (at the end of weapon).
umpat	curse, swearword.
umpatan	curse, verbal abuse.
umpel-umpelan	(java) crowded.
umpet	(coll.) go hide, lie low.
umpet-umpetan	1 in secret, on the sly. 2 hide-and-seek.
umpil	1 lift, raise. 2 row, scull.
umpuk	heap, pile, stack.
umroh	(islam) perform a pilgrimage to mecca (us. not during the hajj season) omitting some of the ritual (e.g. the visit to the fields of arafah).
umuk	(java) brag, boast.
umum	1 general, common. 2 the public. umum-nya us., by and large.
umur	1 age. 2 lifespan. 3 at the age of.
unam	k.o. sea mollusc.
uncang	bag (for traveling, etc.).
uncang-uncit	restless, unsettled.
unclik	(java, jakarta) walk without looking left or right.
uncue	/uncui/ see huncue.
unda-unda	being in tow o. behind the other.
undak	(java) 1 step. 2 terrace.
undak-undakan	stairs, steps.
undan	1. level. 2. pelican.
undang	invite, summon.
undang-undang	law, ordinance, act.
undangan	undangan
undat	undat
undi	a lot (in a drawing).
undian	1 lottery. 2 lottery prize.
unduh	(java) pick (fruit from tree).
undung-undung	veil over the head.
undur	1 go back, withdraw. 2 be out of circulation or publicity, out of trend.
undur-undur	(java) ant-lion.
uneg-uneg	/unek-unek/ (java) grudges.
ungap	gasp for breath.
unggah-ungguh	(java) etiquette.
unggang-unggit	go up and down (seesaw, rocking chair, etc.).
unggas	bird, fowl, esp. as scientific term.
unggat-unggit	see unggang-unggit
unggis	nibble, gnaw at.
ungguk	see onggok.
unggul	superior, excellent.
unggulan	s.o. or s.t. considered superior.
unggun	1 woodpile. 2 campfire.
unggunan	1 campfire. 2 heap, pile.
unggut	tug a rope, play tug of war.
ungka	k.o. gibbon.
ungkai	come undone, come off (of clothing).
ungkak	(naut.) post for fastening the hawser.
ungkang-ungkang	see ongkang-ongkang.
ungkang-ungkit	see unggang-unggit.
ungkap	1 express (with words, face or gestures). 2 reveal, uncover.
ungkapan	1 expression. 2 idiom.
ungkat-ungkit	repeated oscillating motions.
ungkil	pry up.
ungkir	see mungkir.
ungkit-ungkit	bob up and down.
ungku	see engku.
ungsi	evacuate.
ungu	purple.
uni	1. (m) older sister. 2. union, esp. in names of political entities. 3. see huni.
unifikasi	unification.
uniform	1 standardized. 2 a uniform.
uniformisasi	uniformization.
uniformitas	uniformity.
unik	unique.
unit	/yunit, unit/ unit.
universal	/universil/ universal.
universitas	university.
universiter	concering universities.
universitet	see universitas.
unjam	see hunjam.
unjuan	see unjukan.
unjuk	show s.t.
unjukan	/unju'an/ (java) drinks offered to a respected person.
unjung	see kunjung 1.
unjur	extended, stretched out (of legs).
unjuran	foot of the bed.
unjut	small bag or bundle tied at the end with knots.
unsur	element, substance. unsur-kimia chemical element.
unsuriah	/unsuri/ 1 elementary, elemental. 2 elemental.
unta	camel. bururng-unta ostrich.
untai	1 string, lace. 2 numerical classifier for stringlike objects (garlands, rosaries, etc.).
untaian	1 series. 2 string, chain, garland. 3 strophe. 4 (ling.) string.
untal	1. 1) pellet. 2) pill, tablet. 2. 1) swallow a large quantity. 2) (vulg.) eat.
untang-anting	swinging to and fro.
until	1. dangle, hang down. 2. see untal 1.
unting	1 strand, skein. 2 numeral classifier for hanging objects, tied together (such as corn, etc.).
unting-unting	plumb.
untingan	untingan
untir	twist.
untuk	1 for, on behalf of. 2 to, in order to.
untung	1 luck, fortune. 2 good luck, have good luck. 3 advantage, profit. 4 gain profit.
untung-untung	it is lucky.
untung-untungan	undertake s.t. hoping for the best.
untut	elephantiasis.
unyai	(m) softly, gently.
up.	(untuk perhatian) for the attention of (used in letter addresses).
upacara	1 ceremony, ritual. upacara-ngruwet (java) ritual to ward off evil. upacara-pelantikan inaugural ceremony. 2 regalia.
upah	1 pay, wages. 2 fee, commission.
upahan	1 wages. 2 hired worker.
upam	polish, burnish.
upama	see umpama.
upaman	upaman
upas	1. k.o. toxin derived from the sap of certain plants. 2. 1) messenger, ettendant. 2) policeman.
upat	see umpat.
upaya	1 eforts (to atttain a certain aim). 2 means.
upet	(java) wick, fuse.
upeti	1 tribute paid by subjects. 2 (coll.) bribe to higher-ranking official.
upgrade	/apgred/ upgrade.
upgrading	/apgreding/ upgrading.
upih	(biol.) leaf-sheath.
upik	(m) term of address for a little girl.
upil	1 dried snot. 2 scab on a wound.
upleg	(java, jakarta) be extremely busy.
upleg-uplegan	rush about very busy.
urah	1. (m) demolish, tear down. 2.relate.
urai	apart, asunder.
urai-uraian	strands, pieces.
uraian	uraian
urakan	rowdy, unconventional.
urang-aring	k.o. herb used for the hair.
uranium	uranium.
urap	1. ointment, salve. 2. grated coconut with spices.
urap-urap	salad of mixed vegetables (cabbage, beansprouts, stringbeans) with coconut.
urapan	urapan
urat	1 tendon. urat-keting (anat.) achilles' tendon. 2 nerve. urat-saraf nerve. 3 vein. urat-nadi artery.
urban	o. who has moved to the city from the country.
urbanisasi	migration to the city.
urea	urea-based fertilizer.
uret	(java) larva, white grub.
urgen	urgent.
urgensi	urgency.
uri	see ori.
urik	(java) pick, pluck.
urine	(med.) urine.
uring	(m) groove between nose and upper lip.
uring-uringan	(java) grumble angrily, be angry.
uris	dash. uris-datar dash. uris-miring slant, virgule.
uro-uro	chant java poetry.
urolog	urologist.
urologi	urologi
urss	(uni republik sovyet sosialis) ussr.
uruk	1 bury. 2 fill (with soil, sand, etc.).
urukan	mound.
urunan	(java) 1 contribution. 2 contribute.
urung	1 failed, unsuccessful. 2 not take place, be canceled.
urup	1 barter, exchange. 2 change money.
urupan	1 the thing exchanged. 2 change (money).
urus-urus	purgative, laxative.
urusan	urusan
urut	1. massage. 2. (coll.) in a series, well organized.
urut-urutan	1 consecutively, in sequence. 2 (sport) seeded.
urutan	urutan
us	(uni sovyet) soviet union.
usah	it is not necessary, no need to.
usaha	1 effort, exertion. 2 labor, work, trade.
usahawan	1 entrepreneur. 2 industrialist.
usahkan	1 let alone, not to mention. 2 instead of.
usai	1 finished, ready. 2 dispersed.
usak	decrease, lessen.
usali	/usalli/ 1 (islam) firm intention to pray. 2 (islam) word uttered upon beginning a prayer. 3 intention.
usam	1. 1) dregs. 2) waste remaining after the oil has been pressed from coconut meat. 2. vague, dull (of color).
usang	1 worn out, decrepit. 2 obsolete. 3 dry, barren, withered.
usap	1 wipe. 2 caress, stroke.
usapan	stroke, caress.
usar	k.o. grass used to make fragrant oil.
usdek	the five guiding principles of sukarno's gvt. after 1960: the 1945 constitution; sosialism a la indonesia; guided democracy; guided economy; national identity.
usdekisme	politics on the basis of usdek.
ushuludin	see usuludin.
usia	age.
usik	1tease. 2 touch on. 3 (phys.) perturb.
usikan	1 annoyance, disturbance. 2 meddling, criticism. 3 (phys.) perturbance.
usil	annoying, bothering others doing s.t. not desired.
usilan	annoyance, bothering.
usiran	fugitive.
uskup	(rel.) bishop. uskup-agung archbishop.
usolli	see usali.
ustad	/ustadz, ustaz/ (islam) 1 term of address for islam teacher. 2 (lit.) lord, master.
ustadah	/ustadzah, ustazah/ (islam) term of address for a female islam teacher.
ustrali	(coll.) australia.
ustria	(coll.) austria.
usuk	(java) rafter.
usul	1. 1) proposal, suggestion. 2) motion. 2. nature, characteristic.
usulan	proposal, suggestion.
usuludin	(islam) o. of the branches of theology pertaining to law and philosophy.
usung	carry (together with others) on the shoulders.
usungan	stretcher, litter.
usur	see uzur.
usus	intestines. usus-besar large intestine. usus-buntu appendix. usus-duabelas jari duodenum. usus-halus small intestine.
usut	investigate.
utak-atik	/utak-utik/ tinker with s.t.
utama	1 prominent, eminent. 2 principal, prime.
utan	see hutan.
utang	see hutang.
utar-utar	small round shield.
utara	1. north. 2. explain.
utarid	utarid
utas	1. skilled, capable. 2. 1) cord, string, strand. 2 numeral classifier for long, thin, and supple things (such as ropes, straw, etc.).
utik-utik	touch with a finger, poke into s.t. to examine it.
utilitas	utility, usefulness.
utk.	(untuk) for, in order to.
utopi	/utopia/ utopia.
utopis	utopian
utuh	whole, intact.
utuhan	(math.) integer.
utus	delegate.
utusan	1 messenger. 2 envoy. 3 delegate.
uu	(undang-undang) law, decree.
uud	(undang-undang dasar) the constitution.
uuds	(undang-undang dasar sementara) provisional constitution.
uwar	see uar.
uyel-uyel	(java) justle.
uzur	enfeebled (from old age or illness).
v	/fe/ v, the 22d letter of the alphabet.
vademecum	comprehensive handbook (for medical students, etc.).
vagina	/fagina, fakhina/ (med.) vagina.
vak	/fak/ 1 subject of study. 2 discipline, field of study.
vakansi	vacation.
vakature	/fakatur/ vacancy.
vaksin	(med.0 vaccine.
vaksinasi	vaccination.
vaksinator	o. who vaccinates.
vakum	1. vacuum. 2. (med.) suction device to abort the fetus.
valensi	valence.
validasi	validation.
validitas	validity.
valuta	currency. valuta-asing foreign currency.
vandalisme	vandalism.
vandel	souvenir pennant.
varan	monitor lizard. varan-komodo komodo dragon.
varia	variety, varied.
variabel	1 subject to change. 2 statistical variable.
variabilitas	variability.
varian	variant.
variasi	variation.
varietas	variety, kind (of plants, etc.). varietas-unggul high-yielding variety.
varises	(med.) varicose veins.
varitas	see varietas.
varuna	see baruna.
vas	vase.
vaselin	vaseline.
vb	(vestiging besluit) permission to occupy a company house (in the colonial period).
veem	wharfage and transport business.
vegetaris	vegetarian.
vegetarisme	vegetarianism.
vektor	(math.) vector.
velar	(ling.) velar.
velbak	see pelbak.
veldbed	/felbet/ see felbet.
veldfles	/pelples, felfles/ water-bottle, canteen.
velg	see pelek.
ventilasi	ventilation.
ventilator	ventilator.
ver-	see also entries with per-.
verba	(ling.) verb.
verbal	1 verbal, oral. 2 (ling.) verbal.
verdah	suspected of having a disease.
verdieping	see perdiping.
vergunning	/verkhening/ see perkening.
verifikasi	verification.
verkeneng	/verkening/ reconnaisance, reconoitering.
vermaak	/permak/ see permak.
vernis	see pernis.
verpleegster	see verplehster.
verpleger	/verpleher/ male hospital attendant.
verplehster	nurse.
verpolitisir	politicize.
versi	version.
versneleng	/versneling/see persneling.
versus	versus.
vertikal	vertical.
vet	(coll.) grease, esp. engine lubricators.
veter	shoelaces.
veteran	veteran, esp. of the revolution of 1945.
veto	veto.
vetsin	monosodium glutamate.
via	via.
viaduk	/viadukt/ 1 viaduct. 2 fly-over, overpass.
vibrasi	vibration.
vide	refer to, see.
video	1 video cassette. 2 video performance.
vietsel	(vietnam selatan) south vietnam.
vietut	(vietnam utara) north vietnam.
vihara	see wihara.
vikariat	(rel.) vicariate.
vikaris-jenderal	(rel.) vicar general.
vila	/villa/ hous in country, us. for weekend use.
vilt	felt.
vinyet	vignette.
violet	violet in color.
violis	violinist.
vip	/fip/ s.t. reserved for vips.
virgo	(zodiac) virgo.
virulen	virulent.
virulensi	virulence.
virus	virus.
visa	visa.
visi	point of view, perspective.
visual	visual.
visualisasi	visualization.
visuil	see visual.
visum	1 visa. 2 any written document from relevant authorities stating that a certain matter has been considered and approved of.
vital	vital.
vitalitas	vitality.
vitrage	/fitrasye/ lace curtain.
vivere-periculoso	live dangerously (sukarno-era slogan).
vla	k.o. rich custrad us. used as a topping for cakes and puddings.
vlex	see plek.
voc	/fe o se/ (verenigde oostindische compagnie) dutch e. india company (a trading company that held a monopoly in indonesia 1602-1799).
voile	/foal/ k.o. cloth, voile.
vokabuler	1 vocabulary, wordlist. 2 o.'s verbal knowledge.
vokal	(ling.0 vowel.
vokalis	vocalist.
vol	se pol1.
vol.	(volume) volume.
voli	volleyball.
volt	volt.
volta-hulu	upper volta.
voltase	voltage.
volume	1 volume, amount of liquid content. 2 volume, loudness.
volunter	a volunteer.
vonis	verdict.
votum	vote.
vrij	/fre, pre/ see perai 1.
vs	/fe es/ (versus) versus.
vulakanik	/vulakanis/ volcanic.
vulgair	/fulkher/ vulgar.
vulgarisasi	vulgarization.
vulkan	vulkan
vulkanisasi	vulcanization.
vulkanisir	1 retread. 2 vilcanize.
vulkanisme	(geol.) volcanic activity.
vulkanolog	expert in vulcanology.
vulkanologi	study of volcanic activity.
vulpen	see pulpen.
vuring	lining of clothing.
vutw	(varitas unggul tahan wereng) a high-yielding pest-proof variety of rice (much used in the 1970s).
w	/we/ w. the 23d letter of the alphabet.
w.	(waktu) time (zone).
waad	/waadat/ (lit.) treaty, contract.
wabah	epidemic.
wabakdahu	/wabakdu/ (lit.) furthermore, then.
wacana	1 (lit.) word, expression. 2 (lit.) discourse.
wadag	body, bodily.
wadah	1 container. 2 coordinating institution, umbrella organization.
wadal	sacrifice (upon completion of a new building, to obtain magical powers, etc.).
wadam	(wanita adam) transvestite homosexual, transsexual.
wadas	stony ground.
wadat	1 celibacy. 2 live a celibate life.
wadduh	(java) see aduh.
wader	k.o. small freshwater fish.
wadi	wadi, a stream in desert.
wadon	(java) female.
waduh	(java) see aduh.
waduk	1 rumen. 2 (coll.) paunch. 3 basin, reservoir.
wadul	(java) tell on s.o., be a tattletale.
wadung	ax.
wae	1 (sunda) also, even. 2 (java) only.
wafat	pass away.
wage	fourth day of the java five-day week.
wagen	/wakhen/ carriage (of typewriter).
wagon	(r.r.) coach, car.
wagub	(wakil gubernur) vice-governor.
wah	well, hey ! (exclamation of surprise or exasperation).
waha	/wahah/ oasis.
wahadah	/wahadat/ (rel.) oneness (of god).
wahai	(lit.) 1 alas ! (particle to emphasize distress). 2 oh ! (particle to draw attention).
waham	suspicious, suspicion.
wahana	1 (lit.) mode, vehicle (for conveyingthoughts, ideas, or for realizing ideals). 2vehicle (in automotive workshop names).
wahid	1 one, unique (of god). 2 alone, without peer.
wahon	see wagon.
wahyu	(rel.) divine revelation, vision from god to man.
wai	1. river (in place names in lampong, ambon, and elsewhere). 2. see wahai.
waisak	/waisyak/ see wesak.
waja	see baja 1.
wajah	countenance, face. wajah-baru newcomer.
wajan	wok.
wajar	1. 1) natural, proper. 2) genuine, without deceit. 2. (wajib belajar) compulsory education.
wajib	1 (islam) obligatory (of certain pious acts, e.g. praying at the appointed times, etc.). 2 must. 3 duty, obligation.
wajik	1 rhomboid shape. 2 (crd.) diamond. 3 k.o. cake made of sticky rice and palm sugar, cut in rhomboid shapes.
wak	see ua.
waka	(wakil kepala) deputy head.
wakaf	1. (islam) 1) property donated for religious or community use. 2) religious foundation. 2. (islam) pause in reading the koran.
wakap	see wakaf 1.
wakhen	see wagen.
wakif	(islam) o. who donates property to the islam community.
wakil	1 representative. 2 vice, deputy. 3 agent (on behalf of a firm).
waktu	1 time. 2 when. 3 while. 4 time zone.
wakuncar	(wajib kunjung pacar) (coll.) have a date with o.'s lover.
wala	(wajib latih) military training requirement for civilians (1970s).
walaah	/wala:h/ (coll.) 1 come on get serious ! (exclamation of belittlement). 2 oh no ! (exclamation expressing disapproval of a situation).
walafiat	see sehat.
walaikumsalam	(islam) and peace be to you (in reply to the greeting assalam alaikum).
walakhir	(lit.) (and) in the end, finally.
walakin	(lit.) although.
walama	(wajib latih mahasiswa) military training requirement for students (in the 1970s).
walang	(java) grasshopper, locust. walang-hati anxious, concerned. walang-sangit k.o. insect that releases a pungent smell.
walau	/walaupun/ although.
walawa	(wajib latih mahasiswa) military training requirement for students 9in the early 1970s).
waled	(java) ooze, alluvium. waled-an arrears (in payment, salary).
walet	(java) k.o. swallow.
walhasil	(lit.) with the result that...
wali	1 (islam) male relative legally responsible for a bride, us. her father. 2 guardian, proxy. 3 high civil servant. 4 religious leader.
walikota	mayor.
walimah	wedding party.
waliullah	(islam) holy person.
wallah	see walaah.
wallahi	i swear by god !.
wallahualam	1 god knows best. wallahualam-bissawab gods knows the truth. 2 heaven knows ! (i do not).
wals	/walsa/ waltz.
waluh	(java) squash, gourd, pumpkin.
waluku	(java) plow.
wamil	(wajib militer) conscription.
wamilda	(wajib militer darurat) emergency military obligation.
wampa	(wakil menteri pertama) deputy chief minister.
wan	1 term of reference or address for males of arab descent. 2 tittle for nobility in some areas.
wana	(china) an indigenous indonesian.
wang	see uang.
wangi	fragrant.
wangi-wangian	perfumery, all k.o. scents.
wangkang	ocean-going sailboat.
wangsa	dynasty.
wangsat	expression of reproach: you animal !.
wangsit	(java) divine inspiration.
wanita	woman.
wanra	(perlawanan rakyat) people's militia.
wanti-wanti	(java) repeatedly, time after time.
wantunas	see watunas.
wap	see uap 1.
wapat	see wafat.
waperdam	(wakil perdana menteri) vice-premier.
wapres	(wakil presiden) vice-president.
wara	(wanita angakatan udara) women's section of the air force and its members.
warak	(islam) observant of religious obligations, esp regarding abstinence.
warakat	see warkah.
warakawuri	(lit.) army widow.
warangan	see berangan 1.
waranggana	(java) singer in gamelan orchestra.
waras	1 having full possession of o.'s senses. 2 healthy.
warawiri	1. (lit.) hibiscus. 2. 1) back and forth. 2) fickle, unstable.
warek	(java, jakarta) satiated, full.
warembol	k.o. sweet roll.
warga	1 accredited member of an association. 2 citizen.
waria	(wanita pria) transsexual, transvestite homosexual.
waringin	(java) see beringin.
waris	heir.
warisan	legacy, inheritance.
warkah	/warkat/ (lit.) letter. warkat-pos 1 aerogram. 2 postal form for domestic mail similar to an aerogram.
warmbol	see warembol.
warna	1 color. warna-bahasa (ling.) speech level. warna-suara/nada timbre. warna-warni all k.o. colors. 2 (crd.) suit.
warni	see warna.
warok	(java) k.o. ascetic expert of martial arts, often homosexual.
warong	see warung.
warsa	(lit.) year.
warta	1 report, communication. warta-harian daily newspaper. 2 news. warta-berita news broadcast.
wartawan	journalist, correspondent.
wartawati	woman reporter or journalist.
warteg	(warung tegal) food stall with cheap food (us. with little or no meat).
waru	1. (crd.) spades. 2. see baru 2.
waruna	see baruna.
warung	small shop, stall. warung-keliling itinerant food stall. warung-kopi coffee shop. warung-nasi food stall. warung-remeng-remeng 1 dimly lit food stall. 2 food stall for assignations in a prostitution complex.
wasalam	see wassalam.
wasana	(lit.) final.
wasangka	suspicion.
waserai	dry-cleaners and laundry.
waseraian	dry-cleaned clothes.
wasiat	1 dying exhortation, last will and testament (spoken or written). 2 magic power (of an ancient heirloom).
wasilah	/wasilat/ relation, connection, bond.
wasir	see bawasir.
wasit	1 referee, umpire. 2 arbiter.
wasitah	medium, spirit.
waskita	clairvoyant, psychic.
waskom	see baskom.
waslap	washcloth, scrubbing towel.
waspada	wary, on guard.
wassalam	peace be with you ! (use to conclude letters), sincerely yours.
wassalamualaikum	(islam) and peace be with you (used to close letters and speeches). -warakhmatullahi wabarakatuh and peace be with you and god's blessing (used to close letters and speeches).
wasserij	/waserai/ see waserai.
wastafel	bathroom sink, wash basin.
waswas	/waswisu/ anxious, uneasy to the point of being suspicious.
wat	thai buddhist temple.
watak	1 nature, disposition. 2 character (of novel, etc.).
watermantel	water-cooled machine gun.
waterpas	carpenter's level.
waterpoken	(coll.) chicken pox.
waterpruf	/waterprup/ waterproof.
watt	watts.
wattase	wattage.
watunas	(wanita tuna susila) prostitute.
wau	the 25 letters of the arabic alphabet.
wauw	(coll.) wow !.
wauwau	k.o. gibbon.
wawancara	interview.
wawansantap	(lit.) friendly, informal meal or banguet.
wawasan	1 insight, perception. 2 concept. wawasan-nusantara the archipelago concept (i.e. the maritime territory of indonesia includes all the water between the islands).
way	see wai 1.
wayang	1 shadow play with leather puppets often. 2 leather puppet. 3 traditional drama performance of java and bali. wayang-golek wooden puppet show. wayang-kulit shadow play with leather puppet. wayang-orang java stage show us. with wayang themes.
wayer	electric fan.
wayuh	(java) have more than o. wife.
wazir	1 (lit.) vizier. 2 (che.) queen.
wb.	see wr. (wb.).
wc	/wese/ (water closet) toilet, restroom.
we	1. (java) gosh !. 2. see owe.
wedana	(java) district chief.
wedar	(java) disclose.
wedel	(java) dye.
wedelan	s.t. dyed.
wedung	(java) cleaver.
wegah	see ogah.
wejang	advice, instruct.
wejangan	1 advice. 2 speech containing advice.
weker	/wekker/ see beker 1.
welang	(java) see belang.
welas-asih	(java) mercy.
welasan	welasan
weling	last will and testament.
welirang	see belerang.
weluku	see waluku.
wenang	syiwa's father (in the wayang).
werak	recruiter of laborers.
werda	(mil.) a guard's call :" who is there ?"
werdha	see wisma.
werek	see werak.
werek-kontrak	(coll.) contract labor.
wereng	k.o. rice pest.
wesak	holiday marking buddha's birth, enlightenment, and death.
wesel	1. money order, draft. 2.(r.r.) railway switch.
weselbor	(tel., r.r.) switchboard.
weselpos	see poswesel.
wesi	(java) see besi.
wesio	(china) buddhist monk.
westernisasi	westernization.
wet	(coll.) law.
wetan	(java) east.
wewangian	perfurmery.
wewegombel	(java) k.o. ugly female ghost with sagging breasts.
wewenang	authority, competence.
wiara	see wihara.
wib	(waktu indonesia bagian barat) west indonesia time (zone).
wibawa	authority, power.
wicara	(ling.) speech.
widara	see bidara.
widuri	(java) k.o. shrub.
widyakarya	(lit.) university-level work-study.
widyawisata	(lit.) study tour,
wiena	see wina.
wih	(coll.) exclamation to show surprise or call attention to s.t.
wihara	buddhist monastery or nunnery.
wijaya	(lit.) victory.
wijayakusuma	see bunga.
wijen	(java) see bijen.
wiku	see biksu.
wiladah	confinement, childbirth.
wilayah	1 region, district (below the province but larger than a county in size). 2 zone. wilayah-industri industrial estate. wilayah-pinggiran peripheral area, frontier estate.
wildop	hubcap.
wilis	see burung.
wina	vienna.
windu	cycle of eight years in java calendrical reckoning.
wing	1 (mil.) decoration (for those who have flown or parachuted a certain number of times). 2 wing in air formation.
wiper	/waiper/ windshield wiper.
wira	(lit.) man, hero. wira-tamtama a low military rank.
wiracarita	/wiracerita/ (lit.) epic.
wirama	see irama.
wiraniaga	salesperson.
wiraswasta	1 entrepreneur. 2 run a private enterprise.
wiraswastawan	entrepreneur.
wirausaha	businessman.
wirawan	hero, heroic.
wirid	(islam) passage of koran,.
wiron	(java) pleats in a batik wraparound.
wiru	pleat.
wiryaan	see hal 1.
wisata	a tour.
wisatawan	tourist.
wisel	see wesel 1.
wisik	(java) inspiration.
wiski	whisky.
wisma	public building. wisma-budaya art galery. wisma-werdha/wreda (lit.) old people's home.
wisuda	graduation ceremony.
wisudawan	male graduate at commencement.
wisudawati	female graduate at commencement.
wit	(waktu indonesia bagian timur) east indonesia time (zone).
wita	(waktu indonesia bagian tengah) central indonesian time (zone).
wiyaga	(java) gamelan player.
wiyata	(lit.) education. wiyata-bhakti practice teaching.
wk(l).	(wakil) vice-, deputy, assistant.
wkt.	(waktu) time.
wmp	see wampa.
wn	(warga negara) citizen.
wna	(warga negara asing) foreign citizen, us. refering to chinese.
wni	(warga negara indoneasia) 1 (leg.) citizen of indonesia. 2 naturalized indonesian citizen, esp. of china descent.
woki-toki	walki-talki.
wol	wool.
wolanda	see belanda.
wong	1. (java) person). 2. (java) because. 3. (java) what are you talking about ! (expression of disagreement).
wortel	carrot.
wr.(wb.)	(warakhmatullahi (wabarakatuh) ) may god be merciful (and bless you) (for formal conclusions to letter and speeches).
wreda	see wisma.
wredatama	(lit.) retired person.
wts	(wanita tuna susila) prostitute.
wudhu	/wudlu, wudu/ (islam) ritual ablution before prayers.
wuduk	see nasi 1.
wujud	shape into which s.t. has been formed.
wuku	(java) o. of the 30 seven-day periods which make up the 210-day calendar cycle.
wukuf	(islam) ceremony of gathering on the field of arafah during the hajj.
wuluh	1. (zod.0 pleiades. 2. see belimbing. 3. (java) see buluh.
wungkul	(java) whole, unbroken.
wungu	(java) see ungu.
wutuh	see utuh.
wuwu	(java) see bubu.
wuwung	(java) see bubung.
x	there are not any x words in bahasa indonesia.
y	y, the 25th letter of the alphabet.
ya	1. 1) yes. 2) what? (a response to s.o.'s call). 3) ok?, will you? (particle indicating a softened command). 4) right? isn't it? (question tag word). 5) let us see now...what? how? who? etc. 6) hmm (hesitation particle). 7) as for (topic marker) 2. oh.
yad.	(yang akan datang) the future, coming.
yah	1. well.... (particle of resignation, exasperation, etc.). 2 see ayah.
yahud	(sl.) ok, excellent, great.
yahuddah	judaic.
yahudi	jew, jewish.
yahudiah	jewish.
yahut	see yahud.
yahya	1 male name. 2 (bib.) the gospel of john.
yaini	see yakni.
yais	menopause.
yaitu	that is, i.e., viz.
yak	1 (coll.) yes. 2 (sport) catch (i.e. a ball).
yakin	sure, certain, convinced.
yakis	baboon.
yakni	that is, namely, viz.
yakut	hyacinth.
yalah	see ialah.
yaman	yemen.
yang	1. 1) nominalizing particle: the o. who, the thing which, etc. 2) particle forming a specific adjective clause : "which is, who are," etc. 3) with numerals or demonstrative:the o. or the two, etc. (as opposed to others). 2. see sayang.
yapon	1 bathrobe (for women). 2 western-style women's dress.
yareh	/yarig, yareh/ coll.) have o.'s birthday.
yasan	k.o. rice field that is cultivated individually.
yasin	(islam) chapter 37 of the koran often read while s.o. is dying.
yasmin	jasmine.
yassin	see yasin.
yatim	fatherless child. yatim-piatu orphan.
yaumuddin	(islam) doomsday.
yaumulkiamah	(islam) day of judgment.
yayasan	foundation, institute.
yayi	(java) younger brother or sister.
yb.	(yang berikut) next, following.
ybl.	(yang baru lalu) last.
ybs.	(yang bersangkutan) the person concerned.
yeksi	see injeksi.
yel	yell (in demonstration, etc.).
yellowpaper	/yelo peper/ sensation-oriented newspaper.
yeremiah	(bib.) jeremiah.
yesuit	(rel.) jesuit.
yet	see jet.
yg.	(yang) which, who.
yi.	(yaitu) that is, namely, viz, i.e.
yl.	1. (yang lain) the other. 2. (yang lalu) past, last.
yme	(yang maha esa) the one god.
ymj.	(yang menjalankan jabatan) acting, holding office temporarily.
yo	see ayo.
yodium	iodine.
yodiumisasi	program for providing iodized salt.
yoga	meditation.
yogia	/yogya/ proper, fitting.
yohanes	/yohannes/ 1 male name. 2 (bib.) the gospel of john.
yojana	distance, field of vision.
yok	see ayo.
yoker	(crd.) joker.
yon.	(batalyon) battalion.
yongenskop	short haircut (for women).
yongker	see yoker.
yongtahu	(china) tofu filled with meat.
you	/yu/ you (distant but informal).
yth.	(yang terhormat) the honorable (on letter addresses and salutations).
yts.	(yang tersebut) mentioned.
yu	1. see mbak. 2. see hiu. 3 see you. 4 see ayo.
yubilaris	o. who celebrates his or her jubilee (wedding, ordination, etc.).
yubileum	jubilee.
yuda	/yudha/ (lit.) war.
yudisium	1 latinate citation on a diploma (cum laude, etc.). 2 graduation exercise (at divisional level).
yudo	yudo.
yugo	yugoslav, yugoslavia.
yuh	/yuk/ see ayo.
yuli	see juli.
yunani	greek, greece.
yuncto	/yungkto/ (leg.) in connection with.
yunior	1 (sport) junior, pertaining to or concerning youth. 2 son of.
yuniorat	k.o. college preparatory school emphasizing classics (esp. in colonial period and formerly in jesuit training).
yuran	1 contribution. 2 dues.
yuridiksi	jurisdiction, competency of a certain court.
yuridis	juridical.
yuris	1 juris, lawyer. 2 law student.
yurisprudensi	legal administration, jurisdiction.
yurk	/yurek/ dress, frok, shirt.
yusak	(bib.) joshua.
yuta	see juta.
yuwelir	jeweler.
yuyu	k.o. small soft-shelled crab.
z	/zet, set, jet/ z, the 26th letter of the alphabet.
zaal	/sal/ see sal 1.
zabarjad	topaz.
zabib	(lit.) raisins.
zabur	psalm. kitab-zabur (bib.) book of psalms.
zadah	see jadah.
zadat	(phys.) solid.
zadir	(chem.) sal ammoniac.
zahid	ascetic.
zahir	see lahir 1.
zair	(phys.) liquid.
zaitun	/zait/ olive tree and its fruit.
zak	/sak see sak 1.
zakar	penis. batang-zakar shaft of the penis, penis. buah-zakar testicles.
zakat	(islam) tithe. zakat-fitrah (islam) tithe in rice or money paid on last day of fasting month. zakat-maal tithe paid by rich people.
zakelijk	/sakelek/ (coll.) businesslike.
zakiah	sincere, pure.
zalf	/salep/ see salep.
zalim	see lalim.
zalir	fluid.
zaman	see jaman.
zamrud	emerald.
zamzam	1 a sacred well in mecca's mosque, haggar's well. 2 water from mecca's sacred well.
zanggi	see janggi.
zantara	(phys.) medium.
zarafah	see jerapah.
zarah	/zarrah/ 1 particle, crumb, matter. 2 atom.
zat	(chem.) essence, substance. zat-air hydrogen. zat-asam oxygen. zat-cair liquid. zat-hijau cholorophyl. zat-lemas nitrogen. zat-makanan vitamin. zat-telur protein, albumen. zat-yang maha tinggi the supreme substance (god).
zebra	zebra.
zending	(rel.) /sending/ protestant missionary or mission.
zeni	1. (mil.) detachment of army engineers. 2. (coll.) genius.
zenit	zenith.
zero	(ling.) zero allomorph.
zet	/set/meng-set type
ziadah	addition, excess.
ziarah	make a devotional visit to a sacred place.
zib	1. (lit.) k.o. wolf. 2. see jib.
zig-zag	zig-zag.
zikir	see dikir.
zina	/zinah/ any sexual act outside of marriage.
zindik	heretic.
zinkwit	/singkwit/ zinc-white.
zirafah	see jerapah.
zirah	(lit.) coat of chain-mail.
zirnikh	/sirnikh/ arsenic.
zitje	/sice/ see sice.
zohal	(astr.) saturn.
zohrah	(astr.) venus.
zolim	see lalim.
zonder	/sonder/ see sonder.
zoologi	/sologi/ zoology.
zuadah	see juadah.
zuhal	see zohal.
zuhrah	/zuhrat/ see zohrah.
zuhur	see lohor.
zulhijah	12th month of arabic calendar.
zulkaedah	11th month of arabic calendar.
zunub	see junub.
zurafah	see jerapah.
zuriat	1 (biol.) seed. 2 descendant, posterity.
zus	/sus, ses/ 1 term of address for christian or westernized adult women. 2 term of address for female nurses and midwives.
