opaque	ks. tak tembus cahaya, buram.
open	kb. luar. -ks. 1 terbuka. 2 bebas. 3 buka. 4 terang-terangan (in attitude). 5 berlubang-lubang (texture). 6 lepas. 7 terluang. -opening kb. 1 pembukaan (of a building, an opera, in chess). 2 lubang (in a wall). 3 (vacancy) lowongan.
opener	kb. 1 (can) pembuka. 2 sport : pembukaan.
opennes	kb. keterbukaan, sikap hati terbuka, sikap berterus-terang.
opera	kb. opera. o. house gedung opera/kesenian.
operable	ks. 1 dapat dibedah. 2 dapat dijalankan/dioperasi.
operagoer	kb. penggemar opera.
operate	kkt. 1 menjalankan (a machine, car). 2 menyelenggarakan, mengadakan, mengusahakan (an airline). -kki. to o. for/on membedah, mengoperasi. -operating ks. yang berhubungan dengan eksploitasi.
operatic	ks. yang berhubungan dengan opera.
operation	kb. 1 operasi. 2 med.: pembedahan. 3 eksploitasi.
operational	ks. cara bekerja. o problem kesulitan cara kerjanya.that ordinance is o. peraturan itu berlaku.
operator	kb. 1 penyelenggara, pengurus (of a restaurant. petugas (of a crane). 3 tel.: penghubung. 4 inf.: operator, orang yang licik yang mempergunakan orang-orang dan kejadian-kejadian untuk kepentingannya sendiri.
operetta	kb. operet.
ophtalmologist	kb. dokter (ahli) mata.
ophtalmology	kb. ilmu kedokteran mata.
opiate	kb. 1 opiun, (obat yang mengandung) candu. 2 madat, racun. propaganda is an o. for the masses propaganda adalah racun bagi orang banyak.
opinion	kb. 1 pendapat. 2 pikiran, pendapat.
opinionated	ks. dogmatis, berpendirian keras.
opium	kb. apiun, candu, madat. o. smoker pemadat, pencandu.
opossum	kb. semacam tupai.
opp.	[opposite] lawan, bertentangan, berhadapan.
opponent	kb. (pe)lawan.
opportune	ks. tepat, pantas, menguntungkan, layak (of time). this money is most o. uang itu kebetulan memang sangat dibutuhkan.
opportunism	kb. faham oportunis.
opportunist	kb. oportunis.
opportunity	kb. (j. -ties) kesempatan. to have the o. berkesempatan.
oppose	kkt. menentang. to o. any move menentang setiap gerak. -opposing ks. yang melawan/menentang. o. arnies tentara perlawanan.
opposite	kb. 1 lawan. 2 sebaliknya. -ks. berlawanan, bertentangan. -kd. berhadapan dengan, dihadapan.
opposition	kb. 1 perlawanan, tentangan, oposisi. 2golongan oposisi. partai penentang.
oppress	kkt. menindas, menekan. -oppressed ks. terimpit.
oppression	kb. 1 tindasan, tindihan (of people). 2 tekanan. 3 aniaya.
oppressive	ks. 1 menyesakkan napas (of heat). 2 menindas (of a law, measure).
oppressor	kb. penindas, penindih, penginjak.
opprobrium	kb. kehinaan, kekejian. term of o. istilah penghinaan.
opt.	1[optician] ahli kacamata. 2 [optical] yang berkaitan dengan mata. 3 [optional] fakultatip, boleh memilih.
optic	ks. yang berhubungan dengan mata. o. nerve saraf mata.
optical	ks. yang berhubungan dengan mata. o. instrument perkakas optik. o. illusion ilusi/kekeliruan penglihatan.
optician	kb. ahli kacamata.
optics	kb. ilmu optic(a).
optimal	ks. paling bagus/tinggi. o. results hasil terbagus.
optimism	kb. optimisme, harapan baik.
optimist	kb. optimis.
optimistic	ks. optimistis, barharapan baik.
optimum	kb. jumlah maksimum. -ks. 1 yang tertinggi. 2 terbaik. the o. number of students per class jumlah pelajar yang terbaik untuk tiap kelas.
option	kb. 1 kebebasan (on a house). 2 pilihan. to have the o. of boleh memilih. 3 kehendak.
optional	ks. fakultatif, boleh memilih. o. subject matapelajaran pilihan. -optionally kk. secara bebas-pilih/fakultip.
optometrist	kb. ahli pemeriksa mata, ahli kacamata.
optometry	kb. ukuran mata.
opulence	kb. kakayaan, kemewahan.
opulent	ks. kaya, mewah.
opus	kb. karya, karangan, buku.
or	ksam. atau. is this for you or for me ? ini untuk saudara atau untuk saya ?
oracle	kb. 1 sabda dewa. 2 ramalan, jawaban yang sangat bijaksana. 3 orang bijaksana, peramal.
oral	kb. ujian lisan. -ks. 1 lisan (exam, report). 2 mulut, lubang mulut. -orals j. ujian lisan. -orally kk. 1 dengan lisan. 2 dengan minuman, melalui mulut.
orange	kb. jeruk. o. juice air jeruk. -ks. jingga tua. o. blossom bunga limau.
orangeade	kb. air jeruk (campur air dan gula).
orangutan	kb. orang hutan.
oration	kb. pidato.
orator	kb. ahli pidato.
oratorical	ks. bersifat kecakapan pidato.
oratory	kb. 1 kefasihan berpidato, seni pidato. 2 pidato.
orb	kb. bola, bulatan.
orbit	kb. 1 orbit. to put a man/satellite into o. melontarkan seorang/satelit kedalam orbit. 2 lingkaran. o. of the earth about the sun lingkaran bumi sekeliling matahari. -kkt. 1 mengorbitkan (the earth, the moon). 2 melontarkan (seseorang, sebuah satelit).
orbital	ks. yang berhubungan dengan orbit. o. velucity kecepatan orbit/mengitari.
orchard	kb. kebun buah-buahan.
orchestra	kb. 1 orkes. string o. orkes gesek. 2 tempat duduk dibawah didepan panggung.
orchestral	ks. yang berhubungan dengan orkes. o. composition komposisi/gubahan untuk orkes.
orchestrate	kkt. mengarang/menyusun musik.
orchestration	kb. tehnik mengarang/mengatur musik.
orchid	kb. anggrek. -ks. ungu muda.
ord.	1 [ordinal] urutan. 2 [order] perintah, tatatertib. 3 [ordinance] peraturan. 4 [ordinary] biasa.
ordain	kkt. 1 mentahbiskan, menobat(a minister). 2 mentakdirkan. it was ordained that he die sudah ditakdirkan bahwa ia harus/akan mati.
ordeal	kb. 1 cobaan berat. 2 siksaan.
order	kb. 1 perintah. 2 pesanan. 3 urutan. 4 tatatertib, ketenteraman. 5 orde. 6 golongan, orde. 7 acara. 8 (decoration) medali, tanda jasa. -ordering kb. mengadakan pesanan- pesanan, pemesanan.
orderliness	kb. ketertiban, kerapian, keteraturan.
orderly	kb. 1 (hospital) perawat, mantri, jururawat, ordonan. 2 mil.: ordonan, pengawal. -ks. 1 rapi. o. room kamar yang rapi. 2 tertib. o. crowd kelompok atau orang banyak yang tertib.
ordinal	kb. nomor urutan.- ks. urut(an). o. number bilangan urutan.
ordinance	kb. ordonansi, peraturan. local o. peraturan setempat.
ordinary	kb. out of the o. luar biasa, aneh. -ks. biasa. o. house rumah biasa. -ordinarily kk. biasanya.
ordinate	kb. ordinat.
ordination	kb. pentahbisan.
ordnance	kb. 1 meriam, artileri. 2 senjata/perlengkapan perang.
ore	kb. biji(h), cebakan. iron o. bijih besi. o. deposit lapisan bijih.
ore(g).	[oregon] negarabagian a.s.
oregano	kb. semacam rempah-rempah.
organ	kb. 1 mus.: orgel, organa. 2 anat.: bagian badan, organ, alat tubuh. 3 alat pemerintahan (police force, etc.). 4 organ (majalah perusahaan).
organist	kb. pemain orgel.
organization	kb. 1 organisasi. party o. organisasi partai. 2 hal mengatur. o. of an outing mengatur darmawisata.
organizational	ks. yang berhubungan dengan organisasi. o. meeting rapat organisasi.
organize	kkt. 1 mengatur. to be good at organizing pandai mengatur. 2 mengorganisasi(kan), mengorganisir, mengadakan (picnic, meeting).
organizer	kb. organisator.
orgasm	kb. syahwat, puncak nafsu.
orgy	kb. (j. -gies) pesta pora (yang gila-gilaan), sukaria.
orient	kb. the o. asia timur. -kkt. mengorientasi, menghadap. to o. o.s. mengadakan penyesuaian diri, menyesuaikan diri.
oriental	kb. orang timur/asia. -ks. timur. o. art seni timur. o. rug permadani dari timur.
orientation	kb. orientasi. o. course kursus orientasi.
orifice	kb. lubang, mulut.
orig.	1 [origin] asal. 2 [original] asli.
origin	kb. 1 asal (of a word). 2 asal-usul. 3 asal mula, pangkal (of a quarrel, rumor). 4 sumber.
original	kb. yang asli. this is the o. of that painting inilah lukisan asli dari gambar itu. 2 orisinil. o. idea pikiran yang orisinil. 3 semula. o. price harga semula. -originally kk. bermula, semula.
originality	kb. keaslian.
originate	kkt. yang mula-mula mempunyai, yang memulai. -kki. berasal. that idea originated here gagasan itu berasal disini.
originator	kb. pemula.
oriole	kb. semacam (burung) kepodang.
ornament	kb. 1 perhiasan. o. around her neck perhiasan di lehernya. 2 hiasan. she's an o. to any room dia merupakan hiasan di kamar manapun. christmas tree o. hiasan pohon natal.
ornamental	ks. yang berhubungan dengan (per)hiasan. o. tree pohon hias.
ornamentation	kb. barang-barang perhiasan.
ornate	ks. 1 banyak hiasan, terhias banyak. o. architecture arsitektur yang terlalu penuh hiasan. 2 berbunga (of language).
ornery	ks. 1 inf.: bengal (of amule). 2 inf.: kasar (of a remark).
ornithologist	kb. ahli ilmu burung.
ornithology	kb. ilmu burung.
orphan	kb. anak yatim (-piatu). o. asylum rumah yatim(-piatu), panti asuhan anak yatim. -kkt. menjadikan yatim. to be orphaned at the age of five menjadi yatim pada umur lima tahun.
orphanage	kb. rumah yatim/piatu, rumah panti asuhan.
orthodontics	kb. orthodonsi.
orthodontist	kb. dokter gigi yang keahliannya merapikan gigi.
orthodox	kb. the o. kaum ortodoks. -ks. ortodoks. o. christian orang kristen ortodoks. to follow o. practices mengikuti cara-cara yang telah menjadi kebiasaan.
orthodoxy	kb. (j. -xies) sifat ortodoks, kekolotan.
orthography	kb. (j. -phies) ortografi.
orthopedic	ks. mengenai pembedahan tulang. o. surgeon dokter bedah bagian tulang-tulang.
orthopedics	orthopedics
orthopedist	kb. ahli bedah bagian tulang.
oscillate	kki. 1 berpaling (of fan). 2 berkisar, terombang-ambing. to o. between good and bad terombang-ambing antara buruk dan baik. -oscillating ks. bergerak kesana-kemari, bergoyang (kesana kemari).
oscillation	kb. osilasi, goyangan.
osculate	kkt. mencium.
osmosis	kb. 1 osmosa. 2 pelajaran/pengertian secara berangsur-angsur.
ossifies	lih ossify.
ossify	kki. (ossified) 1 menjadi tulang, mengeras. ossified tissue jaringan yang menulang. 2 menjadi kaku (of o's mind).
ostensible	ks. 1 pura-pura, seolah-olah. her o. purpose was... maksudnya seolah-olah... 2 nyata. there was no o. reason tak ada alasan yang nyata. -ostensibly kk. pura-pura.
ostentation	kb. lagak-lagu yang memperagakan.
ostentatious	ks. suka pamer, sok, berlagak.
osteology	kb. ilmu tulang.
osteopath	kb. ahli osteopati.
osteopathy	kb. osteopati.
ostracism	kb. pengasingan/pemboikotan dari masyarakat/pergaulan.
ostracize	kkt. mengasingkan, memboikot, mengesampingkan (dari masyarakat).
ostrich	kb. (burung) unta.
other	kb. others j. orang lain. the happiness of others kebahagian orang lain. -ks. 1 yang lain. 2 satu lagi.
otherwise	ks. sebaliknya. the outcome could have been o. akibatnya mungkin sebaliknya. -kk. lain. to do o. berbuat lain. -ksam. kalau tidak.
otolaryngology	kb. ilmu penyakit telinga, hidung dan tenggorokan.
otter	kb. berang-berang, anjing air.
ouch	kseru. aduh, aih. o, that hurts ! aih, sakit !
ought	kb. -kkb. 1 sebaliknya. 2 seharusnya. 3 harus, mesti.
ounce	kb. ons. to sell by the o. menjual per ons.
our	kg. 1 kami. o. house rumah kami. 2 kita. o. country negeri kita. 3 kami/kita punya.
ours	kg. 1 milik kami/kita. friends of o. teman-teman kami. 2 kepunyaan kita/kami.
ourselves	lih self.
oust	kkt. 1 mengusir. 2 memecat, mengeluarkan (from a firm, post). 3 mendaulat.
ouster	kb. 1 tindakan pemecatan. 2 pengusiran, pendaulatan. 3 orang yang mendaulat/mengusir.
out	kb. 1 orang/partai yang tidak memegang tampuk pimpinan. 2 jalan keluar. -ks. 1 tidak lagi berkuasa. 2 tidak mode lagi (of clothes). -kk. 1 tidak di rumah. 2 rugi. 3 sudah terbit. 4 tak bisa diterima. 5 pingsan. 6 sedang mengadakan. 7 diluar.
outargue	kkt. mengalahkan (seseorang) dalam perbantahan.
outbid	kkt. (outbid) mengalahkan seseorang) dalam menawar.
outboard	ks. diluar, sebelah luar. o. motor motor tempel.
outbreak	kb. 1 perjangkitan (of disease). 2 pecahnya (of war).
outbuilding	kb. bangunan tambahan.
outburst	kb. 1 ledakan, riuh-rendah (of applouse). 2 semburan (of smoke, lava).
outcast	kb.orang yang diusir dari masyarakat, orang buangan, seorang paria/buangan masyarakat.
outclass	kkt. termasuk tingkatan yang lebih tinggi, jauh lebih unggul.
outcome	kb. 1 hasil. o. of the elections hasil pemilihan. 2 akibat.
outcrop	kb. singkapan, muncul ke permukaan bumi.
outcry	kb. teriakan, ingar bingar, gaduh, haru-hara. to raise an o. against s.o. berteriak terhadap seseorang.
outdated	ks. ketinggalan jaman, (model) kuno.
outdid	lih outdo.
outdistance	kkt. mendahului, meninggalkan.
outdo	kkt. (outdid, outdone) mengalahkan, menang atas. he will not be outdone by everyone dia tak akan terkalahkan oleh siapapun.
outdone	lih outdo.
outdoor	ks. diluar. o. swimming pool kolam renang diluar (rumah).
outdoors	kk. diluar rumah, di tempat terbuka. to eat o. makan diluar rumah (di udara), makan di tempat terbuka.
outdraw	kkt. (outdrew, outdrawn) menarik lebih banyak orang (of sports).
outdrawn	lih outdraw.
outdrew	lih outdraw.
outer	ks. sebelah luar. o. lining bahan pelapis sebelah luar. space ruang angkasa, angkasa luar.
outermost	ks. yang paling jauh. in the o. regions di daerah-daerah yang paling jauh.
outfight	kkt. (outfought) mengalahkan dalam perkelahian.
outfit	kb. 1 perlengkapan. 2 pakaian (of a woman). 3 perusahaan. 4 kesatuan. -kkt. (outfitted) memperlengkapi.
outfitter	kb. penjual pakaian (pria) eceran.
outflank	kkt. mengepung.
outflow	kb. mengalirnya, pengaliran, keluar.
outfought	lih outfight.
outfox	kkt. mengakali, menipu.
outgo	kb. pengeluaran.
outgoing	ks. 1 (retiring) meninggalkan dinas, demisioner, mengundurkan diri. 2 ramah tamah. 3 surut.
outgrew	lih outgrow.
outgrow	kkt. (outgrew, outgrown) 1 menjadi lebih besar (of size). 2 menjadi lebih tinggi. 3 mengatasi, menguasai (o's temper).
outgrown	lih outgrow.
outgrowth	kb. 1 hasil pertumbuhan, perkembangan (of on idea). 2 tumbuhan (of hair).
outguess	kkt. lebih pintar dari we couldn't o. him ia terlalu pintar buat kami.
outhouse	kb. kakus (diluar rumah).
outlandish	ks. 1 asing (of custom). 2 aneh (of clothing). 3 jauh terpencil (of a place).
outlast	kkt. hidup lebih lama dari.
outlaw	kb. orang diluar perlindungan hukum. -kkt. 1 menyatakan tidak syah. 2 mencabut perlindungan hukum.
outlay	kb. pengeluaran, pembayaran, pembiayaan.
outlet	kb. 1 saluran keluar (for o's energy). 2 jalan keluar/lepas. 3 elec.: stopkontak. 4 toko/tempat pejualan.
outline	kb. 1 garis, bagan, sketsa, skema (of a plan). 2 garis bentuk (of a building). -kkt. 1 menguraikan (o's duty). 2 memperhatikan garis bentuk. 3 menggambar denah peta. o. map peta bagan.
outlive	kkt. 1 hidup lebih lama daripada. 2 dipakai lbih lama daripada (of street car).
outlook	kb. 1 pandangan. 2 harapan. 3 pemandangan (over valley, from a window). 4 ramalan.
outlying	kb. terpencil, jauh. o. district wilayah yang terpentil.
outman	kkt. (outmanned) melebihi anggouta, mengalahkan dalam jumlah anggota.
outmaneuver	kkt. mengakali (dalam permainan bola dsb).
outmatch	kkt. melebihi, menang dalam jumlah, mengalahkan. we were outmatched by... kami dikalahkan oleh...
outmoded	ks. ketinggalan zaman. o. car mobil kuno.
outnumber	kkt. melebihi/menang dalam bilangan.
outpace	kkt. 1 melebihi. 2 berlari lebih cepat.
outpatient	kb. pasien yang diobati di rumah sakit tetapi tidak tinggal di rumah sakit.
outplay	kkt. bermain lebih bagus daripada, lebih unggul.
outpoint	kkt. sport : lebih banyak mendapat angka daripada.
outpost	kb. 1 pos terdepan, pengawal luar, tempat kawalan luar. 2 pelopor, pionir (of civilization peradaban).
outpouring	kb. 1 pencurahan, penumpahan. 2 sesuatu yang membanjir/melimpah.
output	kb. 1 hasil, produksi. literary o. hasil kesusasteraan, karya sastera. 2 informasi (dari computer). 3 tenaga mesin (of electricity).
outrage	kb. 1 kebiadaban (against society). 2 kekejaman. 3 (insult) penghinaan. -kkt. 1 menyakitkan hati. 2 (rape) memperkosa (perempuan).
outrageous	ks. 1 menyakitkan hati, memalukan (of conduct). 2 kasar, kotor, tak patit (of language). 3 menghina. -outrageously kk. sangat, terlalu. o. expensive sangat/terlampau mahal.
outran	lih outrun.
outrank	kkt. lebih tinggi pangkatnya daripada. a colonel outrank a mayor kolonel berpangkat lebih tinggi daripada mayor.
outrigger	kb. (peng)gandung.
outright	ks. 1 yang sama sekali palsu. o. lie kebohongan yang sama sekali palsu. 2 secara ikhlas. o. gift hadiah secara ikhlas. -kk. sekaligus, seketika itu. to pay o. membayar seketika itu.
outrival	kkt. melebihi dalam persaingan.
outrun	kkt. (outran, outrun) berlari lebih cepat dari.
outsell	kkt. (outsold) menjual lebih banyak dari.
outset	kb. permulaan. at the o. pada permulaan, mula-mula.
outshine	kkt. (outshone) 1 lebih cemerlang daripada. 2 paling pintar dari yang lain.
outshone	lih outshine.
outside	kb. sebelah luar. from the o. dari (sebelah) luar. -ks. 1 sebelah luar. 2 tipis. -kk. diluar, keluar. -kd. diluar. o. the door diluar pintu.
outsider	kb. orang luar.
outskirts	kb., j. daerah pinggiran, pinggir (of a city).
outsmart	kkt. mengakali.
outsold	lih outsell.
outspeard	ks. terentang, terhampar. with arms o. dengan tangan terentang.
outspoken	ks. terang-terangan, blak-blakan.
outstanding	ks. 1 terkemuka, terkenal. o. student mahasiswa yang menonjol. 2 belum diselesaikan. debts o. hutang yang belum dilunasi.
outstretched	ks. terulur, diulurkan. with o. arms dengan tangan yang diulurkan.
outstrip	kkt. (outstripped) melebihi, melampaui.
outtalk	kkt. berbicara lebih baik, menang dalam percakapan.
outvote	kkt. mengalahkan dalam pemilihan.
outward	ks. disebelah luar, keluar. o. voyage pelayaran keluar. -kk keluar. outward-bound ks. dengan jurusan/tujuan luar. -outwardly kk. pada lahirnya, dari luar, kelihatannya.
outwards	= outward kk.
outwear	kkt. (outwore, outworn) lebih tahan daripada (of clothes). -outworn ks. lungsuran, usang, bekas pakai. o. clothes pakaian-pakaian usang.
outweigh	kkt. 1 lebih berat daripada. 2 labih banyak daripada. the advantages o. the disadvantages keuntungannya lebih banyak daripada kerugiannya.
outwit	kkt. (outwitted) memperdayakan, mengecoh.
outwore	lih outwear.
outwork	kkt. lebih kuat bekerja daripada.
outworn	ks. lih outwear.
oval	ks. bujur telur. oval-shaped ks. jorong.
ovary	kb. (j. -ries) indung/induk telur.
ovation	kb. sambutan dengan tepuk tangan, sambutan sorak-sorai. standing o. sambutan sorak-sorai sambil berdiri.
oven	kb. kompor, tanur, tungku. coke o. tungku pembuat arang. that room is a regular o. kamar itu sangat panas.
ovenware	kb. piring-piring tahan panas (perkakas dapur).
over	ks. berakhir. -kk. 1 diatas. 2 keatas. 3 sisa, lebih. 4 lebih dari. 5 lagi. 6 selesai. 7 daripada.
overabundance	ks. meluap-luap, melimpah-limpah.
overact	kki, bermain berlebih-lebihan.
overactive	ks. terlalu aktif, terlalu banyak bekerja.
overage	ks. terlalu tua.
overall	overalls kb., baju/pakaian kerja. -ks. secara keseluruhan/menyeluruh. the o. cost ongkos keseluruhan.
overanxious	ks. terlalu cemas.
overate	lih overeat.
overawe	kkt. sangat mengagumkan/mempesonakan. to be overawed by o's ability sangat kagum melihat kecakapannya.
overbearing	ks. suka menguasai/memaksa. o. personality watak suka menguasai.
overboard	kk. keluar kapal. man o ! orang jatuh ke laut !
overburden	kkt. terlalu membebani. she's not overburdened with brains ia tak terlalu pandai.
overcame	lih overcome.
overcast	kb. cuaca mendung, awan. -ks. mendung, berawan (of sky).
overcharge	kkt. menjual terlalu mahal.
overcoat	kb. mantel.
overcome	kkt., kki. (overcame, overcome) 1 mengatasi, menanggulangi (a problem, o's shyness). 2 menguasai.
overconfidence	kb. kepercayaan yang berlebih-lebihan, hal terlalu percaya.
overconfident	ks. terlalu percaya (of akan).
overcrowd	kkt. membuat sesak/padat. -overcrowded ks. terlalu penuh. 0. bus bis yang terlalu penuh. -overcrowding kb. kepadatan yang berlebihan.
overdid	lih overdo.
overdo	kkt. (overdid, overdone) melakukan sesuatu berlebih-lebihan. -overdone ks. terlalu lama dimasak (of food).
overdone	lih overdo.
overdose	kb. lebih dari takaran semestinya, terlalu banyak.
overdraft	kb. penarikan cek yang melebihi jumlah uang di bank.
overdraw	kkt. (overdrew, overdrawn) 1 menarik cek lebih daripada uang simpanan. 2 terlalu berlebih-lebihan melukiskan peranan (of characters in a novel).
overdrawn	lih overdraw.
overdress	kki. berpakaian secara berlebih-lebihan.
overdrew	lih overdraw.
overdrive	kb. gir tambahan, alat penambah kecepatan.
overdue	ks. 1 terlamabat (of plane, train). 2 melampaui batas waktunya(of an account).
overeat	kkt., kki. (overate, overeaten) makan terlalu banyak.
overeaten	lih overeat
overestimate	kkt. menaksir terlalu tinggi.
overexertion	kb. pekerjaan yang terlalu keras.
overexpose	kkt. cahaya terlalu banyak masuk. the negative was overexposed negatipnya kena terlalu banyak cahaya.
overextend	kkt. 1 mengulur-ulur (o's visit). 2 bekerja terlalu berat.
overflight	kb. penerbangan diatas wilayah negeri lain.
overflow	kb. 1 kebanjiran (of a crowd). 2 banjir (of river, tank). -kkt. meluapi. -kki. melimpah, meluap.
overgrown	ks. tumbuh melampaui. yard o. with weeds halaman yang penuh ditumbuhi rumput-rumput.
overhand	kb. tenn.: o. shot pukulan overhand, pukulan dengan ayunan tangan yang tinggi.
overhang	kb. emper, serambi. -kki. (overhung) bergantung diatas, menganjur. overhanging vines tanaman menjalar yang bergantungan.
overhaul	kb. pemeriksaan. thorough o. pemeriksaan yang sangat teliti. -kkt. 1 memeriksa, secara seksama. 2 berhasil mengejar (a speeder).
overhead	kb. ongkos exploitasi, pengeluaran tambahan (seperti sewa, listerik, pajak dsb).
overhear	kkt. (overheard) ada mendengar-dengar, ada menangkap.
overheard	lih overhear.
overheat	kkt. membuat/menjadikan terlalu panas. -kki. menjadi terlalu panas.
overhung	lih overhang.
overjoyed	ks. sangat gembira.
overkill	kb. pembunuhan besar-besaran.
overladen	ks. penuh dibebani. o. with responsibility penuh dibebani pertanggungan jawab.
overlaid	lih overlay.
overland	ks., kk. melalui darat.
overlap	kb. saling meliputi/melengkapi. -kki. (overlapped) dapat dicocokkan, bersamaan waktu.
overlay	kb. lembaran penutup, lapisan atas, hamparan. -kkt. (overlaid) 1 melapisi. the table is overlaid in veneer meja itu dilapisi dengan suatu lapsan. 2 membebani (with responsibility).
overleaf	kb. halaman sebaliknya/sebelah.
overload	kb. beban yang terlalu berat. -kkt. 1 memberi muatan melebihi kekuatan (truck). 2 memberi muatan melewati batas (current, circuit).
overlook	kb. pemandangan kebawah. -kkt. 1 melupakan, pangling (details, facts). 2 memaafkan (a mistake). 3 memandang kebawah (a valley). 4 mengabaikan (o's talent).
overlord	kb. tuan besar, maharaja.
overly	kk. sangat, terlalu. o. eager sangat ingin.
overnight	ks. bermalam. -kk. semalam, waktu (dalam) satu malam.
overpaid	lih overpay.
overpass	kb. jembatan diatas jalan, jembatan penyeberangan.
overpay	kkt. (overpaid) membayar lebih banyak dari yang semestinya.
overplay	kkt. bermain berlebih-lebihan. to o. o's hand mencoba untuk mencari terlalu banyak.
overpower	kkt. 1 menggagahi. 2 menyergap.
overproduction	kb. produksi yang berlebihan.
overran	lih overrun.
overrate	kkt. menilai terlalu tinggi.
overreach	kkt. melampaui batas yang ditentukan (o's authority). to o. o.s. bertindak terlalu berani.
overreact	kki. bertindak melampaui batas.
overridden	lih override.
override	kkt. (overrode, overridden) mengesampingkan, menolak (a decision, objection). overriding objection keberatan yang menolaknya.
overripe	ks. 1 terlalu masak, ranum. 2 terlalu mendesak (of conditions).
overrode	lih override.
overrule	kkt. menolak, mengesampingkan. objection overruled keberatan ditolak.
overrun	kkt. (overran, overrun) 1 membanjiri, mengerumuni (a house with cats). 2 mengeroyok, menyerbu (a country). 3 menutupi.
oversaw	lih oversee.
overseas	ks. luar negeri, seberang laut. o. services dinas tentara diseberang lautan. -kk. diluar negeri, di perantauan.
oversee	kkt. (oversaw, overseen) mengawasi, mengatur, menjaga (a firm, play-ground).
overseen	lih oversee.
overseer	kb. mandor, pengawas.
oversell	kkt. (oversold) terlalu banyak menjual (of plane tickets).
oversexed	ks. mempunyai nafsu syahwat terlalu besar.
overshadow	kkt. mengalihkan, membelakangi. she is overshadowed by her older sister dia dikalahkan oleh kakaknya.
overshoe	kb. sepatu luar.
overshoot	kkt. (overshot) melampaui. to o. the runway terlalu jauh melampaui landasan.
overshot	lih overshoot.
oversight	kb. kekeliruan, kekhilafan, kesilapan, kesalahan, kealpaan, kalalaian.
oversimplification	kb. penyederhanaan yang berlebih- lebihan.
oversimplified	lih oversimplify.
oversimplifies	lih oversimplify.
oversimplify	kk. (oversimplified). menyederhanakan secara berlebih-lebihan
oversize	ks. terlalu besar. o. shirt kemeja yang terlalu besar.
oversized	ks. besar sekali. o. boat sepatu bot yang terlalu besar.
oversleep	kki. (overslept). 1 tidur terlalu lama. 2 bangun kesiangan.
overslept	lih oversleep.
oversold	lih oversell.
overstate	kkt. terlalu keras menekankan (o's case persoalannya).
overstatement	kb. pernyataan yang berlebih-lebihan.
overstay	kkt. memperpanjang. to o. o's welcome tinggal lebih lama daripada sepantasnya.
overstep	kkt. (overstepped) melampaui, melewati (o's authority).
overstock	kkt. terlalu banyak menimbun.
overstuff	kkt. mengisi terlalu tebal. overstuffed chair kursi yang bantalannya tebal sekali.
oversubscribe	kkt. menyumbang uang yang berlebih-lebihan.
overt	ks. jelas, terang, lahir. o. act tindakan yang bermaksud jahat. -overtly kk. pada lahirnya.
overtake	kkt. (overtook, overtaken) menyusul. his car overtook hers mobilnya mendekati mobil wanita itu (dari belakang).
overtaken	lih overtake.
overtax	kkt. 1 mengenakan terlalu banyak pajak. 2 melemahkan (o's strength tenaganya).
overthrew	lih overthrow.
overthrow	kb. perobohan, penggulingan (of a government). -kkt. (overthrew, overthrown) menjatuhkan, menggulingkan, merobohkan.
overthrown	lih overthrow.
overtime	kb. lembur. to work o. bekerja lembur. o. pay bayaran lembur.
overtone	kb. nada tambahan.
overtook	lih overtake.
overture	kb. 1 lagu pembukaan, musik pengantar. 2 tawaran, usul. to make overtures to mengajukan tawaran kepada.
overturn	kkt. 1 menjatuhkan, menggulingkan (a government). 2 menjungkir-balikkan (a canoe). -kki. berjungkir-balik (of a car).
overview	kb. peninjauan luas, gambaran ikhtisar.
overwater	ks. melalui laut. the o. rute jalan melalui laut.
overweening	ks. terlalu kuat, besar sekali.
overweight	ks. kelebihan berat. she's ten pounds o. dia kelebihan berat sepuluh pon.
overwhelm	kkt. meliputi, membanjiri. to be overwhelmed a) (with joy) gembira meluap-luap. b) with disaster) kewalahan. -overwhelming ks. besar sekali, berlimpahan.
overwork	kb. terlalu banyak pekerjaan. -kki. terlalu banyak bekerja, bekerja melamapui batas.
overwrought	ks. terlalu capek/meregang.
ovum	kb. (j. ova) telur.
owe	kkt. 1 berhutang. 2 memperlihatkan, memberikan. 3 menerima. -owing ks. berhutang.
owl	kb. burung hantu.
own	kb. to come into o's o. mendapatkan yang selayaknya, memperoleh yang sewajarnya, mendapat penghargaan semestinya. -ks. kepunyaan sendiri. -kkt. 1 memiliki. 2 mengakui.
owner	kb. pemilik, yang empunya.
ownership	kb. kemilikan, hak milik,kepemilikan. this store is under new o. toko ini di bawah pemilikan/pemilik baru.
ox	kb. (j. oxen) lembu jantan.
oxcart	kb. gerobak sapi.
oxen	lih ox.
oxford	kb. semacam sepatu berumur rendah. he's an o. man ia lulusan (universitas) oxford.
oxidation	kb. oksidasi.
oxide	kb. oksid(a).
oxidize	kkt. mengoksid(asi).
oxtail	kb. ekor lembu. o. soup buntut.
oxtongue	kb. lidah lembu.
oxyacetylene	ks. o. torch lampu oksiasetilin.
oxygen	kb. zat asam/pembakar, oksigen. o. tent tudung oksigen.
oyster	kb. tiram. o. bed petiraman.
oz.	[ounce] ons.
ozone	kb. 1 ozon. 2 udara murni.
p	kb. huruf keenambelas dari abjad inggris.
p.	1[ page] halaman. 2 [part] bagian.
p.a.	[public address] p.a. system pengeras suara, (alat) pemanggilan umum.
p.c.	[per cent] persen.
p.js.	kb., j. sl.: piyama.
p.m.	1 [post meridiem] sore, petang hari. 2 [post mortem] pemeriksaan mayat.
p.o.	[post office] kantor pos.
p.o.b.	[post office box] kotak pos.
p.p.s.	[a second postcript] catatan tambahan kedua (dalam surat).
p.r.	[puerto rico] porto rico.
p.s.	[postcript] tambahan pada akhir surat.
p.s.t.	[pasific standard time] waktu tolok pasifik.
p.ss., p.ss.	[postscripts] kata-kata tambahan.
p.t.a.,pta	[parent-teacher association] persatuan orangtua murid dan guru (pomg).
p.t.o.	[please turn over] lihat sebaliknya. lihat sebelah (lsb).
pa	kb. bapak, pak.
pa.	[pennsylvania] negara bagian di a.s.
pac.	[pacific] pasifik, lautan teduh.
pace	kb. langkah. -kkt. melangkah bolak-balik (the floor). -kki. to p. up and down melangkah bolak-balik.
pacemaker	kb. perintis, pembuka jalan.
pacesetter	kb. 1 yang menentukan model. 2 pemimpin kecepatan.
pachyderm	kb. binatang yang berkulit tebal.
pacific	ks. tenang. the p. (ocean) lautan teduh/pasifik.
pacification	kb. 1 pengamanan, pasifikasi, perdamaian. 2 penyabaran, penenangan.
pacifier	kb. 1 pembawa perdamaian. 2 dot (for babie).
pacifies	lih pacify.
pacififism	kb. paham suka damai.
pacifist	kb. orang yang suka damai.
pacify	kkt. (pacified) menenangkan, menenteramkan (a baby, an area).
pack	kb. 1 pak (cigarette). 2 beban kumpulan, bungkusan, ran(g)sel (on o's back). 3 kumpulan. 4 onggokan. -kkt. 1 mengepak, mempak (o's suitcase). 2 memasukkan. 3 membalut. (pipes). 4 memadatkan. 5 membawa. 6 memadati (the stadium).
package	kb. 1 bungkus. 2 pak (of cornflakes, frazen asparagus, cigarettes). 3 paket. -kkt. membungkus, mengepak. -packaging kb. pengemasan.
packager	kb. pengepak, tukang pak.
packer	kb. 1 tukang bungkus. 2 pengusaha pengepak.
packet	kb. paket (of notes, letters). 2 pak 9of cigarettes). 3 bongkos.
pact	kb. perjanjian, pakta. p. of friendship persetujuan persahabatan.
pad	kb. blok (kertas). 2 bloknot (for noter). 3 alas (beneath a dish). 4 bantal(an). 5 sl.: flat, kamar. -padding kb. 1 bahan pengisi, 2 lapisan.
paddle	kb. 1 dayung, kayuh. 2 tongkat. 3 bat, alat pemukul (pingpong). -kkt. 1 mengayuh, mendayung. 2 memukul, mencemeti.
paddler	kb. anak dayung, pendayung.
paddy	kb. (j. -dies) padi. p. field sawah, padang padi.
paddybird	kb. burung sawah/gelatik.
padlock	kb. kunci kura-kura, gembok gantung. -kkt. menggembok, mengunci dengan kunci gantung.
paean	kb. nyanyi pujian, lagu pujaan.
pagan	kb. penyembah berhala. p. religion agama penyembah berhala.
paganism	kb. penyembahan berhala.
page	kb. 1 halaman, muka, pagina (a book). -kkt. 1 memanggil. 2 menomori halaman. -paging kb pemberian nomor pada halaman buku..
pageant	kb. pawai sejarah, pertunjukan yang indah (biasanya tentang sejarah).
pageantry	kb. (j. ries) pertunjukan arak-arakan kebesaran.
pagination	kb. pemberian nomor pada halaman buku.
pagoda	kb. 1 kuil budha berbentuk menara. 2 kelenteng.
paid	lih pay.
pail	kb. ember. a p. of water air seembar.
pailful	kb. seember penuh.
pain	kb. perasaan sakit, kesakitan. -kkt. 1 menyakitkan. 2 menyedihkan (of news).
painful	ks. 1 menyakitkan (of an injury, diease) 2 tersiksa hati (of a performance).
painkiller	kb. penawar (rasa) sakit.
painkilling	ks. panawar kesakitan.
painless	ks. tanpa rasa sakit.
painstaking	ks. sungguh-sungguh, saksama. with p. care dengan ketelitian yang sungguh-sungguh.
paint	kb. cat, cet. -kkt. 1 mencat, mengecat, mengecet, mencet (a house). 2 melukis (a picture). 3 mengobati, mengulasi. -painted ks. bercat. -painting kb. 1 lukisan. 2 pekerjaan mengecet.
paintbox	kb. kotak cet.
paintbrush	kb. kuas cat.
painter	kb. pelukis. 2 tukang cat (of a house).
pair	kb. 1 sepasang. 2 pasangan.
pajamas	kb., j. piyama.
pakistani	kb. orang pakistan.
pal	kb. inf.: sahabat, kawan. -kki. inf.: to p. around kemana-mana berteman.
palace	kb. istana.
palanguin	kb. tandu, joli.
palatable	ks. 1 enak, lezat. 2 cocok (to dengan).
palatal	ks. palatal, mengenai langit-langit. p. "l" huruf l yang dibunyikan dengan lidah didekatkan kepada langit-langit.
palatalization	kb. membunyian/pengucapan dengan mendekatkan lidah kepada langit-langit.
palate	kb. 1 langit-langit mulut. 2 cita-rasa, selera.
palatial	ks. mewah, bagus sekali (seperti istana).
palaver	kb. perembukan, perundingan.
pale	kb. batas. -ks. 1 pucat. 2 muda. -kki. memucat, menjadi pucat. pale-faced ks. bermuka pucat.
paleness	kb. kepucatan.
paleography	kb. paleografi, ilmu tulisan kuno.
paleontology	kb. paleontologi.
palette	kb. palet/(pelukis).
palisades	kb., j. pagar (dibuat dari) kayu runcing.
pall	kb. 1 kain penutup peti mati. 2 selubung kabut (of smoke). -kki. 1 membosankan(of food). 2 menjadi luntur (of a friendship).
pallbearer	kb. pengusung jenazah.
palliative	kb. yang meringankan/meredakan (tidak menyembuhkan).
pallid	ks. pucat (pasi) (of complexion).
pallor	kb. kepucatan, muka pucat.
palm	kb.1 telapak/muka tangan. 2 pohon palem. -kkt. menyembunyikan (sesuatu) dalam telapak tangan.
palmist	kb. tukang ramal dengan melihat rajah tangan.
palmistry	kb. kepandaian meramal berdasarkan rajah tangan.
palmy	ks. makmur, subur-makmur. p. days zaman kemakmuran.
palpable	ks. jelas, gamblang. p. mistake kesalahan yang jelas.
palpitate	kki. berdebar (of the heart).
palsied	ks. lumpuh.
palsy	kb. (j. -sies) kelumpuhan (saraf), penyakit lumpuh.
paltry	ks. tak berharga, remeh.
pamper	kkt. memanjakan. -pampered ks. manja.
pamphlet	kb. pamplet, brosur, surat sebaran.
pan	kb. panci. -kkt. (panned) 1 inf.: mencela dengan keras (a play). 2 mendulang, melimbang (gold).
pan-american	ks. amerika raya, seluruh amerika.
pan-islam	kb. islam raya, umat islam seluruh dunia.
panacea	kb. obat mujarab.
panama	panama
pancake	kb. kue dadar/serabi. p. landing pendaratan pesawat yang cepat dan datar. -kkt. mendaratkan dengan terhempas.
pancreas	kb. pankreas, kelenjar ludah perut.
pandemonium	kb. kekacauan yang sangat, gara-gara, hiruk-pikuk.
pander	kb. calo, kakitangan. -kki. menjadi kakitangan/calo untuk berbagai perbuatan keji dan mesum.
pandora	kb. to open a pandora's box menimbulkan segala macam kesulitan/keburukan.
pane	kb. kaca (jendela).
panegyric	kb. pidato/tulisan berisi pujian-pujian terhadap seseorang.
panel	kb. 1 sehelai papan (of door). 2 juri, panel (of experts).3 (instrument). papan. -kkt. memberi papan atau bilah (a room). -paneling kb. hiasan kambi/jalur, papan bingkai.
panelboard	kb. papan alat.
panelist	kb. peserta dalam diskusi beregu, panelis.
panful	kb. sepanci penuh.
pang	kb. rasa (sakit) yang tiba-tiba datangnya, kepedihan. p. of hunger perihnya perut karena lapar.
panhandle	kb. 1 gagang panci. 2 geog.: juluran wilayah.- kkt. mengemis.
panhandler	kb. pengemis.
panic	kb. kepanikan, kegegeran. -kkt. (panicked) 1 membikin panik. 2 menggelikan hati. -kki. menjadi panik/gugup. panic-stricken ks. terkena panik.
panicky	ks. panik, gugup karena takut. p. crowd orang banyak yang panik/amat ketakutan.
panoply	kb. (j. -lies) 1 pakaian besi. 2 persenjataan lengkap.
panorama	kb. pemandangan yang luas.
pansy	kb. (j. -sies) 1 sejenis bunga. 2 sl.: pria pesolek, banci. 3 sl.: pria yang homoseksuil.
pant	kb., napas pendek dan cepat. -kki. terengah-engah, ngap-ngap. -panting kb. suara terengah-engah.
pantheism	kb. panteisme.
panther	kb. harimau kumbang.
pantie	= panty.
pantomime	kb. pentomim, pertunjukan bisu. -kki. bermain pantomim.
pantry	kb. (j. -ries) kamar sepen.
pants	kb., j. 1 pantalon (pria), celana panjang (pria). 2 celana panjang (wanita).
panty	kb. (j. -ties) celana dalam (anak-anak atau wanita).
pantywaist	kb. sl.: laki-laki yang bersifat perempuan.
pap	kb. 1 bubur (untuk bayi). 2 yang dangkal.
papa	kb. bapak, pak, ayah.
papacy	kb. (j. -cies) kepausan.
papal	ks. yang berkaitan dengan paus.
papaw	kb. semacam pepaya.
papaya	kb. pepaya.
paper	kb. 1 kertas. 2 surat kabar, koran. 3 acad.: karangan, naskah. -papers j. surat-surat (dokumen). -kkt. menempeli (a room). papering kb. penempelan kertas dinding.
paperback	kb. buku bersampul tipis.
paperboy	kb. tukang/kacung koran.
paperclip	kb. jepitan/penjepit kertas.
papermaking	kb. pembuatan kertas.
paperweight	kb. penindih kertas.
paperwork	kb. pekerjaan tulis-menulis.
papier-mache	kb. bahan yang terbuat dari bubur kertas yang dicampuri perekat untuk dicetak atau dibentuk (patung, topeng, dsb).
pappy	kb. (j. -pies) bapak, pak, ayah.
paprika	kb. paprika (semacam lombok).
papua	kb., ks. orang papua.
papyrus	kb. (j. -ri) lontar.
par	kb. 1 persamaan, tingkat yang sama. 2 par (golf). 3 lebih sehat.
par.	[parliament] parlemen, dewan perwakilan rakyat.
para.	[paragraph] ayat, paragrap.
parable	kb. cerita perumpamaan, ibarat.
parabola	kb. parabol.
parachute	kb. parasut. -kki. terjun dengan parasut/payung.
parachutist	kb. prajurit tentara payung.
parade	kb. pawai, parade. -kkt. 1 mempertunjukkan (o's wealth). 2 memperagakan, memamerkan. -kki. berpawai, berbaris.
paradigm	kb. 1 model pola, contoh. 2 gram.: contoh tasrif.
paradise	kb. firdaus, sorga, janat.
paradox	kb. paradoks. lawan asas.
paradoxical	kb. berlawanan asas.
paraffin	kb. lilin, parafin, malam.
paragon	kb. teladan yang sempurna, suri teladan.
paragraph	kb. paragraf, ayat, alinea.
parakeet	kb. bayan, betet.
parallel	kb. 1 garis lintang sejajar. 2 persamaan. -sejajar. -kkt. 1 sejajar dengan. 2 serupa dengan (of a life story). 3 bersamaan/sama dengan.
parallelogram	kb. jajaran genjang.
paralysis	kb. (j. -ses/-siez/) kelumpuhan.
paralytic	kb. orang yang dilumpuhkan. -ks. yang berhubungan dengan kelumpuhan. to have a p. stroke mendapat serangan yang melumpuhkan.
paralyze	kkt. melumpuhkan. to be paralyzed lumpuh.
parameter	kb. parameter.
paramilitary	ks. bersifat kemiliteran.
paramount	ks. yang tertinggi, yang terpenting. of. p. importance yang terpenting, yang pokok sekali.
paramour	kb. kekasih (diluar ikatan suami istri).
paranoia	kb. penyakit gila karena ketakutan atau karena kekecewaan.
paranoiac	kb. orang yang gila ketakutan.
paranoid	ks. gila ketakutan.
parapet	kb. sandaran, dinding (jembatan).
paraphase	kb. uraian dengan kata-kata sendiri. -kkt. menguraikan dengan kata-kata sendiri.
paraphernalia	kb. 1 perlengkapan. 2 perhiasan-perhiasan.
paraphlegic	kb. orang yang bagian bawah dari tubuhnya lumpuh.
parasite	kb. parasit, pasilan, benalu.
parasitic	ks. bersifat parasit/benalu/pasilan.
parasitology	kb. ilmu parasit.
parasol	kb. payung (terhadap matahari).
paratrooper	kb. prajurit payung, parasutis. -paratroopers j. pasukan para, pasukan payung.
paratroops	kb., j. pasukan-pasukan payung.
paratyphoid	kb. penyakit tipus ringan, paratipus.
parboil	kkt. memasak setengah matang, menanak-nanak matang.
parcel	kb. 1 bingkisan, bungkusan, paket. 2 bidang. -parceling kb. pembagian, pematokan.
parch	kkt. memanggang (corn, banana). to be parched by the sun menjadi kering dan panas kena matahari.
parchment	kb. kertas (dari) kulit, perkamen.
parciple	kb. partisip.
pardon	kb. ampun, pengampunan, grasi (dari gubernur). 2 maaf. -kkt. 1 memaafkan. 2 mengampuni, memberi ampun/grasi.
pardonable	ks. 1 dapat diampuni. 2 dapat dimaafkan. with p. pride dengan rasa bangga yang dapat dimaafkan.
pare	kkt. 1 mengupas (an apple). 2 memotong (o's nails). parings j. kulit, kupasan. -paring kb. pengupasan.
paregoric	kb. (obat) penghilang rasa sakit.
paren.	[parenthesis] tanda kurung.
parent	kb. 1 orang tua. 2 ayah. 3 ibu. p. company perusahaan induk.
parentage	kb. asal-usul.
parental	ks. yang berkaitan dengan orang tua. p. authority kekuasaan orang tua.
parenthesis	kb. (j. -ses) tanda kurung. in parentheses dalam tanda kurung.
parenthetic(al)	ks. 1 yang disisipkan. 2 dalam tanda kurung. -parentthetically kk. dengan sisipan, sambil lalu.
parenthood	kb. kedudukan sebagai orang tua.
parer	kb. 1 orang pengupas. 2 mesin pengupas.
parfait	kb. eskrim sama krim dan buah-buahan yang dibekukan dan disajikan dalam gelas tinggi.
pariah	kb. 1 paria. 2 kasta yang terendah di india. 3 sampah masyarakat.
parish	kb. jemaah gereja. p. priest pendeta wilayah (yang ada gerejanya).
parishioner	kb. anggauta kemaah gereja.
parisian	kb. orang kota paris. p. atmosphere suasana kota paris.
parity	kb. (j. -ties) 1 kesamaan. 2 keseimbangan.
park	kb. 1 taman. 2 kebun raya. -kkt. 1 menempatkan, memarkir (a car). 2 inf.: menaruh. -parking kb. parkir.
parkinson	kb. parkinson's disease semacam penyakit lumpuh.
parkway	kb. jalan raya yang berumput ditengahnya.
parlance	kb. bahwa, cara bercakap. in common p. dalam bahasa biasa.
parley	kb. permusyawaratan, perembukan.
parliament	kb. perlemen, dewan perwakilan rakyat.
parliamentarian	kb. 1 anggauta parlemen. 2 anggota perlemen yang berpengalaman dalam sidang-sidang parlemen.
parliamentary	ks. parlementer. p. body badan parlementer.
parlor	kb. kamar/salon tamu.
parochial	ks. 1 yang berkaitan dengan gereja/agama. p. school sekolah gereja/agama. 2 picik, sempit.
parody	kb. (j. -dies) parodi, tiruan yang mengejek. -kkt. meniru-niru secara mengejek.
parole	kb. pembebasan bersyarat. to be out on p. dilepaskan dengan bersyarat. -kkt. membebaskan atas jaminan seseorang.
parolee	kb. orang (hukuman) yang dilepaskan dengan jaminan.
paroxysm	kb. serangan hebat. a p. of coughing serangan batuk yang hebat.
parquet	kb. 1 lantai dari papan yang bergambar. 2 tempat penonton diantara panggung dan balkon.
parries	lih parry.
parrot	kb. burung beo, nuri. -kkt. membebek. parrot-fashion tidak tahu arti yang dikatakan.
parry	kkt. (parried) 1 mengelakkan, menangkis (a question). 2 menangkis (a blow).
parse	parse
parsimonious	ks. terlalu hemat, kikir, pelit, lokek.
parsimony	kb. sifat hemat, kekikiran.
parsley	kb. peterseli, daun sup.
parsnip	kb. semacam wortel.
parson	kb. pendeta.
part	kb. 1 bagian. 2 peranan. 3 belah, kuak (in the hair). 4 pihak. 5 daerah, tempat. part-time ks. setengah/sebagian waktu. -parting kb. 1 perpisahan. 2 perceraian (of married couple) ks. terakhir. -partly kk. sebagian
part.	[participle] partisip.
partake	kki. (partook, partaken) 1 ikut serta, mengambil bagian. 2 makan, minum.
partaken	lih partake.
partial	ks. 1 sebagian. 2 memihak, berat sebelah. 3 suka kepada. 4 pilih kasih. -partially kk. sebagian.
partiality	kb. (j. -ties) sikap memihak. to show p. to s.o. menunjukkan sikap memihak terhadap seseorang.
participant	kb. peserta. p. in a conference peserta dalam konperensi.
participate	kki. mengikutsertakan, mengambil bagian (in dalam).
participation	kb. pengambilan bagian, pengikutsertaan.
participial	ks. yang berkaitan dengan partisip.
particle	kb. 1 butir. 2 unsur. 3 gram.: partikel.
particular	kb. particulars j. fakta-fakta, keterangan-keterangan. -ks. 1 teliti. 2 khusus. -particularly kk. terutama sekali, (ter)istimewa.
partisan	kb. 1 pendukung kuat terhadap sesuatu atau seseorang. 2 gerilya, partisan. -ks. pengikut.
partisanship	kb. sifat/sikap berat sebelah.
partition	kb. 1 sekat, dinding antara pemisah. 2 pembagian. -kkt. menyekat, membagi (sesuatu) menjadi dua.
partner	kb. 1 pasangan, jodoh (in marriage, a game). 2 sekiti, kompanyon (in business).
partnership	kb. persekutuan, perkongsian.
partook	lih partake.
partridge	kb. semacam ayam hutan.
parturition	kb. proses kelahiran.
party	kb. (j. -ties) 1 partai. 2 pesta. 3 kelompok, kumpulan orang. 4 orang atau nomor telepon yang mau bicara. -kki. 1 berpesta. 2 pergi pesta, ikut berpesta.
pasonage	kb. rumah pendeta.
pass	kb. 1 pas jalan. 2 kartu (free bebas). 3 jalan kecil yang dalam. 4 nilai, angka. -passing kb. 1 meninggalnya, wafatnya. 2 berlalunya (of time)
passable	ks. 1 dapat diseberangi (of a river). 2 agak baik. -passably kk. boleh juga, cukup baik.
passage	kb. 1 jalan lintasan, gang. 2 tempat di kapal (terbang). 3 bagian (in a book). 4 penerimaan. 5 perjalanan 6 karcis naik kapal.
passageway	kb. gang, jalan terusan.
passe	ks. ketinggalan jaman.
passenger	kb. penumpang. p. car. mobil penumpang. p. ship kapal penumpang.
passer	kb. pelempar (of a ball). p. of a bad check penarik cek kosong.
passer-by	kb. (j. passers-by) orang yang lewat/lalu.
passion	kb. 1 nafsu, keinginan besar. to have a p. for work bernafsu bekerja. 2 kegemaran (for pada).
passionate	ks. bernafsu, penuh gairah. - passionately kk. dengan nafsu.
passive	ks. 1 pasif, tidak giat (of a person). 2 gram.: pasif (of a verb). -passively kk. dengan pasip.
passiveness	kb. ketidakpedulian, kepasifan.
passivity	kb. = passivenes.
passkey	kb. kunci maling.
passover	kb. perayaan paskah kaum yahudi.
passport	kb. 1 paspor. p. photo pasfoto. 2 kunci (to happiness).
password	kb. kata tegoran.
past	kb. masa lalu. -ks. 1 bekas. 2 lewat. 3 lalu. p. participle bentuk katakerja yang menunjukkan bahwa sesuatu pekerjaan sudah dilakukan. p. tense bentuk katakerja yang menyatakan bahwa pekerjaan telah terjadi pada waktu yang lalu.
paste	kb. perekat, lem. -kkt. 1 melekatkan, merekatkan, menempelkan (in didalam). 2 sl.: meninju. -sl.: pasting kb. pukulan.
pasteboard	kb. papan pengumuman, papan penempelan berita-berita.
pastel	ks. pastel, kapur berwarna. p. color warna pastel.
pasteurize	kkt. memberantas kuman-kuman penyakit dengan memanaskan hingga 70c.
pastime	kb. hiburan, pelengah waktu, rekreasi, perlengah hati/waktu.
pastor	kb. pendeta.
pastoral	ks. 1 yang berkaitan dengan pendeta. 2 yang berkaitan dengan penghidupan pengembalaan atau dengan pedusunan.
pastrami	kb. daging sapi bagian bahu yang diasap.
pastry	kb. (j. -ries) kue kering. p. shop toko kue-kue.
pasture	kb. padang rumput. -kki. membiarkan makan rumput, menggembalakan.
pastureland	kb. padang rumput.
pasty	ks. 1 pucat (of complexion). 2 seperti bubur.
pat	kb. 1 tepukan. 2 ulasan. -ks. tepat, cocok, sepadan. -kkt. (patted) menepuk (on the back, cheek).
patch	kb. 1 auto.: tambalan. 2 potongan kecil (over an eye). 3 bidang kecil tanah. 4 potong. -kkt. menambal, menempeli. patch-up ks. seada-adanya. p. up job pekerjaan/ tambalsulam seada-adanya.
patchwork	kb. 1 penjahitan kain perca. 2 kain tambal seribu. 3 potongan kecil-kecil 4 campur aduk.
patchy	ks. setengah-setengah, tidak selesai/lengkap/sempurna.
pate	kb. kepala. his bald p. kepalanya yang botak.
patent	kb. paten. -ks. terang, jelas, nyata. -kkt. mendapat paten untuk.
paternal	ks. pihak ayah. p. grandfather kakek dari pihak ayah.
paternalism	kb. bapakisme.
paternalistic	ks. kebapak-bapakan.
paternity	kb. ayah, hal berbapak.
path	kb. 1 (garden) jalan kecil. 2 garis edar (of a satellite).
pathetic	ks. menyedihkan, sedih, pedih.
pathfinder	kb. pandu, pramuka.
pathological	ks. mengenai hama/penyakit.
pathologist	kb. ahli patologi.
pathology	kb. (j. -gies) ilmu penyakit.
pathos	kb. rasa kesedihan/penderitaan.
pathway	kb. jalan kecil.
patience	kb. kesabaran. to exhaust o's p. habis kesabarannya.
patient	kb. pasien. -ks. sabar, panjang usus. -patiently kk. dengan sabar.
patio	kb. emper terbuka dibelakang rumah (di pekarangan).
patois	kb. logat daerah.
patriarch	kb. kepala keluarga.
patriarchal	ks. patriarkhal, perayahan.
patriarchy	kb. (j. -chies) sistim kemasyaraklatan yang menentukan ayah sebagai kepala keluarga.
patrician	kb. bangsawan, ningrat.
patricide	kb. pembunuhan ayah sendiri.
patrilineal	ks. patrilinial, menurut garis keturunan ayah.
patrimony	kb. (j. -nies) warisan dari ayah atau leluhur.
patriot	kb. patriot, pencinta tanah air.
patriotic	ks. patriotik.
patriotism	kb. patriotisme, kecintaan kepada tanah air.
patrol	kb. patroli. -kkt. merondai (an area). -kki. meronda, (ber)patroli.
patrolman	kb., (j. -men) 1 polisi (ronda). 2 patroli, peronda.
patron	kb. 1 pelindung, penyokong (of the arts). p. saint orang suci yang dijadikan pelindung. 2 langganan (of a restaurant).
patronage	kb. 1 (per)lindungan. 2 langganan.
patroness	kb. pelindung, penyokong (wanita).
patronize	kkt. berlangganan (a certain shop).
patronymic	kb. nama yang hampir sama dengan nama ayah.
pattela	kb. tempurung lutut.
patter	kb. 1 cakap cepat. 2 derai, rintik (of rain). 3 suara derai (of feet). -kki. 1 berketepuk-ketepuk (of feet). 2 berderai-derai. (of rain).
pattern	kb. 1 pola, mal (of a dress). 2 susunan gambar dan warna (on material). 3 pola, contoh, teladan (of behavior). -kkt. mencontoh, meneladan.
patty	kb. (j. -ties) p. shell semacam kue pastel.
paucity	kb. kekurangan.
paunch	kb. 1 perut gendut. 2 perut.
pauper	kb. orang miskin/fakir.
pause	kb. 1 selaan, istirahat. 2 waktu istirahat/jedah. -kki. berhenti sebentar.
pave	kkt. 1 meratakan, mengaspal (road, street). 2 membuka. -paving kb. 1 trottoar, kakilima. 2 ubin, bahan hamparan.
pavement	pavement
pavilion	kb. pavilyun.
paw	kb. 1 cakar, kaki. 2 inf.: tangan. -kkt. 1 mencakar. 2 mengais-ngais (the ground).
pawn	kb. pion, bidak (in chess, in a power struggle). -kkt. menggadaikan. p. ticket surat gadai.
pawnbroker	kb. pemilik rumah gadai.
pawnshop	kb. rumah gadai, penggadaian.
pay	kb. 1 upah, gaji. 2 bayaran. -kkt. (paid) membayar. paid lunas, dibayar. -paying kb. pembayaran. ks. bayaran, gaji.
payable	ks. 1 dapat dibayar. 2 untuk dibayarkan kepada.
paycheck	kb. cek upah/gaji.
payday	kb. hari bayaran, habis bulan.
payee	kb. yang dibayar.
payer	kb. pembayar.
payload	kb. 1 bagian muatan yang menghasilkan untung. 2 alat-alat, kendaraan atau satelit dalam sebuah roket.
paymaster	kb. pembayar gaji, juru bayar, kasir.
payment	kb. 1 bayaran. 2 pembayaran.
payoff	kb. 1 pembayaran gaji. 2 hasil. 3 sl.: hadiah, hukuman.
