a	kb. huruf pertama dalam abjad inggris. 2 angka yang baik sekali. 3 nada a. a- bomb bom atom. a-1 ks. 1 kelas satu. 2 ulung.
a la, a la	menurut , secara. a. carte menurut kartu makanan, boleh memesan satu demi satu. a. hollywood secara hollywood. a. king dilapisi dgn lombok hijau. chicken a. king ayam yang dilapisi dgn lombok hijau.
a priori	kk. berdasar teori daripada kenyataan yang sebenarnya.
a.c.	(alternating current) arus bolak-balik
a.d.	[anno domini] t.m. [tarich masehi] sesudah lahirnya nabi isa.
a.m.	(ante meridiem) waktu dari jam 12 malam hingga 12 siang 7 a.m.jam 7 pagi .
aaa	1 ( american automobile association) ikatan mobil amerika. 2 (american antrhopological association) ikatan ilmu bangsa-bangsa amerika.
aaas	(american association for the advacement of science) perkumpulan amerika untuk kemajuan ilmu pengetahuan.
aau	(amateur athletic union) perserikatan atlit amatir.
abaca	kb. pisang manila/serat.
aback	kk. lih take.
abacus	kb. se(m)poa, sipoa.
abaft	kk. buritan, di belakang.
abalone	kb. tiram/kerang laut.
abandon	kb. bebas..--kkt. 1 meninggalkan (ship). 2 memutuskan (hope).3 melepaskan, meninggalkan, membuang. 4. menyerahkan.
abandoned	ks. 1 yang ditinggalkan. an a. house or ship rumah atau kapal yang ditinggalkan. 2 yang dibuang. an a. child anak yang dibuang, anak yang tak diurus lagi.
abandonment	kb. 1 keadaan tertinggal. 2 dengan bebas.
abase	kkt. to a. o.s. before merendahkan diri terhadap.
abasement	kb. penghinaan, kerendahan diri.
abash	kkt. memalukan.
abashed	ks. malu, bingung, kebingungan.
abate	kki. 1 (me)reda. the storm abated angin ribut (me)reda. 2 mengurang, berkurang . the pain abated sakitnya mengurang. perasaan sakit itu berkurang.
abattoir	kb. pembantaian, pejagalan, tempat pemotongan.
abbess	kb. kepala biara wanita.
abbey	kb. biara.
abbot	kb. kepala biara pria.
abbreviate	kkt menyingkatkan, memendekkan --kki . menyingkat. he abbreviates a great deal in his memos ia menyingkat banyak dalam catatan - catatannya.
abbreviated	ks. yang disingkatkan. a. shorts celana pendek yang pendek sekali.
abbreviation	kb. 1 singkatan, kependekan. 2 perpendekan.
abc	kb. 1 abjad. that child knows his abc's anak itu tahu abjad. 2 ( american broadcasting company) perusahaan siaran amerika.
abdicate	kkt. 1 turun takhta. 2 melepaskan . to a. o's responsibility melepaskan tanggung jawab nya. --kki. turun takhta. the king abdicated raja itu turun takhta.
abdication	abdication
abdomen	ks. perut, daerah perut.
abdominal	ks. yang berhubungan dengan perut a. operation pembedahan perut.
abduct	kkt. menculik, mengalap, melarikan (dengan paksa). the stranger abducted the woman. orang yang tak dikenal itu menculik perempuan itu.
abduction	kb. penculikan. a. of a child is a crime punishable by death penculikan anak adalah kejahatan yang dapat dihukum mati.
abductor	kb. penculik.
abeam	kk. (ditengah) rusuk.
abegging	ks.,kk. tidak diinginkan.scholarships often go a. beasiswa-beasiswa sering tak dimanfaatkan.
aberrant	ks. yang menyimpang dari kebiasaan a. behavior tingkah laku yang menyimpang dari kebiasaan
aberration	kb. penyimpangan, penyelewengan, keluar-kebiasaan, sikap/tindakan yang berlainan.
abet	kkt. (abetted) bersekongkol dengan. he abetted his companion in the theft ia bersekongkol dengan temannya dalam pencurian itu.
abetment	kb.. penghasutan.
abettor	kb. kaki tangan, penolong dalam kejahatan.
abeyance	kb. penundaan. in a. terkatung-- katung, ditangguhkan. the matter was held in a. until the committee presented its report masalah itu untuk sementara ditangguhkan pembahasannya. menunggu sampai panitia menyampaikan laporannya.
abhor	kkt. (abhorred) benci akan. tidak menyukai. i a. his wickedness saya benci akan kejahatannya. nature abhors a vacuum alam tidak menyukai kehampaan.
abhorred	kb. benci, kebencian, kejijikan, kemualan. his a. of corruption kebenciannya akan kecurangan.
abhorrent	ks. benci, jijik. the murder was a. to him pembunuhan itu menjijikkan baginya.
abide	--kki. 1 ada. hope still abides harapan masih ada. 2 tinggal, diam. to a. in the forest tinggal/berdiam di hutan.
abiding	ks. kekal, tak kunjung hilang. he has an a. interest in money ia mempunyai perhatian yang tak kunjung hilang terhadap uang.
ability	kb. ( j.-ties) 1 kecakapan, bakat, kemampuan. 2 kemampuan. 3 ketangkasan. 4 kesanggupan.
abject	ks. hina (papa), hina dina, rendah. a. poverty kemiskinan yang hina papa.
ablative	ks. ablatif, kasus kelima.
ablaze	ks. 1 terbakar berkobar-kobar. the building was a. gedung itu sedang terbakar berkobar-kobar. 2 terang benderang. the street was a. with lights jalan itu terang benderang.
able	ks. 1 dapat, bisa, sanggup, mampu. 2 cakap, trampil. 3 berwewenang.4 yang menunjukkan kecakapan.
ablution	kb. pembersihan, pencucian. ritual a. wudu
abnormal	ks. 1 abnormal, aneh. a. behavior tingkahlaku yang tidak normal. a. psychology psikologi abnormal. 2 luar biasa, abnormal.
abnormality	kb. (j. -ties) 1 kelainan. a. of the thumb kelainan dari ibu jari. 2 ketidaknormalan.
aboard	kk. 1 di (atas, dalam). 2 naik
abode	kb. 1 tempat kediaman. this is my humble a. inilah gubuk saya. 2 lih. abide.
abolish	kkt. menghapuskan, mengakhiri, meniadakan. to a. slavery menghapuskan perbudakan.
abolishment	kb. penghapusan. a. of secret organizations penghapusan dari organisasi rahasia.
abolition	kb. penghapusan, pembasmian, abolisi. a. of slavery penghapusan dari perbudakan.
abolitionist	kb. anggota gerakan penghapusan s.s.t., seorang yang ingin menghapuskan s.s.t.
abominable	ks. buruk sekali (of food, style).
abomination	kb.s.s.t.yang (sangat) dibenci. exams are an a. ujian adalah s.s.t. yang dibenci
aboriginal	kb. orang asli. he's an a. dia orang asli. --ks. asli, pribumi, a. inhabitant penduduk asli.
aborigine	kb. orang asli, orang pribumi (biasanya sangat bersahaja).
abort	kkt. menggagalkan, menggugurkan. kki. gagal, gugur.
abortion	kb.1 (micarriage) pengguguran kandungan, keluron, abortus, keguguran.2. kegagalan.
abortionist	kb.tukang menggugurkan kandungan aborteur, aborteuse.
abortive	ks.gagal, seman. a. attempt percobaan yang gagal.
abound	kki. to a. in berlimpah-limpah .to a. with penuh dgn. the ship abounds with rats kapal itu penuh dengan tikus.
about	kk. 1 kira-kira.2 hampir.3 baru saja mau.4 dimana-mana.5 disana-sini .6 kesana-sini.
above	kb. yang diatas. --ks. tersebut diatas --kk. (di) atas. --kd. 1 diatas. 2 bebas dari. 3 lebih tinggi dari. 4 sukar, sulit above-average ks. lebih dari biasa.
aboveboard	ks. tulus hati, ikhlas, jujur. his actions are a. perbuatan-perbuatannya adalah tulus hati. the management of that business so far has proved a. pimpinan perusahaan itu sampai sekarang ternyata jujur.
aboveground	ks., kk. diatas (permukaan) tanah. a. grave mound tumpukan kuburan diatas tanah. some snakes live a. beberapa macam ular hidup diatas permukaan tanah.
abovementioned	ks yang tersebut diatas.
abracadabra	kb. 1 omong kosong, bukan-bukan. 2 ucapan pendek yang dipakai sebelum menyihir s.s.t. atau mengerjakan sunglap; sim-sala-bim.
abrasion	kb. luka lecet, kegores ringan.
abrasive	kb. 1 penggosok, alat pengempelas, ampelas. 2 penggosok, obat asah. ks. kasar, kesat.
abreast	kk., ks.berbaris dua-dua. to be a. of/with mengikuti
abridg(e)ment	kb .1 pemendekan, penyingkatan, (ke) singkatan. a. of a dictionary pemendekan kamus. 2 pembatasan, pelanggaran. a. of human rights pembatasan hak manusia.
abridge	kkt. 1 memendekkan, memperpendek, menyingkat, mempersingkat. 2 membatasi, mengurangi. 3 mengikhtisarkan.
abridged	abridged
abroad	kk. 1 luar negeri.2 dgn luas. 3 tersiar,tersebar.4 meninggalkan rumah.
abrogate	kkt. mencabut, membatalkan.
abrogation	kb. pencabutan, pembatalan, penghapusan. a. of a treaty pencabutan perjanjian.
abrupt	ks.1 kasar. 2 tiba-tiba,tak tersangka, mendadak.3 curam, terjal.
abruptly	kk. 1 dgn kasar. 2 dgn tiba-tiba.
abruptness	kb. kekasaran, kekurangajaran 2 kecuraman, keterjalan.
abs	1 tak hadir, mangkir. 2 mutlak. 3 abstrak.
abscess	kb. abses. barah. bisul bernanah, bengkak bernanah.kki.menjadi abses, membisul.
abscessed	ks. kena abses, bengkak bernanah.
abscissa	kb. absis.
abscond	abscond
absence	kb. 1 kemangkiran.2 ketidak hadiran.3 ketiadaan, ketidakadaan, kekurangan.
absent	ks.absen, mangkir,tak hadir.kkt. meninggalkan.absent-minded ks. 1 lupa-lupa, linglung, mengelamun. 2 pelupa,pelalai.
absentee	kb. s.s.o. yg tak ada atau tak hadir di tempatnya.
absenteeism	kb. ketidakhadiran, kemangkiran.
absentmindedness	kb. kelinglungan
absinthe	kb. absinth
absolute	kb. absolutes j. hal-hal yg mutlak (spt kebenaran, keadilan dsb).-ks. 1 penuh, sepenuhnya. 2 mutlak. 3 nyata.4 pasti,tentu,positip . 5 absolut 6.sebetulnya,sesungguhnya.
absolutely	kk. 1 sama sekali, betul, benar. 2 memang.
absolution	kb. 1 absolusi.2 pengampunan pengampunan/permaafan dosa.
absolve	kkt. membebaskan, memerdekakan. he was absolved from his promise ia dibebaskan dari janjinya
absorb	kkt.1 mengisap, menyerap. 2 menahan, menyangga 3 menangkap,mengerti. 4 mengabsorbir, menampung. 5 memikat,mengasyikkan. 6 mengisap, menyedot, menghirup, membuat menyerap.
absorbed	ks. asyik,terpikat.
absorbent	ks.pengisap.a. cotton kapas pengisap/pembalut.
absorbing	ks.1 sangat menarik. 2 mengasyikkan.
absorption	kb. 1 pengisapan. penyerapan, absorpsi.2 penggabungan perusahaan kecil kedalam perusahaan yg lebih besar. 3 kekhusyukan,keasyikan.
absorptive	ks.yg berh.dgn absorpsi. a. capacity daya absorpsi.
abstain	kki. 1 berpantang.2 menjauhkan diri, tak memberi suara.
abstainer	kb. pemantang. he's an a . ia pemantang alkohol.
abstemious	ks. bebas dari minuman keras.
abstention	kb.1 abstensi.2 suara blangko.
abstinence	kb. pertarakan, pantang, pemantangan, penahanan nafsu
abstract	ks. 1 abstrak. 2 mujarad. -kkt. 1 meringkaskan, mengintisarikan, mengikhtisarkan. 2 memisahkan.
abstraction	kb. 1 abstraksi, keniskalan. 2 pemisahan, pemindahan.
abstruse	ks. mus(y)kil, sulit dimengerti, mendalam. physics is an a. subject ilmu alam adalah mata pelajaran yang muskil.
abstruseness	kb. kedalaman, kemuskilan.
absurd	ks. 1 (impossible, unreasonable, out of the question) mustahil, tak masuk akal. 2 (ridiculous, laughable) menggelikan, menertawakan.
absurdity	kb. (yj -ties) kemustahilan, keadaan yang bukan-bukan.
absurdly	kk. bukan main.
abundance	kb. kelimpahan, keadaan berlimpah-limpah. an a. food bahan makanan yang berlimpah-limpah..
abundant	ks. berlebih-lebih, berlimpah-limpah.
abundantly	kk. berlimpah-limpah, berlimpah-ruah.
abuse	kb. 1 penyalahgunaan, salah-pakai. 2 perlakuan kejam, siksaan. 3 makian. -kkt. 1 (misuse) menyalahgunakan. 2 (mistreat) memperlakukan dengan kasar/kejam/keji. 3 (scold, insult) memaki-maki, mencacimaki. 4 mengkhianati.
abusive	ks. kasar, kejam, menghina.
abut	kki. (abutted) berbatas kepada, berbatasan. the two yards a. upon e.o. dua halaman itu berbatasan satu sama lain.
abysmal	ks. bukan kepalang. his ignorance is a. kejahilannya bukan main.
abyss	kb. jurang ngarai yang dalam sekali.
academic	kb. akademikus, sarjana.ks. 1 akademis.2 menurut teori,
academician	kb. akademikus, sarjana. academicians j. kaum akademisi.
academy	kb.(j.mies) 1 akademi.2 sekolah menengah (biasanya swasta/partikelir).
acc.	1 rekening.2 (according) menurut. 3 (accusative) kasus keempat, akuativ.
accede	kki. 1 mengabulkan, menyetujui .2 naik.3 ikut serta.
accelerate	kkt. mempercepat,melajukan.-kki. mempercepatkan jalannya.
accelerated	ks. yg di percepat.
acceleration	kb. 1 percepatan, perlajuan (mobil, pertumbuhan ekonomi). 2 akselerasi
accelerator	kb. pedal gas, akselerator, alat pemercepat
accent	kb. 1 logat, aksen,2 tekanan.3 titik berat, tekanan.- kkt.memberi tekanan pada, menekankan.
accentual	ks. beraksen. much poetry is a. kebanyakan puisi beraksen.
accentuate	kkt. 1 menonjolkan.2 menekankan (pd), mengutamakan, mementingkan.to a.safety measures menekankan (pd) tindakan-tindakan keselamatan.
accentuation	kb.1 penekanan, tekanan. 2 penitikberatan.
accept	kkt. 1 menerima (baik) 2 menyetujui,mengabulkan.-kki. menerima.
acceptability	kb. hal dapat diterima.
acceptable	ks.1 dpt diterima,2 pantas cocok.
acceptance	kb.1 penerimaan.2 sambutan, dukungan.
accepted	accepted
access	kb. jalan masuk.there is a to their yard ada jalan masuk ke halaman mereka.
accessibility	kb. hal dapat masuk, hal mudah dicapai.
accessible	ks. dapat diperoleh.2 dapat menerima, dpt dicapai.3 dpt diambil 4 mudah didatangi,5 dpt didatangi.
accession	kb. penaikkan.2 tambahan. 3 pencapaian.
accessory	kb. (j -ries) 1 barang tambahan, alat ekstra.2 law : kaki tangan.
accident	kb.kecelakaan.kebetulan. accident-prone ks. mudah tertimpa kecelakaan,sering tertimpa bencana.
accidental	ks. kebetulan.an a. meeting suatu pertemuan yg secara kebetulan.
accidentally	kk. 1 (dgn) tdk sengaja. 2 (secara) kebetulan.
acclaim	kb. tepuk tangan sorak.-kkt. 1 menyambut dengan gembira. 2 menyatakan. 3 menyoraki.
acclamation	kb. 1 aklamasi,suara bulat. 2 sambutan gembira,sambutan dgn (ber) tepuk tangan.
acclimate	kkt. menyesuaikan diri kpd suatu iklim.
acclimatize	= acclimate.
accolade	kb. penghargaan, penghormatan, pujian.
accommodate	kkt.1 memuat, menampung. 2 memberi akomodasi/penginapan. 3 menolong.4 menyesuaikan/ mencocokan diri.5 mendamaikan.
accommodating	ks. peramah, baik hati, suka menolong.
accommodation	kb. 1 pertolongan, bantuan. 2 penyesuaian diri.3 penggunaan.
accommodations	j. akomodasi, penginapan.
accompanist	kb. pengiring.
accompany	kkt a.(ed) 1 menemani, menyertai. 2 mengiringi.
accompanying	ks. yg mengiringi,yg mendampingi, yg menemani.
accomplice	kb. kaki tangan,antek.
accomplish	kkt.1 menyelesaikan, menyempurnakan.2 menyelesaikan, mengerjakan.
accomplished	ks. ulung, pandai.
accomplishment	kb.1 prestasi.2.kepandaian kecakapan.3 penyelesaian, pencapaian.
accopaniment	kb. 1 iringan (bunyi-bunyian). 2 menyertai.
accord	kb.1 persetujuan.2 keserasian.-kkt. memberi, menyampaikan. kki. cocok, sesuai,selaras,seia-sekata.
accordance	kb. in a. with 1 sesuai dgn, menurut.2 berkenaan dgn, sesuai dgn,memenuhi.
accordingly	kk.1 sesuai dgn itu. 2 jadi, karena itu, maka.
accordion	kb. akordeon, harmonika tangan.
accordionist	kb. pemain akordion.
accost	kkt.1 menyapa, menegur 2 mendekati,mendatangi.
account	kb. 1 laporan, cerita.2 catatan, rekening.3 uang,rekening. 4 tanggungan,rekening, nama. 5 harga, nilai.6 bagi/karena seorang.7 perhitungan.8 (charge) saya boleh berhutang di toko ini.
accountability	kb. keadaan untuk dipertanggung-jawabkan, keadaan dpt dimintai pertanggung-jawab.
accountable	ks. bertanggung-jawab. he is a. for the child's unhappiness ia bertanggung-jawab atas kesusahan anak itu.
accountancy	kb. akuntansi, pembukuan.
accountant	kb. akuntan.
accounterments	kb. j. perlengkapan-perlengkapan prajurit.
accounting	kb 1 akuntansi. 2 laporan.
accredit	kkt. 1 memberi kuasa resmi kpd seorang wakil, mengangkat seorang wakil.2 mengakui (sesudah memenuhi syarat-syarat resmi).
accreditation	kb. 1 pengakuan. a. of a school pengakuan sekolah. 2 pengangkatan.a. of our ambassador to finland pengangkatan duta besar kita untuk finlandia.
accredited	ks. yg diakui keahliannya, yang berijazah.
accretion	kb. (per)tambahan, (per)tumbuhan. the last part of the epict is a later a. bagian terakhir syair kepahlawanan itu adalah tambahan belakangan.
accrue	kki. bertambah, tumbuh. interest will a. with savings bunga akan bertambah dengan bertambahnya uang simpanan.
acct.	rekening, uang di bank.
acculturate	kkt. menyesuaikan diri (kepada adat kebudayaan baru atau kebiasaan asing).
acculturation	kb. akulturasi, penyesuaian diri.
accumulate	kkt. mengumpulkan, menghimpun (wealth). --kki. bertumpuk sedikit demi sedikit, mengumpul. dust accumulates on the table debu bertumpuk sedikit demi sedikit diatas meja.
accumulation	kb. 1 pengumpulan, penghimpunan, penimbunan. 2 timbunan. a. of dust timbunan debu.
accuracy	kb. 1 ketelitian, keseksamaan. 2 a. of a report ketelitian suatu laporan. 3 kecermatan, ketepatan. the a. of his shooting was amazing ketepatan penembakannya mengherankan.
accurate	ks. 1 teliti, cermat, seksama. an a. bookkeeper seoang pemegang buku yang teliti. 2 tepat. that's not a.statement pernyataan itu tidak tepat.--accurately kk. dengan teliti/seksama/tepat.
accurateness	kb.ketelitian, keseksamaan.
accursed	ks. terkutuk, keparat. a. devil syaitan terkutuk. a. child anak keparat.
accus.	akusatip.
accusation	kb. tuduhan, penuduhan, (pen) dakwaan, dakwa. what is the a. against him? apa tuduhan terhadap dia ?
accusative	kb. akusatip, penderita, kasus keempat. a. case kasus keempat.
accuse	kkt. 1 menuduh. 2 menyalahkan.
accused	kb. terdakwa, tertuduh. --ks. yang terdakwa. the a. man orang laki-laki yang terdakwa.
accuser	kb. pendakwa, penuduh.
accustom	kkt. membiasakan, menyesuaikan.
accustomed	ks. 1 biasa. 2 membiasakan diri.
ace	kb. 1 bridge: kartu as..2 ahli, jempolan, jago. --ks. ulung. ..--kkt. to a. o's opponent mengalahkan lawannya dgn pukulan service yg mematikan.
acerbity	kb. (j. -ties) 1 rasa masam. 2 kemarahan. the a. of his remark astounded me ucapannya yg pedas itu mengejutkan (bagi) saya.
acetate	kb. asetat, cuka asam (garam), garam cuka.
acetic	ks. yang bersifat asetat. a. acid cuka, asam asetat.
acetylene	kb. asetilen, gas karbid. a. torch lampu assetilen, tangkai las asetilen, api karbid.
ache	kb. 1 sakit. 2 rindu. 3 ingin sekali.
achieve	kkt. mencapai. to a. success mencapai sukses.
achilles	kb. achilles. a. heel kelemahan, sifat yg lemah. a tendon urat keting
aching	ks. sakit, sakit-sakitan. a. back punggung yang sakit.
achy	ks. sakit. i feel a. saya merasa sakit (tidak enak badan). saya sakit.
acid	kb. 1 asam, hamud.--ks. 1 asam, masam. 2 tajam. she has an a. tongue lidahnya tajam. an a. remark pernyataan yang tajam.
acidity	kb. (j. -ties) 1 kadar asam/masam. 2 keasaman. a. of a lemon keasaman jeruk . 3 ketajaman.
acknowledge	kkt. 1 mengakui. 2 menyatakan. 3 menjawab.
acknowledgment	kb. 1 pengakuan. 2 penghargaan. 3 balasan, sambutan. 4 surat tanda terima.
acknowledgments	j. pernyataan-pernyataan tanda terima kasih.
acls	(american council of learned societies) dewan perkumpulan kesarjanaan amerika.
acme	kb. puncak. the a, of success puncak kesuksesan/kejayaan.
acne	kb. jerawat.
acolyte	kb. pembantu pendeta pada upacara misa.
acorn	kb. buah atau biji pohon ek.
acoustic	ks. akustik. a. phonetics fonetika akustik. a. tile genteng menyerap bunyi, genteng akustik.
acoustical	ks.= acoustic.
acoustics	kb. ilmu suara, ilmu bunyi akustik.
acquaint	kkt. 1 memperkenalkan 2 mempelajari, mengetahui.
acquaintance	kb. 1 kenalan. we are acquaintances kami kenalan. kami talah berkenalan. 2 pengetahuan, tahu. i have some a. with chemistry saya mengetahui sedikit tentang kimia.
acquaintanceship	kb. 1 perkenalan. an a. of long standing perkenalan yang lama. 2 pengetahuan. an a. whith several languages pengetahuan dengan beberapa bahasa.
acquiescence	kb. persetujuan tanpa protes/dgn diam-diam. our a. in their plan made us guilty too persetujuan kita tanpa protes terhadap rencana mereka membuat kita ikut bersalah.
acquiescent	ks. yang menyetujui diam-diam. she has an a. nature dia adalah seorang yang menyetujui diam-diam.
acquire	kkt. 1 memperoleh, mendapatkan. 2 belajar.
acquired	ks. yang diperoleh.
acquirement	kb. kecakapan, kepandaian yang diperoleh. his language acquirements are astounding kecakapan bahasanya mengagumkan.
acquisce	khi. menyetujui tanpa bantahan, setuju dgn bersikap diam. we were forced to a. in their plan kita terpaksa menyetujui rencana mereka tanpa protes.
acquisition	kb. 1 kemahiran. 2 tambahan, pendapatan. 3 tambahan buku-buku. 4 perolehan, penerimaan
acquisitive	ks. 1 tamak, serakah. he is very a. ia tamak sekali. 2 keras/gigih untuk memperoleh s.s.t.
acquit	kkt. (acquitted) membebaskan. 2 bertingkahlaku.
acquittal	kb. 1 pembebasan. 2 pelunasan. a. of a debt pelunasan utang.
acre	kb. ukuran tanah (=4840 yar persegi: 0.4646 ha).
acreage	kb. luas ukuran atau jumlah luas tanah dalam acre.
acrid	ks. 1 tajam.a.odor bau tajam. 2 pedas, sengit, tajam. a. remarks ucapan-ucapan yang pedas. 3 menjengkelkan, mendongkolkankan.a. manner kelakuan yang mendongkolkan.
acrimonious	ks. sengit, tajam. a. debate percekcokan sengit.
acrimony	kb. (j. -nies) kesengitan. ketajaman.
acrobat	kb. akrobat, penambul.
acrobatic	kb. acrobatics j. bermain senam, kemahiran bertambul. --ks. akrobatis.
acronym	kb. akronim,singkatan yang dibentuk dari huruf-huruf kata uraian. radar is an a. radar adalah akronim.
acrophobe	kb. penggamang.
acrophobia	kb. gamang, (rasa) takut akan jatuh dari tempat yang tinggi
across	kk. jarak lintas. right a. persis , tepat, melewati. to get a. menjelaskan. to put a. membentangkan, menguraikan, mengutarakan. --across-the-board ks. untuk semua.an a.-the-board raise kenaikan untuk semua.
acrostic	kb. sanjak atau susunan kata-kata yang seluruh huruf-awal atau huruf-akhir tiap-tiap barisnya merupakan sebuah kata atau nama diri.
act	kb. 1 perbuatan, fi'il, paal. 2 tindakan 3 babak. 4 undang-undang, keputusan, penetapan. 5 main-main, pura-pura.
action	kb. 1 tindakan, aksi. 2 gerak. 3 kekuatan. 4 tenaga. a man of a. orang yg suka bertindak. --actions j. 1 tindak-tanduk, tingkah-laku. his actions are those of a child tindak-tanduknya seperti kanak-kanak.
activa	ks. 1 aktip, gesit, giat, bersemangat. 2 ikut giat. 3 hidup, masih bekerja,aktip. 4 cepat menjalar, giat. 5 keras, kuat. 6 aktip. 7 giat, ramai.
activate	kkt. 1 menggiatkan, menghidupkan, menggerakkan. to a. an association menggerakkan suatu perkumpulan. 2 meradioaktipkan.
activation	kb. penggerakan, penggiatan. a. of a milittary reseve unit penggerakan dari suatu satuan cadang militer.
activator	kb. 1 penggerak, penggiat. 2 katalis.
activism	kb. aktipisme, aktivisme.
activist	kb. aktivis.
activity	kb. (j. -ties). 1 aktivitas, aktivitet, keaktivitetan. 2 kegiatan. 3 kesibukan, keramaian.
actor	kb.pemain/pelaku pria sandiwara atau film, aktor.
actress	kb. pemain/pelaku wanita sandiwara/film.
actual	ks. 1 sebenarnya. 2 memang betul-betul, sesungguhnya.
actuality	kb. (j. -ties.) keadaan yang sebenarnya/sesungguhnya. in a. sebenarnya. he looks 30 but in a. he's 40 ia kelihatannya umur tigapuluh, tapi sebenarnya ia umur empatpuluh.
actualize	kkt. mewujudkan, melaksanakan.
actually	kk. 1 benar-benar, betul-betul. 2 sebetulnya, sebenarnya, sesungguhnya.
actuarial	ks. yg berhubungan dengan penaksiran sebelumnya penetapan asuransi. a. statistics statistik asuransi.
actuary	kb. (j. -ries) aktuaris, penaksir yang kerjanya mempertimbangkan bahaya-bahaya, ongkos-ongkos dsb.
actuate	kkt. menggerakkan, menjalankan. she was actuated by the finest motives ia digerakkan oleh alasan-alasan yang paling baik.
acuity	kb. ketajaman.
acumen	kb. kecerdasan, ketajaman. business a. ketajaman berdagang, kelihaian berusaha.
acupuncture	kb. pengobatan dengan tusuk jarum.
acute	ks. 1 akut. 2 hangat, akut, genting, gawat.3 halus, tajam. 4 teliti.
acutely	kk. he is a. aware of his weaknesses ia benar-benar mengetahui tentang kelemahannya.
ad	kb. 1 (= advertisement) iklan, adpertensi. 2 tenn.: (=advantage). ad in keuntungan untuk yang serve. ad out keuntungan lawan.
ad hoc	ks. khusus utk s.s.t.maksud. a.commitee panitia khusus.
ad infinitium	terus menerus,tiada hentinya.we can discus this a.kita bisa perbincangkan hal ini terus-menerus.
ad interim	sementara. an a. report laporan sementara.
ad-nauseam	sampai membosankan/memualkan. he talks a. about his relatives dia berbicara tentang sanak saudaranya sampai memualkan.
adage	kb. pepatah, peribahasa.
adagio	ks., kk. perlahan-lahan.
adam	kb. manusia pertama. i don't know him from a. saya sekali-kali tidak mengenalnya. adam's apple lekum. halkum,jakun(g)
adamant	ks. tetap tidak berubah, tak mau menyerah. he was a. ia tak mau merubah pikirannya.
adapt	kkt. 1 membiasakan, menyesuaikan. 2 menyadur.3 merubah. --kki. menyesuaikan diri. children a. easily to new situations anak-anak dgn mudah menyesuaikan diri kepada keadaan baru.
adaptability	kb. pencocokan, penyesuaian. his a. to changing conditions is remarkable kesanggupannya menyesuaikan diri kpd keadaan yg berubah mengagumkan.
adaptable	ks. dapat menyesuaikan diri. he is very a. ia dapat menyesuaikan diri dengan mudah.
adaptation	kb. 1 penyesuaian (diri), pencocokan. 2 saduran. 3 penyaduran. 4 perubahan.
adapter, adaptor	kb. 1 penyadur. 2 pencocok. lens. a. pencocokan lensa.
adaptive	ks. dapat menyesuaikan diri. he is quite a. to the new situation ia dapat menyesuaikan diri dengan mudah kpd keadaan baru itu. a. coloring of a chameleon warna bunglon yang dapat berubah-ubah menurut keadaan.
adc	(aide-de-camp) ajudan, pembantu.
add	kkt. 1 menjumlahkan. 2 menambahkan. 3 mengatakan lagi, menyambung.
added	ks. yang ditambah.
addendum	kb. (j. -nda) lampiran, suplemen, (barang) tambahan.
adder	kb. ular biludak (berbisa).
addict	kb. 1 pe(n)candu.he's a drug a. dia pe(n)candu obat bius. 2 pecandu. she's a movie a. dia pecandu bioskop. addicted ks. kecanduan, ketagihan.
addiction	kb. kecanduan, ketagihan. .
adding	machine mesin hitung/tambah/jumlah.
addition	kb. 1 penjumlahan. 2 tambahan ( ruangan ).
additional	ks. tambahan, ekstra. an a. room tambahan kamar. there is no a. charge for spare parts tidak ada ongkos tambahan untuk onderdil. a. reason alasan lagi.
additive	additive
addlebrained	ks. tak karuan, kacau, berkepala udang. he's a. ia buntu pikiran.
address	kb., 1 alamat. 2 amanat, pidato 3 berbicara, menegur. 4 memanggil, menyapa, menyebut.
addressee	kb. sialamat
addressograph	kb. mesin pencetak alamat.
adduce	kkt. mengemukakan. to a. sufficient evidence to convict the criminal mengemukakan cukup bukti untuk menghukum penjahat itu.
adenoids	kb., j. tumbuh-tumbuh adenoide.
adept	kb. seorang ahli. --ks.1 mahir. a. at/in languages mahir dalam bahasa. 2 cakap, mahir , ahli, trampil. an a. golfer seorang pemain golf yang cakap.
adeptness	kb. kemahiran, kecakapan, keahlian.
adequacy	kb. kecukupan. he questioned the a. of his income ia menyangsikan kecukupan penghasilannya.
adequate	ks. 1 cukup, memadai. my income is a. penghasilan saya cukup. 2 mampu. a. to the task mampu mengerjakan tugas.
adequately	kk. cukup. the house was a. furnished rumah itu cukup perabotannya.
adhere	kki.1 melekat, menempel 2 setia,taat 3 mengikuti,menganut.
adherence	kb. kesetiaan,ketaatan. a. to a religion kesetiaan pd agama.
adherent	kb. pengikut,penganut.
adhesion	kb.1 adhesi 2 pelekatan.
adhesive	kb. bahan perekat.
adhesiveness	1 kelengketan,kelekatan.2 daya merekat.
adj.	1 (adjective) kata sifat.2 (adjunct) ajun (g).
adjacent	ks. berdekatan, berbatasan.
adjectival	ks. sebagai kata sifat.a. phrase rangkaian kata sifat. a. adjunct keterangan benda.
adjective	kb. kata sifat,ajektip. "pretty" is an a.pretty adalah suatu kata sifat.
adjoin	kkt. berdampingan/bergandengan/berbatasan dgn.
adjoining	ks.1 ditengahnya,diantaranya. 2 berdampingan.
adjourment	kb. penundanaan, penangguhan. 2 istirahat.3 pemindahan tempat.
adjourn	kkt. menunda, menangguhkan.-kki. 1 ditunda,2 istirahat,berlibur,tutup.
adjudge	kkt. 1 memutuskan (secara hukum) .2 menghukum.3 memberikan atau menyerahkan secara/menurut hukum.
adjudicate	kkt. bertindak sebagai hakim untuk memutuskan.
adjudication	kb. keputusan hakim atau pengadilan.
adjunct	kb. 1 (barang) tambahan.2 kata atau kalimat keterangan.-ks.ajun (g) pembantu,asisten.
adjure	kkt. meminta dgn sangat, mendesak.
adjusment	kb1. penyesuaian diri,pencocokan. 2 alat penyetel.3 penyetelan.
adjust	kkt. 1 menyetel,mengatur. 2 membetulkan.3 mengurus, menyelesaikan.-kki. 1 menyesuaikan/membiasakan diri. 2 mengatur.
adjustability	kb. ketangkasan/kecakapan menyesuaikan diri.
adjustable	ks. dpt disetel/disesuaikan/dicocokkan.
adjusted	ks. biasa.
adjuster	kb. penaksir dlm tuntutan kerugian biasanya dlm asuransi.
adjutant	kb. ajudan, ajidan. a. general ajudan jenderal.
adlib, ad-lib	kb. pidato tanpa persiapan.-kki. (adlibbed) berpidato tanpa persiapan.
adm	1 (administration) tatausaha, administrasi, pemerintahan. 2 (admiral) laksamana. 3 (admiralty) markas besar al.
administer	administer
administration	kb. 1 administrasi, tatausaha. 2 pemerintahan.3 pelaksanaan.4 pemberian.5 pengambilan.
administrative.	ks.1 administratip.2 ketatausahaan
administrator	kb. pengatur, penyelenggara, pemimpin, pengurus, pengelola.
admirable	ks. mengagumkan, terpuji, dpt dikagumi.
admirably	kk. dgn mengagumkan.
admiral	kb. laksamana. rear a. laksamana muda.
admiralty	kb. (j.-ties) 1 departemen angkatan laut inggris.2 markas besar angkatan laut di london.
admiration	kb. 1 kekaguman,takjub. 2 kebanggaan.
admire	kkt. 1 mengagumi.2 memuji.
admirer	kb. 1 pengagum.2 penggemar.3 pemuja.
admiringly	kk. dgn (penuh rasa) kagum, dgn takjub.
admissible	ks. 1 dpt diterima.2 boleh masuk.only adult are a.to that club hanya orang-orang dewasa saja yg boleh masuk klab itu.
admission	kb.1 hak atau izin masuk.2 karcis masuk.3 pengakuan.
admit	kkt. (admitted) 1 mengakui.2 mengaku.3 menerima 4 memuat (dpt memberikan tempat) 5 mengenal. 6 berlaku utk.
admittance	kb. hak masuk. no a.! dilarang masuk!
admitted	ks.yg diakui.
admittedly	kk.tak dpt disangkal.
admixture	kb. 1 campuran. an. a. of oil and water campuran minyak dan air. 2 adonan.
admonish	kkt. 1 memperingatkan. 2 mengingatkan. 3 menegur.
admonition	kb. 1 peringatan. 2 teguran. 3 nasehat (yang baik). in the a. of the lord diperingatkan oleh tuhan.
ado	kb. ribut, heboh, beributan, kegaduhan. much a. about nothing ribut-ribut mengenai hal sepele.
adobe	kb. bata jemuran, sm batako. a. wall tembok dari bata jemuran.
adolescence	kb. masa remaja, keremajaan.
adolescent	kb. anak remaja. --ks. belum dewasa /matang. his attitude is still a. sikapnya belum dewasa.
adopt	kkt. 1 mengambil, memakai. 2 mengangkat, memungut.3 menyetujui.
adoption	kb. 1 pengangkatan, pemungutan, adopsi, a. of a child pengangkatan anak. 2 pemakaian. a. of new rules pemakaian peratuan-peraturan baru.
adorable	ks. manis (sekali), menawan hati, menarik. she's simply a. in that dress ia sungguh manis dalam baju itu.
adoration	kb. 1 pemujaan, penyembahan. 2 cinta yang mendalam, cinta sejati. 3 pujaan.
adore	kkt. 1 memuja. to a. the gods memuja dewa-dewa. 2 mencintai, cinta akan (s.o). 3 inf.: suka. i a. coca-cola saya suka sekali coca-cola. 4 menyembah. o come, lets us a. him marilah kita menyembahnya.
adorn	kkt. 1 menghiasi. the christmas tree was adorned with decorations pohon itu dihiasi dgn perhiasan-perhiasan.2 memperindah, menghiasi. she was adorned with jewels ia diperindah dgn intan permata.
adornment	kb.1 perhiasan. 2 dandanan.
adrenal	ks. yang berhubungan dengan adrenalin. a. gland kelenjar adrenalin.
adrenalin	kb. adrenalin.
adrift	ks., kk. terapung-apung, hanyut terkatung-katung. the boat was a. kapal itu hanyut terkatung-katung.
adroit	ks. 1 cakap, tangkas, cekat. he's a very a. player ia seorang pemain yang sangat tangkas. 2 cerdas, lihai, cerdik. a. questioning pertanyaan-pertanyaan yang cerdas.
adulate	kkt. memuji-muji berlebih-lebihan.
adulation	kb. puji-pujian yang berlabih-lebihan ( of the crowd).
adult	kb. (orang) dewasa, dewasawan, akil-balikh. she has grown into an a. ia telah menjadi dewasa. --ks. dewasa. an a. movie/film pilem untuk orang dewasa. a. education pendidikan masyarakat.
adulterate	kkt. mencampuri, memalsukan. to a. gasoline with water mencampuri bensin dengan air.
adulteration	kb. pencampuran (sehingga turun nilainya), pemalsuan.
adulterer	kb. pezina, orang yang bermukah.
adulteress	kb. pezina perempuan.
adulterous	ks. bermaksiat, berzina, bermukah, bergendak. a. behavior tingkah-laku yang berzina, perbuatan zina, permukahan.
adultery	kb. (j. -ties) zina(h), perzina(h)an. to commit a. berzina, menggendaki, bermukah.
adulthood	kb. masa dewasa, kedewasaan.
adumbrate	kkt. membayangkan.
adv.	1 (adverb) kata keterangan. 2 (advertisement) iklan. 3 (advvocate) pengacara. (advent) musim adven.
advance	kb. 1 kemajuan. 2 kenaikan, penaikan.3 cumbu-cumbuan, cumbuan, rayuan.4 persekot, uang muka. --ks. 1 yg dulu, terdahulu, dimuka. .2 sebelumnya. --kkt. 1 memajukan. 2 mempercepat, mendahulukan. 3 memberi. 4 meminjamkan kepada,meminjami.
advanced	ks 1 maju, teerdepan. 2 lanjutan, lebih maju dari yang lain. 3 telah lanjut, tua. 4 parah.
advantage	kb. keuntungan. to take a. of 1 mengambil (menarik) keuntungan dari. 2 mempergunakan kesempatan, menarik keuntungan dari.
advencement	kb. 1 kemajuan,pemajuan..a. of knowledge kemajuan ilmu pengetahuan. 2 promosi, kenaikan pangkat. his present position is a big a. for him kedudukannya yang sekarang adalah promosi yang besar baginya.
advent	kb. 1 kedatangan, datangnya. the a. of spring datangnya musim semi. 2 musim adven.
adventageous	ks. menguntungkan, berfaedah, berguna. an a. position kedudukan yang menguntungkan.
adventure	kb. petualangan.
adventurer	kb. 1 petualang, avonturir. 2 orang yg suka berspekulasi (mengadu untung). 3 prajurit yg bersedia menggabungkan dirinya pada tentara mana saja yg menawarkan bayaran yg paling tinggi.
adventuresome	ks. = adventurous.
adventurism	kb. avonturisme.
adventurous	ks. 1 sangat berani (bersedia mengambil risiko). he's an a. climber ia adalah pendaki yg sangat berani. 2 kepetualangan. his a. nature/spirit semangat kepetualangannya.
adventurousness	kb. kepetualangan.
adverb	kb. kata keterangan/tambahan.
adverbial	kb. bersifat kata keterangan/tambahan.
adversary	kb. (j. -ries) musuh, lawan. he's a formidable a. ia adalah lawan berat/hebat.
adverse	ks. 1 merugikan. 2 bersifat bermusuhan. 3 tidak cocok.4 yang berlawanan.
adversity	kb. (j. -ties) kesengsaraan, kemalangan.
advertise	kkt. 1 mengiklankan, mengadpertensikan. 2 menyatakan, memperlihatkan, menekankan.. --kki. memasang iklan, mengiklankan.
advertisement	kb. iklan, adpertensi. to place/insert an a. in memasang iklan di.
advertiser	kb. pemasangan iklan.
advertising	kb. periklanan, pemasangan iklan, reklame.
advertize	= advertise.
advice	kb. 1 nasehat, adpis. a. on a matter nasehat mengenai suatu soal. 2 berita. of shipment berita pengiriman.
advisability	kb. kepantasan, kelayakan. i question the a. of suggesting this just now saya meragukan apakah tepat untuk menyarankan hal ini pada waktu ini.
advisable	ks. sebaiknya. it would be a. for you not to go sebaiknya kamu jangan pergi.
advise	kkt. 1 menasehati. 2 memberitahu, memaklumkan. 3 menasehatkan. 4 menganjurkan. 5 mempertimbangkan.--kki. menasehatkan.
advisedly	kk. dgn dipikir dulu, dipertimbangkan betul-betul.
advisee	kb. orang yang dinasehati.
advisement	kb. pertimbangan. i'll take that under a. saya akan pertimbangkan itu benar-benar.
adviser	kb. penasehat. legal a. penasehat hukum.
advisor	= adviser.
advisory	kb. (j. -ries) laporan. weather a. from buffalo laporan cuaca dari buffalo. --ks. sebagai/bersifat penasehat.
advocacy	kb. sokongan anjuran, pembelaan.
advocate	kb. 1 penyokong, penganjur. an a. of socialism penyokong sosialisme.2 law: pengacara. --kkt. menganjurkan, menyokong. she advocates building more schools ia menganjurkan supaya dibangun lebih banyak sekolah.
adz	kb. sm kapak atau beliung.
aec	(atomic energy commission) komisi tenaga atom.
aegis	kb. 1 perlindungan, pengayoman.2 usaha, pengawasan, inisiatip.
aeon	kb. 1 suatu masa yang berabad-abad lamanya. 2 beribu-ribu tahun.
aerate	kkt. 1 menganginkan, memperanginkan. 2 mengisi atau mencampuri dengan gas/udara, mengisi angin. to a.reservoir mencampurkan udara kedalam air di kolam cadangan.
aeration	kb. pengisian angin atau gas, penganginan, penjemuran.
aerial	kb. antena. television a. antena tv --ks. udara. a. photography pemotretan (dari) udara. a. spraying penyemprotan dari udara. a. survey pemeriksaan/pengintaian dari udara.
aerodynamics	kb. (a)erodinamika, (ilmu) dinamika udara.
aerogram	= air letter 1.
aeromedicine	kb. = aviation medicine.
aerometer	kb. aerometer, pengukur berat atau padat udara atau gas-gas lain
aeronautics	kb. ilmu penerbangan, aeronotika, aeronoutika.
aeronoutical	ks. yang berhubungan dengan ilmu penerbangan atau aeronotika. a. laboratory laboratorium penerbangan. a. engineering ilmu tehnik aeronotika.
aeroplane	kb. = airplane.
aerosol	kb. a. bomb bom aerosol, alat penyemprot erosol.
aerospace	kb. udara yang mengelilingi bumi lapisan udara. a. medicine cabang ilmu kedokteran yang mempelajari penyakit-penyakit di angkasa luar.
aestetics	kb. estetika.
aesthete	kb. astetikus.
aesthetic	ks. estetis.
aether	kb. = ether.
af	(air force) angkatan udara.
afar	kk. dari jauh . i saw him from a. saya lihat dia dari jauh.
affability	kb. keramah-tamahan, kebaikan hati, kesopanan.
affable	ks. ramah-tamah, baik hati, sopan. he's very a. ia sangat ramah-tamah.
affair	kb. 1 urusan. 2 urusan, pekerjaan. 3 kejadian, peristiwa, perkara, hal ihwal. (love) hubungan cinta/asmara 5 keadaan, hal, usaha. 6 (illicit) hubungan gelap. 7 pertemuan.
affect	kkt. 1 mempengaruhi. 2 mengharukan. 3 pura-pura. 4 memakai, mempergunakan. 5 merusak.
affectation	kb. pura-pura, sok aksi, dibuat-buat. that's an a. on her part ia pura-pura saja. itu hanya dibuat-buat saja.
affected	ks. 1 sok. 2 dibikin-bikin, dibuat-buat,pura-pura.
affection	kb. kesayangan, sayang, kasih, kasih-sayang, cinta. the boy has great a. for his mother anak itu sangat sayang pada ibunya.
affectionate	ks. 1 mengharukan, 2 yang penuh kasih sayang.
affectionately	kk. 1 setia. 2 dengan mesra.
affidavit	kb. surat sumpah(an), pernyataan tertulis yang sah.
affiliate	kb. cabang. --kki. bergabung, menggabungkan diri.
affiliated	ks. yang bergabung.
affiliation	kb. keanggotaan,affiliasi, pertalian, gabungan, perhubungan, persatuan. a. with a leftist organization pertalian dan sangkut paut dengan organisasi gerakan kiri.
affinity	kb. (j.-ties). 1 afinitas, daya tarik-menarik/gabung.2 tertarik.3 persamaan,pertalian,keturunan.
affirm	kkt. 1 menegaskan,mengiakan.2 memperkokoh,mensahkan,menguatkan.
affirmation	kb.penegasan,penguatan.
affirmative	kb. pihak atau golongan yg menyetujui.-ks. setuju
affiuent	kb. anak sungai.-ks.1 makmur, berlimpahan,subur.2 kaya.
affix	kb. bubuhan,imbuhan.-kkt.1 melekatkan,menambahkan ,membubuhkan.2 membubuhi.
affixation	kb. afikasi.
afflict	kkt. merundung, menyebabkan hati atau derita,menimpa, mengenai.
affliction	kb. penderitaan,kesusahan, kemalangan, derita.
affluence	kb. kekayaan,kemakmuran
afford	kkt.1 menghasilkan,memberi-(kan).2 kuat, mampu.3 boleh.4 mengadakan, membuka, memberi.
afforestation	kb. penanaman hutan.
affray	kb. perkelahian, pertengkaran,ribut di tempat umum, keributan.
affront	kb. penghinaan, hinaan.-kkt. menghina.
afield	kk. 1 menyeleweng, menyimpang.2 jauh.
afire	kk. terbakar, menyala.
afl	(american federation of labor) federasi buruh amerika.
aflame	ks., kk. 1 terbakar, bernyala, menyala.2 merah, kemerah-merahan.
afloat	ks. kk. 1 terapung, 2 di laut, naik kapal, berlayar.3 banjir, terendam.4 tersebar, tersiar, beredar.
aflutter	ks.kk. 1 berkibar,2 berdebar(-debar)
afoot	ks,. kk. 1 bangun, bergerak.2 sedang berjalan/dikerjakan.3 akan datang/terjadi.
aforementioned	ks. tersebut (diatas, dimuka, tadi). the a. were present yang tersebut tadi hadir. the a. paragraph ayat yang tersebut diatas.
aforesaid	= aforementioned.
afoul	ks., kk. berbentur, berlanggar, bertabrakan, terlibat. to run a. of the law mendapat kesukaran dengan hukum.
afraid	ks. 1 takut, ketakutan. i'm a. of the dark saya takut akan gelap. saya ketakutan kalau gelap. 2 kuatir, rasa i am a. i can't come today saya rasa/kuatir hari ini saya tak dapat datang. don't be a. jangan khawatir.
afresh	kk. (sekali) lagi. we'll start a. kita akan mulai (sekali) lagi.
africa	kb. afrika.
african	kb. orang afrika. --ks. afrika. a. languages bahasa-bahasa afrika.
afro-american	kb. orang negro-amerika. --ks. negro-amerika. a. culture kebudayaan negro-amerika.
afro-asian	ks. asia-afrika. the a. bloc blok asia-afrika.
aft	kk. buritan, bagian belakang kapal. we'll go a. kita pergi ke bagian buritan kapal. the cabin is a. of the pilot house kamar ada dibelakang ruang pengemudi.
after	ks. (lama) kemudian. --kk. sesudah itu. --kd. 1 sesudah.2 tentang. 3menurut. 4 lebih rendah. 5 seperti, sama dengan, mirip, meniru.6 mencari. 7 karena, sebab, oleh karena.8 berturut-turut.9 setelah.
afterbirth	kb. uri, tembuni.
afterdark	ks. waktu malam, pada malam hari. a. rides are prohibited mengendarai kendaraan pada malam hari dilarang.
afterdectk	kb. bagian belakang kapal, dek belakang.
aftereffect	kb. akibat yang datang kemudian. the a. was noticeable akibat yang datang kemudian tampak.
afterglow	kb. 1 cahaya yang tinggal sesudah s.s.t. barang yang bersinar hilang; merah di langit sesudah matahari terbenam. 2 perasaan senang sesudah mengalami atau merasakan kesenangan.
afterhours	ks. waktu sesudah jam kerja. a. relaxation mengaso sesudah jam kerja.
afterlife	kb. akhirat, alam baka.
aftermath	kb. 1 akibat (yang umumnya buruk). the a. of war is inflantion akibat perang adalah inflasi. 2 buntut, ekor. there will surely be an a. to that incident kejadian itu pasti ada buntutnya.
afternoon	kb. (hari) sore. good a.! selamat sore! i will come to the school this a. saya akan datang kesekolah sore ini. the game will be held in the a. pertandingan akan dilangsungkan pada sore hari. a. tea minum teh sore.
aftertaste	kb. sisa rasa (rasa yang masih ketinggalan di mulut sesudah makan s.s.t.). i don't like the a. of durian saya tak suka sisa rasa durian.
afterthought	kb. renungan, pikiran kemudian. it was just an a. itu hanyalah pikiran yang timbul kemudian.
afterwards	kk. sesudah itu, lalu, kemudian. the came to tea and a. we went home with them mereka datang berjamu minum teh dan sesudah itu kami pulang bersama mereka.
ag	1(agriculture) pertanian. 2 (agricultural) berhubungan dengan pertanian. 3 (silver) perak. ag. 1 (agriculture) pertanian. 2 (august) agustus. a.g. 1 (attorney general) jaksa agung. 2 (adjutant general) ajudan-jenderal.
again	kk. 1 lagi, sekali lagi, kembali.it's nice to see you a. senang sekali bertemu lagi dengan kamu.2 pula, lagi.try a. coba lagi. 3 juga.
against	kd. 1 melawan, berlawanan dengan, menentang. 2 melanggar. 3 pada. 4 untuk. 5 terhadap.
agape	ks., kk. ternganga, termangap, termangu. he stood with mouth a. ia berdiri dengan mulut termangap.
agar-agar	kb. agar-agar.
agate	kb. (batu) akik.
agaze	kk. tercengang, melongo.
agcy	kk. keagenan, agen, perwakilan.
age	kb. 1 umur, usia.2 ketuaan, tua. 3 zaman, masa, abad. --kkt. mempercepat menjadi tua, menuakan. --kki. 1 bertambah/menjadi tua. 2 menyimpan, menua.
aged	kb 1 orang - orang yang sudah lanjut umurnya. 2 jompo. ks tua sekali, lanjut umurnya.
ageless	ks. 1 awet muda. he looks a. ia awet muda. 2 yang selalu hidup, kekal , abadi, untuk selama-lamanya. an a. story cerita yang selalu hidup.
agency	kb. (j. -cies) 1 perwakilan, peragenan, agen. he works for an automobile a. ia bekerja pada sebuah perwakilan perusahaan mobil. 2 perantara. he got a job through the a. of well-placed friends ia mendapat pekerjaan dgn perantaraan teman-teman terkemuka
agenda	kb. acara, agenda.
agent	kb. 1 agen, wakil. 2 alat, perantara (yg menyebabkan s.s.t. keadaan) 3 polisi. 4 pengantar.
agglomerate	kb. = agglomeration. .kkt. mengelompokkan, menggumpalkan. --kki. berkumpul, mengelompok, menggumpal.
agglomeration	kb. pengelompokan, gumpalan, tumpukan.
agglutinate	kkt. melekatkan, menggumpalkan, merekatkan menjadi satu. --kki. melekat, berpaut, berpadu, bergumpal.
agglutinating	language bahasa yang berpadu.
agglutination	kb. penggumpalan,pergumpalan, perpaduan.
agglutinative	ks. bersifat melekatkan atau merekatkan.
aggrandize	kkt. memperbesar kekayaan, memperluas kekuasaan.. the boss aggrandized his family at the expense of his employees majikan itu memperbesar kekayaan keluarganya atas penderitaan pegawai-pegawainya.
aggrandizement	kb. pembesaran, pengluasan, penaikan (kekuasaan, daerah, pangkat).
aggravate	kkt. 1 menjengkelkan, menyakiti hati.2 membuat lebih buruk, membiarkan menjadi-jadi, memperburuk. 3 tambah menjadi.
aggravating	ks. 1 (yang) menjengkelkan. 2 mengganggu.
aggravation	kb. 1perbuatan menjengkelkan, menyakiti hati, kejengkelan, gangguan. 2 tambah menjadi, bertambah, memperkeras.
aggregate	kb. 1 jumlah, kumpulan, pengumpulan. the a. of the gifts is $1,000. jumlah sokongan adalah $1,000. 2 agregat.in the a. dalam bersama-sama, kesemuanya. --kkt. berjumlah, mencapai jumlah.
aggregation	kb. pengumpulan, koleksi, kesatuan.
aggression	kb. agresi, penyerangan, serangan. act of a. perbuatan agresi. to commit a. melakukan agresi.
aggressive	ks. 1 agresip.an a. political campaign suatu kampanye politik yang agresip. 2 giat, bersifat menyerang, penuh dengan inisiatip.
aggressiveness	kb. sifat/sikap agresip.
aggressor	kb. agresor, penyerang.
aggrieve	kkt. (biasanya dipakai dalam bentuk pasif ). membuat bersedih hati. .he was deeply aggrieved when he.... ia sangat bersedih hati ketika ia ...
aggrieved	ks. yang dirugikan. who's the a. person in this case? siapakah yang dirugikan dalam perkara ini?
aghast	ks. terperanjat, kaget, terkejut sekali. i was a. at this statement saya terperanjat mendengar keterangan ini.
agile	ks. 1 cerdas. he has an a. mind ia cerdas sekali. 2 tangkas, gesit. he's a. in sports ia tangkas dalam olahraga.
agility	kb. 1 kecerdasan otak/mental. 2 ketangkasan, kegesitan. a. at sports ketangkasan dalam olahraga, ketangkasan berolahraga.
agin	kk. inf.: 1 melawan, berlawan. i'm a. it saya tidak setuju . 2 = against.
aging	kb menyimpan lama, memeram. ks sudah lanjut usia, menjadi tua.
agitate	kkt. 1 menggerakkan (secara tidak teratur), menggoncangkan, mengaduk. 2. menggelisahkan, mengganggu, mengacau.3 merangsang. 4 mengagitasi, mengadakan (h)asutan. --kkt. beragitasi.
agitated	ks. tidak tenang secara gelisah, terganggu.
agitation	kb. 1 agitasi, (h)asutan. .2 bergejolaknya, pergolakan (of the water).
agitator	kb. 1 agitator, penghasut . labor a. agitator buruh. 2 pemutar/penggerak pengaduk (dalam mesin cuci otomatis).
agleam	ks. kk., bercahaya, bersinar, terang. the main street was a. with lights jalan raya mandi cahaya karena lampu-lampu yang terang benderang
aglow	ks kk., menyala, bercahaya, bersinar. the streets were a. whit bright lights jalan-jalan penuh cahaya karena lampu-lampu yang terang benderang. face a. with color muka yang merah menyala.
agnatic	ks. anthro. : keturunan melalui fihak laki-laki saja.
agnostic	kb. seorang agnotis. --ks agnotis.
agnosticism	kb. agnostisme, doktrin, faham atau orang-orang agnostis.
ago	ks. yang lalu/lampau, silam. two years a. dua tahun yang lalu. --kk. dulu, dahulu. he took the course long a. sudah lama berselang ia mengikuti kuliah itu.
agog	ks. gembira, gairah, antusias, senang sekali. we were all a. at the news kami semua gembira sekali mendengar khabar itu
agonize	kki. menderita sekali. to a. over the matter menderita sekali karena hal itu. an agonizing reappraisal penilaian kembali yang terasa sebagai azab.
agony	kb. (j. -nies) 1 nyeri sekali, penderitaan yang mendalam. 2 kesakitan. 3 perjuangan bersusah payah.
agrarian	kb. seorang penduduk yang menyokong gagasan pembagian tanah. --ks. agraria. a. affairs urusan agraria. a. law hukum agraria.
agreable	ks. 1 ramah(tamah), menyenangkan sekali. 2 cocok, serasi. 3 (bersedia) menyetujui.
agreably	kk. secara menyenangkan, secara yang dapat disetujui.
agree	kkt. mengaku(i). --kki. setuju, akur, cocok. 2 sependapat.3 menyetujui.
agreed	ks. 1 yg telah disetujui, dimufakati.2 akur.
agreement	kb. 1 persetujuan, permufakatan, perjanjian. 2 persesuaian, cocok, sesuai.
agricultural	ks. yang berhubungan dengan pertanian. a. country negara pertanian/agraria. a. college sekolah tinggi pertanian. a. economics ekonomi pertanian.a. extension penyuluhan pertanian. a. extension service jawatan penyuluhan pertanian.
agriculture	kb. pertanian.
agronomist	kb. ahli ilmu (pengetahuan) tanah.
agronomy	kb. agronomi, ilmu ( pengusahaan) tanah pertanian.
aground	ks., kk. kandas, terdampar. the ship ran a. kapal kandas.
ah	o! ah! (seruan yang menyatakan rasa sedih, kesal, kegembiraan dsb., tergantung pada intonasi). a., now i understand o, sekarang saya mengerti.
aha	aha ! (seruan yang menyatakan rasa kemenangan , kepuasan, kesenangan dsb., tergantung dari cara mengucapkannya). a., now i've got you! aha, sekarang kena kamu!
ahead	kk. 1 didepan, dimuka. watch out for the bicycle a. awas sepeda dimuka. 2 mendahului, lebih dulu, menang.full speed a.! maju dengan kecepatan penuh!
ahem	kseru. deham, daham,. ( membunyikan kerongkongan untuk membersihkan atau untuk menarik perhatian). a., i say there hm, saya katakan tadi.
ahoy	kseru. hoi (seruan dipakai untuk memanggil kapal atau orang) a. there! hoi situ!
aid	kb. 1 bantuan, pertolongan. 2 (= aide) pembantu, penolong. --kkt. 1 membantu.2 menolong. aid (agency for international development) badan pembangunan internasional.
aide	kb. ajudan, pembantu.
aide-de-camp	kb. perwira pembantu.
aide-memoire	kb. catatan peringatan, memo.
ail	kkt. sakit. what ails you? sakit apa kamu? ada apa dengan kamu? --kki. merana, sakit-sakit. she has been ailing for years sudah bertahun-tahun ia merana.
aileron	kb. av. : kemudi guling.
ailment	kb. penyakit (ringan).
aim	kb. 1 tujuan, maksud. 2 bidikan. --kkt. 1 membidik. 2 mengarahkan. --kki. 1 membidik. 2 berangan-angan 3 inf.: hendak, bermaksud.
aimless	ks. tanpa tujuaan/arah, tak bertujuan. he leads an a. existence hidupnya tanpa tujuan.
ain't	(dibawah standar) tidak, bukan. it a. necessarily so itu tak usah begitu. lih be.
air	kb. 1 udara. planes in the a. pesawat terbang di udara. 2 udara, hawa. fresh a. udara segar. 3 udara, angin. i can't live on a. saya tidak dapat hidup dari "angin" (saja). 4 suasana. there is an a. of charm about her ada suasana yg menarik padanya.
airborne	ks. 1 naik di udara, terbang, ada di udara.the jet was quickly a. jet itu cepat sekali naik di udara. 2 diangkut dengan kapal udara. a. troops pasukan yang diangkut dengan kapal udara.
aircraft	kb. pesawat terbang, balon, zepelin. a. carrier kapal induk (pesawat terbang).
airdrome	kb. lapangan/pelabuhan udara.
airdroped	kkt menjatuhkan.
airfield	kb. lapangan terbang.
airily	lih airy.
airlift	kb. sistim pengangkutan penumpang dan barang melalui udara; biasanya ketempat yang hubungannya terputus atau sukar. --kkt. mengangkut penumpang dan barang melalui udara..
airline	kb. perusahaan/dinas penerbangan. a. hostess pramugari. a. steward pramugara. a. terminal pelabuhan udara.
airliner	kb. pesawat terbang/udara (penumpang) yang besar.
airmail	kkt. mengirimkan dengan pos udara (a letter).
airman	kb. (j. -men). 1 pilot kapal terbang. 2 salah seorang anak buah kapal terbang
airplane	kb. kapal terbang/udara, pesawat terbang/udara.
airport	airport
airpower	kb. kekuatan di udara dari suatu negri.
airproof	ks. tahan/kedap udara.
airship	kb. zeppelin.
airsick	ks. mabuk udara.
airstrip	kb. landasan terbang sementara/ darurat.
airtight	ks. 1 kedap udara. 2 inf.: dengan pertahanan yang rapat. a. defense pertahanan yang rapat.
airwaves	kb.., siaran radio/televisi.
airway	kb. 1 lin udara, trayek kapal terbang. 2 jalan arus udara biasanya dibawah tanah. 3 gelombang radio tertentu
airworthiness	kb. kelayakan udara.
airworthy	ks. layak udara. this plane is certified a. kapal terbang ini dinyatakan layak udara.
airy	ks. 1 banyak udara masuk, luas dan terbuka, berangin. 2 dibikin-bikin, dibuat-buat. 3 ringan, halus, ringan-halus, gembira. 4 tak nyata, dalam khayal, dlm angan-angan kosong.
aisle	kb. gang, jalanan diantara deretan tempat duduk. let's walk up the a. marilah kita melalui gang.
aitch	kb. bunyi huruf inggris h.
ajar	ks., kk. 1 terbuka sedikit. my son likes his door left a. anak laki-laki saya suka membiarkan pintunya terbuka sedikit. 2 terenggang, terbuka sedikit. the door was a. pintu itu terenggang.
akimbo	ks., kk. bertolak/bercekak pinggang. he stood with arms a. ia berdiri dengan bertolak pinggang.
akin	ks. 1 bersanak, berhubungan darah. your cousins are a. to you saudara sepupumu adalah sanakmu. 2 sama (dengan). girls are a. in their love of dancing gadis-gadis adalah sama dalam kesukaannya berdansa.
ala	(alabama) negara bagian a.s.
ala, a la	menurut, secara. a carte menurut kartu makanan, boleh memesan satu demi satu. a. hollywood secara hollywood.
alabaster	kb. batu pualam yang berwarna putih.
alack	kseru. = alas.
alacrity	kb. 1 kelincahan, kecekatan, kesigapan.the old man moved with a. orang tua itu bergerak dgn lincahnya. 2 rela, serta merta. i accepted the invitation with a. saya terima undangan itu dgn serta-merta.
alarm	kb. 1 alarm, larem, tanda bahaya. 2 weker,beker. 3 sirene. 4 ketakutan, kegelisahan. --kkt. 1 menggusarkan, menggelisahkan, menakutkan. 2 khawatir, kuatir.
alarming	ks mengkhawatirkan, menggegerkan, menggelisahkan.
alarmist	kb. penggelisah. even under good conditions he's an a. bahkan juga dalam keadaan-keadaan baik ia mudah menjadi gelisah.
alas	kseru. aduh (menyatakan kesusahan, penyesalan, ketakutan).
alb.	1 (albania(n)) albania; orang atau bahasa albania. 2 ( abert) albert. 3 ( albany) ibukota di negara bagian new york.
albatross	kb. elang laut.
albeit	kseru. sekalipun, walaupun. he has decided to stay there, a. it is expencive ia telah memutuskan untuk tinggal disana, sekalipun mahal.
albino	kb. bulai, balar.
album	kb. album. stamp a. album perangko.
albumen	kb. zat (putih) telur.
albumin	kb. albumin.
alchemist	kb. ahli kimia, alkimis.
alchemy	kb. alkimia.
alcohol	kb. alkohol. pure a. alkohol murni.
alcoholic	kb. pencandu minuman alkohol. --ks. yang mengandung alkohol. a. beverage minuman keras/alkohol.
alcoholism	kb. keadaan sakit karena terlampau banyak minum minuman alkohol.
alcove	kb. ruangan kecil dalam suatu kamar
alderman	kb. (j. -men). anggouta dewan kotapraja yang bertugas menyusun perundang-undangan kotapraja.
ale	kb. samacam bir tetapi lebih keras.
alert	kb. 1 sinyal, tanda. 2 siap siaga, berjaga-jaga. --ks. tajam perhatian, selalu siap, waspada. --kkt. menyiagakan, menyuruh bersiap-siap
alertness	kb. 1 kesiap-siagaan, kesiapan, kewaspadaan. 2 ketajaman perhatian.
alfalfa	kb. nama tanaman untuk makanan sapi dan kuda (di as).
alfresco	kk. diluar rumah, di udara terbuka. to eat a. makan diluar rumah.
algae	kb., j. ganggang.
algebra	kb. aljabar.
algebraic	ks. bersifat/secara aljabar.
algeria	kb. aljazair.
algerian	kb. seorang aljazair. --ks. yang bertautan dengan aljazair.
algiers	kb. (kota) aljazair.
alias	kb. alias, nama lain. he sometimes goes by the a. of teddy kadang-kadang ia memakai alias teddy. he was known as billy, a. willy ia terkenal sebagai billy alias willy.
alibi	kb. 1 alibi, bukti ada di tempat lain daripada di tempat terjadinya kejahatan. 2 alasan (untuk membebaskan diri dari sesuatu kesalahan), dalih, helat, akal. --kkt. mencari/memberi alasan/dalih.
alien	kb. orang asing/luar. --ks. 1 asing. a. domination penguasaan asing. 2 bertentangan dengan, berbeda dari. this is a. to her wishes ini bertentangan dengan kehendaknya.
alienate	kkt. 1 mengasingkan, menjauhkan diri. 2 memindahkan ( hak atau benda), mensita.
alienation	kb. 1 pengasingan, perbuatan mengasingkan diri. 2 perebutan. 3 keadaan mengasingkan diri. 4 pemindahan hak milik kepada orang lain. 5 penyakit jiwa, kegilaan.
alight	ks.berseri-seri, bernyala, bercahaya. --kki. 1 turun. to a. from a bus turun dari bus. 2 hinggap. a bird alighted on a tree branch seekor burung terbang menurun dan hinggap pada dahan pohon.
align	kkt. meluruskan. to a. the wheels of the car meluruskan roda-roda mobil itu. --kki. bersekutu. this country aligned with that one during the war negri ini bersekutu dengan negri itu selama perang.
alignment	kb. penjajaran. the a. of the troops was perfect penjajaran barisan tentara itu sempurna. wheel a. garis arah roda-roda, penjajaran roda.
alike	kk. 1 sama. these two words are spelled a. kedua kata itu dieja sama. 2 sama, serupa. all customers are treated a. semua langganan diperlakukan sama. 3 serupa, mirip. the two girls look much a. kedua gadis itu serupa betul.
alimentary	ks. yang berhubungan dengan makanan atau bersifat memberi makanan. a. canal saluran pencernaan.
alimony	kb. (j. -nies) tunjangan uang yang diberikan seorang suami kepada bekas istrinya selama perceraian secara resmi.
aline	= align.
alinement	= alignment.
aliteration	kb. purwakanti, pemakaian kata-kata yang permulaannya sama bunyinya.
alive	ks. 1 hidup. she is still a. ia masih hidup. 2 riang, gembira, lincah. she is very much a. ia seorang yang riang sekali. 3 penuh enersi, aktif. 4 penuh, dikerumuni.
alkali	kb. alkali.
alkaline	ks. dari atau yang berhubungan dengan alkali atau memiliki sifat-sifat alkali.
all	all
allay	kkt. menghilangkan, menenangkan, menyembuhkan. to a. our fears menghilangkan kecemasan kami. the medicine allayed her fever obat itu menghilangkan demamnya.
allegation	kb. 1 pernyataan tanpa bukti. 2 pernyataan (biasa), dugaan. the man's a. was proved pernyataan orang itu terbukti.
allege	kkt. mengatakan, menduga keras, menyatakan tanpa bukti.
alleged	ks. yang dinyatakan (secara positif tapi tanpa bukti), yg dikatakan orang sebagai., diduga keras sebagai.
allegedly	kk. kata orang, menurut dugaan orang.
allegiance	kb.kesetiaan.
allegorical	ks. alegoris, bersifat kiasan/alegori.
allegory	kb.(j.-ries) alegori, kiasan.
allegro	kb. alegro.
allergic	ks. 1 alergis, alergik, peka sekali.2 tidak sama sekali.
allergy	kb. (j.-gies) alergi, kepekaan yg luar biasa.
alleviate	kkt. mengurangi, meredakan, meringankan.
alleviation	kb. pengurangan,peringanan.
alley	kb. gang, jalan kecil, lorong.
alleyway	kb.gang, jalan kecil, lorong.
alliance	kb. persekutuan, perserikatan,
allied	--kkt. to ally a.s. (with) bersekutu (dengan). ks. (yang) bersekutu. a. nations bangsa-bangsa yang bersekutu.
alligator	kb. sm buaya tetapi lebih kecil dan kepalanya lebih pendek dan gepeng.
alliterate	kki. berbicara dengan memakai kata-kata yang permulaanya sama bunyinya.
alliterative	ks. mengandung/mempunyai kata-kata/huruf yang permulaannya sama bunyinya.
allocable	ks. dapat disediakan/diberikan/ditugaskan.
allocate	kkt. 1 memberikan, menyediakan, mendermakan. the money was allocated for this purpose uangnya diberikan untuk keperluan ini. 2 menentukan/ menemukan tempat. to a. space menentukan ruangan/spasi.
allocation	kb. jatah, pembagian, pemberian, persediaan, distribusi, alokasi.
allomorph	kb. al(l)omorf.
allophone	kb. alofon.
allot	kkt. (allotted) memberikan, membagikan. the director allotted each person present a part in the play direktur itu memberikan tiap orang yg hadir suatu bagian dlm sandiwara itu.
alloted	ks. yang dibagikan.
allotment	kb. bagian, jatah,pemberian.
allow	kkt. 1 membolehkan, mengizinkan. 2 menyediakan, memberikan. 3 menghargai. 4 memperkenankan. 5 memenuhi.
allowable	ks. yang diperkenankan, yang diperizinkan. what is a. under the new regulation? apakah yang diperkenankan oleh peraturan yang baru.
allowance	kb. 1 pemberian uang untuk sesuatu maksud, upah. 2 penghargaan sesuatu dalam tukar-tambah, harga. 3 kelonggaran.
alloy	kb. (logam) campuran. an a. of gold and copper suasa.
allspice	kb. semacam rempah-rempah berbau campuran dari kulit-manis, pala, dan cengkeh tumbuh di amerika tengah.
allude	kki. menyinggung he did not a. to it when we were talking ia tidak menyinggung hal itu ketika kita bercakap-cakap.
allure	kb. panggilan, daya tarik/pemikat, keberahian. the a. of the sea is strong panggilan laut sangat kuat.
alluring	ks. yang memikat, yang menarik. it was an a. prospect itu harapan yang memikat.
allusion	kb. sindiran, kiasan, ibarat. it was an a. to an incident long since past itui memperingatkan kepada kejadian yang sejak lama terjadi.
alluvial	ks. tanah yang ditinggalkan oleh air sesudah surut, tanah baru. a. fan delta, lumpur atau tanah padat di kuala berbentuk kipas. a. plain lapangan (yang terdiri dari) tanah baru. a. soil tanah enap/endapan.
ally	ally
alma mater	alma mater, (bekas) sekolah atau universitas seseorang.
almanac	kb. 1 almanak, primbon. 2 buku referensi tahunan.
almighty	kb. the a. yang mahakuasa. a. god tuhan yang mahakuasa.
almond	kb. amandel, buah badam.
almost	kk. hampir. i am a. through reading this book saya hampir selesai membaca buku ini. a. never hampir selalu tidak. she's a. never at home ia hampir selalu tak ada di rumah. a. no hampir tidak. there's a. no hope for him hampir tidak ada harapan untuk dia.
alms	kb. sedekah, derma, kurnia, zakat, fitrah, amal (jariah).
almshouse	kb. rumah miskin.
aloe	kb. pohon gaharu. --aloes j. obat yang dihasilkan dari daun pohon gaharu.
aloft	kk. diatas, tinggi. the seaman went a. pelaut itu naik tiang layar.
alone	ks. sendirian, seorang diri. i dislike being a. saya tidak suka sendirian. --kk. 1 seorang saja. i always walk a. saya selalu berjalan-jalan seorang saja. 2 hanya. god a. knows. hanya tuhan yang mengetahui.
along	kk. 1 terus. 2 inf.: kira-kira, mendekati, sekitar. to get a. 1 jalan terus. 2 maju. 3 berhubungan/bergaul dengan baik.4 sembuh. all a. 1 sepanjang (seluruh). 2 dari semula. --kd. 1 sepanjang. 2 lanjut, maju.
alongside	kk. 1 di sisi, di samping, sepanjang. he brought his boat a. the dock ia menempatkan kapalnya di sisi galangan (kapal) 2 berdampingan dengan. he drove up a. the other car ia mengendalikan mobilnya hingga berdampingan dengan mobil yang lain.
aloof	ks., kk. jauh. an a. attitude sikap menyendiri. to keep/stand a. menjauhkan/menyisihkan diri. he stood a. from the others ia menjauhkan diri dari yang lain
aloud	kk. dengan (suara) keras. he likes to read a. ia suka membaca dengan keras.
alpha	kb. alfa, alpha. a. particle partikel alpha.
alphabet	kb. abjad, abese, alfabet.
alphabetize	kkt. mengabjad, menyusun menurut abjad. to a. the cards menyusun kartu-kartu itu menurut abjad.
alpine	ks. yang berhubungan dengan pegunungan alpen. a. snows salju di pegunungan tinggi.
alps	kb. pegunungan alpen.
already	kk. sudah, telah. we've a. decided to go kami sudah memutuskan untuk memutuskan untuk pergi. you're 10 minutes late a. engkau sudah 10 menit terlambat.
also	kk. juga, pula, pun. i am a. going to the movies saya juga akan pergi nonton. i'd like some soup a. saya mau sup juga.
alt.	1 (alternating) bertukar-tukar. 2 (altitude) tingginya.
altar	kb. altar. she led him to the a. ia kawin dengan dia. a. boy pembantu pada upacara sembahyang. a. rail pagar tempat pedupaan.
alter	kkt. merubah, mengubah. i will have to a. this dress saya harus merubah baju ini. --kki. berubah. a. ego 1 teman karib yang dipercaya. 2 aku yang kedua.
alternate	kb. 1 pengganti, wakil 2 calon pengganti. --ks. berselang/berganti hari. --kki. 1 berganti-ganti beristirahat dan bekerja. 2 bergantian.
alternating	ks. bertukar-tukar. a. current arus bolak-balik.
alternation	kb. pergonta-gantian, (per)selang-selingan.
alternative	kb. pilihan (antara dua hal), alternatip, jalan lain --ks. cadangan.
alternatively	kk. sebagai kemungkinan lain kita bisa tinggal dir rumah.
altho	inf.: = although.
although	ksam. walaupun, meskipun, sungguhpun, sekalipun.
altimeter	kb. alat pengukur tinggi.
altitude	kb. tinggi, ketinggian (dari permukaan laut atau bumi). the plane is flying at a high a. pesawat terbang itu terbang sangat tinggi. in high altitudes it is difficult to breathe di tempat yang sangat tinggi sukar untuk bernapas.
