intravenous	ks. kedalam pembuluh darah. i. injection suntikan kedalam pembuluh darah. -intravenously kk. melalui urat nadi/urat pembuluh darah.
intrepid	ks. pemberani, berani.
intricacy	kb. (j. -cies) keruwetan, seluk-beluk.
intricate	ks. ruwet, berbelit-belit, berseluk-beluk.
intrigue	kb. tipu daya/tepok, intrik. -kkt. menggugah rasa ingin tahu, membangkitkan minat. -intriguing ks. yang membangkitkan minat.
intrinsic	ks. hakiki. -intrinsically kk. pada hakekatnya.
introduce	kkt. 1 memperkenalkan, mengintrodusir. 2 memasukkan. 3 memajukan, mengajukan (a bill into congress).
introduction	kb. 1 perkenalan, pengenalan. 2 kata pengantar, kata pendahuluan, prawacana, prakata. 3 pengantar.
introductory	ks. 1 pengantar. i. economics pengantar ekonomi. 2 pembukaan. i. words/remaks ucapan-ucapan pembukaan, kata pengantar.
introspection	kb. instrospeksi, mawas diri.
introspektive	ks. mawas diri, suka introspeksi.
introvert	kb. seorang introvert, seorang yang lebih suka memikirkan dirinya sendiri daripada orang lain.
introverted	ks. yang memusatkan perhatian dan pikiran kepada dirinya sendiri.
intrude	kkt. memaksakan. to i. o's views upon memaksakan pendapatnya pada. -kki. mengganggu. to i. into other people's affairs mencampuri urusan orang lain. to i. upon s.o mengganggu seseorang.
intruder	kb. 1 pengacau, orang yang menyelundup. 2 orang yang suka turut campur.
intrusion	kb. 1 penggangguan, pengacauan. 2 hal mencampuri.
intuition	kb. intuisi, gerak hati.
intuitive	ks. berdasarkan intuisi, intuitif.
inundate	kkt. membanjiri, menggenangi (with water, brochures).
inundation	kb. pembanjiri, penggenangan.
inure	kkt. membiasakan. to be inured to menjadi biasa untuk.
invade	kkt. 1 menyerbu (a country). we were invaded by a swarm of bees kami diserbu oleh segerombolan lebah. 2 melanggar (the rights/ privacy of others).
invader	kb. penyerbu.
invalid	kb. penderita cacad, invalide. -ks. 1 yang cacat. i. mother ibu yang cacat. 2 sakit.
invalidate	kkt.membuat tidak berlaku. -invalidated ks. yang tak berlaku lagi.
invaluable	ks. tidak terhingga nilainya. this book is i. as a guide buku ini tidak terhingga nilainya sebagai penuntun.
invariably	kk. tanpa kecuali, selalu. the phone i. rings when i am busy telepon tetap saja berbunyi ketika saya sibuk.
invasion	kb. 1 serbuan, penyerbuan, invasi. the i. of normandy penyerbuan. 2 pelanggaran, penggangguan (of privacy).
invective	kb. makian, cercaan, cacimaki.
inveigh	kki. mengecam. to i. against socialism melancarkan kecaman yang pedas terhadap sosialisme.
inveigle	kkt. membujuk, memperdayakan. to i. s.o. into membujuk seseorang untuk.
invent	kkt. 1 menemukan, menciptakan (s.t. new). 2 membuat-buat. to i. a story membuat cerita.
invention	kb. 1 (hasil) penemuan, ciptaan. 2 isapan jempol, rekaan, hasil khayalan.
inventive	ks. yang berdayacipta.
inventiveness	kb. dayatemu, keahlian menemukan/menciptakan sesuatu yang baru.
inventor	kb. penemu, pencipta.
inventory	kb. (j. -ries) 1 inventaris. 2 (stocktaking) inventarisasi. to take i. menginventarisasikan. -kkt. menginventarisasikan.
inverse	kb. kebalikan. the i. of 1/2 is 2 kebalikan dari 1/2 adalah 2. -ks. terbalik. in i. ratio dalam perbandingan terbalik.
inversion	kb. 1 pembalikan. 2 gram.: inversi.
invert	kkt. membalikkan. to i. the order of subject and predicate membalikkan susunan pokok kalimat dan sebutan. 2 menelungkupkan (a bottle). -inverted spelling ejaan yang terbalik.
invertebrate	kb. hewan tidak bertulang punggung
invest	kkt. imenanam, menginvestasikan (money, capital). 2 melantik dengan upacara, menobatkan. -kki. to i. in menanam uang dalam. to i. in a new car membeli mobil yang baru.
investation	kb. gangguan, serbuan (of insects).
investigate	kkt. menyelidiki, meneliti, mengusut, memeriksa. to i. a crime menyelidiki kejahatan. investigating committee panitia/komisi penyelidik.
investigation	kb. 1 pemeriksaan, pengusutan (of a case). 2 (research) penyelidikan, penelitian.
investigator	kb. 1 pemeriksa, pengusut. 2 penyelidik, peneliti.
investiture	kb. pentahbisan, pelantikan dalam jabatan.
investment	kb. investasi, penanaman (uang, modal). a good i. investasi yang baik.
investor	kb. penanam uang. heavy i. in that firm orang yang banyak menanamkan uang dalam perusahaan itu.
inveterate	ks. tetap, berurat-berakar. i. smoker perokok yang sudah mendarah daging, seorang yang sudah candu merokok.
invidious	yang menyakitkan hati. i. comparisons perbandingan-perbandingan yang menyakitkan hati.
invigorate	kkt. memperkuat, menyegarkan. this lotion invigorates the skin air pembersih ini memperkuat dan menghidupkan kulit. -invigorating ks. yang menghidupkan/menyegarkan (air).
invincible	ks. tak terkalahkan. i. courage keberanian yang tidak terkalahkan.
inviolable	ks. tidak diganggu-gugat. the king's person was i. diri raja tidak dapat diganggu-gugat.
invisibility	kb. limunan.
invisible	ks. tak kelihatan, limunan, siluman, gaib. bacteria are i ; to the naked eye kuman-kuman tidak dapat dilihat dengan mata biasa. i. ink tinta limunan.
invitation	kb. undangan, uleman.
invite	kkt. 1 mengundang. 2 mempersilakan. 3 meminta. -inviting ks. yang menarik. the water doesn't look very i. air itu tidak begitu menarik kelihatannya.
invocation	kb. doa. to deliver the i. membacakan doa.
invoice	kb. faktir, faktur, paktur.
invoke	invoke
involuntary	ks. 1 tanpa sengaja. i manslaughter pembunuhan yang tak berencana/sengaja. 2 diluar (pengawasan) kemauan.
involve	involve
involvement	kb. kekusutan, persangkutan, keterlibatan.
invulnerability	kb. kekebalan.
invulnerable	ks. kebal, tak dapat dikalahkan.
inward	ks. (dalam) batin. -kk. menuju masuk/kedalam. -inwardly kk. dalam hati-batin.
iodine	kb. 1 yodium. 2 obat merah.
iodized	ks. yang mengandung yodium. i. salt garam dapur yang mengandung yodium.
ion	kb. ion.
ionic	ks. ionis.
ionization	kb. ionisasi.
ionize	kkt., kki. mengalami ionisasi, terurai menjadi ion.
ionosphere	kb. ionosfir.
ionsufferable	ks. tidak tertahankan.
iota	kb. sedikit juapun, sekecil-kecilnya. there's not an i. of truth to that story tidak ada sedikitpun kebenaran dalam cerita itu.
iq.,  i.q.	[intelligence quotient) tingkat kecerdasan, derajat cerdas, angka kecerdasan, hasilbagi inteligensi.
ir.	1 [irish] 1 orang/bahasa irlandia. 2 [irland] irlandia
iranian	kb. 1 orang iran. 2 bahasa iran. -ks. yang berhubungan dengan iran.
iraqi	kb., ks. 1 orang irak. 2 bahasa irak.
irascible	ks. yang lekas marah, lekas naik darah, bengkeng, berang. i. disposition perangai yang suka lekas marah, sifat pemberang.
irate	ks. marah, berang.
ire	kb. kemarahan. to arouse s.o's i. membangkitkan kemarahan seseorang.
ire.	[ireland] irlandia.
iridescent	ks. warna-warni, yang berhubungan dengan perubahan warna.
iris	kb. 1 selaput pelangi (of the eye). 2 (flower) bunga iris.
irish	kb. orang irlandia. 2 bahasa irlandia. -ks. yang berhubungan dengan irlandia.
irishman	kb. (j. -men) orang irlandia.
irk	kkt. kesal hati, jengkel. it irks me to... kesal hati saya...
irksome	ks. yang menjengkelkan/mendongkolkan/ menjemukan.
iron	kb. besi. 2 firm.: seterika (listrik). -ks. 1 besi. 2 keras. 3 kuat. -irons j. belenggu. -kkt. cloth.: menyeterika. i. curtain tirai besi. iron-fisted ks. keras. iron-willed ks. berkemauan keras. -ironing kb. pakaian-pakaian yang hendak diseterika.
ironclad	ks. sukar sekali dirobah, kuat (sekali). i. guarantee jaminan yang kuat.
ironic(al)	ks. 1 ironis. 2 yang mengejek.
ironware	kb. barang dari besi.
ironwood	kb. (kayu) ulin, kayu besi.
ironwork	kb. barang-barang besi.
ironworker	kb. pekerja barang-barang besi.
irony	kb. (j. -nies) ironi, ejekan. i. of fate ejekan nasib. one of the ironies of life salah satu ironi kehidupan.
irradiate	kkt. 1 menyinari. 2 menyorot(i). the patient was irradiated by ultraviolet lamp orang sakit itu disorot dengan lampu ultraviolet.
irradiation	kb. penyinaran, penyorotan, penerangan.
irrational	ks. yang mengigau, tidak logis. i behavior tingkah-laku yang tidak logis atau yang tidak masuk akal. 2 irasional, yang belum diketahui. i. number bilangan persamaan irasional.
irreclaimable	ks. 1 tidak dapat diminta kembali (of objects). 2 yang tak dapat ditebus/ diperoleh kembali (of land).
irreconcilable	ks. tidak dapat didamaikan/dirujukkan kembali.
irrecoverable	ks. tidak dapat diperoleh lagi.
irredeemable	ks. tidak dapat ditukarkan lagi.
irreducible	ks. tidak dapat diperkecil lagi. i. minimum jumlah kecil yang tak dapat dikurangi lagi.
irrefutable	ks. tidak dapat dibantah, tak terbantah. i. argument dalil yang tidak dapat dibantah.
irregardless	kk. = regardless (kurang baik).
irregular	kb. tentara/pasukan liar. -ks. 1 yang tidak ditentukan. 2 luar biasa, lain daripada biasa. 3 tidak berketentuan. 4 (not in order) tidak beres. 5 tidak rata. an i. lot tanah yang tidak rata.
irregularity	kb. (j. -ties) 1 ketidakberesan. i. in the accounts ketidakberesan dalam keuangan. 2 hyg.: sembelit, sukar kebelakang. 3 ketidakteraturan (in breathing).
irrelevance	kb. 1 penyimpangan. 2 ketidaktepatan, ketidakrelevanan.
irrelevancy	kb. (j. -cies) = irrelevance.
irrelevant	ks. menyimpang, tidak bertalian/berhubungan. i. to the problem tidak ada hubungan dengan persoalannya. that's i. itu tak ada hubungannya/pertaliannya.
irreligious	ks. 1 tidak beriman. 2 tidak beragama.
irremediable	ks. 1 tidak dapat diperbaiki. i. oversight kekeliruan yang tak dapat diperbaiki. 2 tidak dapat disembuhkan (of a disease).
irremovable	ks. tidak dapat dipindahkan.
irreparable	ks. 1 tidak dapat diperbaiki. i. damage kerusakan yang tidak dapat diperbaiki. 2 tak dapat diganti, putus arang. i. loss kehilangan yang tak dapat diganti.
irreplaceable	ks. tidak dapat diganti, tidak tergantikan.
irrepressible	ks. tidak tertekan/tertahan. i. emotions emosi yang tidak dapat ditahan.
irreproachable	ks. yang tidak dicela. i. manners sopan santun yang tidak ada celanya.
irresistible	ks. sangat menarik, tak dapat menahan. he's i. to women ia menarik sekali bagi wanita-wanita.
irresolute	ks. ragu-ragu, tidak tegas.
irresolution	kb. keragu-raguan, ketidaktegasan.
irresolvable	ks. tidak terpecahkan/teruraikan.
irrespective	irrespective
irresponsibility	kb. ketidak-bertanggungjawaban, ketiadaan (rasa) tanggung jawab.
irresponsible	ks. yang tidak mempunyai rasa (ber)tanggungjawab.
irresponsive	ks. bersikap acuh tak acuh, tidak perduli.
irretievable	ks. yang tak dapat diperoleh kembali, yang tak dapat ditebus. i. loss kehilangan yang tak dapat diperoleh kembali.
irreverence	kb. sikap kurang sopan, ketidaksopanan.
irreverent	ks. kurang/tidak sopan.
irreversible	ks. tidak dapat diubah. i. decision keputusan yang tak dapat diubah lagi.
irrevocable	ks. tidak dapat dibatalkan, tidak dapat ditarik kembali.
irrigate	kkt. mengairi.
irrigation	kb. pengairan, irigasi. i. canal parit aliran, selokan irigasi.
irritability	kb. (j. -ties) sifat lekas marah.
irritable	ks. (suka) lekas marah.
irritant	kb. yang mengganggu/memedihkan. don't use harsh irritants in your eye jangan pakai bahan-bahan yang amat mengganggu dalam matamu.
irritate	kkt. mengganggu, mendongkol(kan), menjengkelkan. his gestures i. me gerak-geriknya mengganggu saya. -irritating ks. 1 menjengkelkan, mengganggu, membuat perih. 2 memedihkan. i. to the eyes memedihkan bagi mata.
irritation	kb. 1 kejengkelan. source of i. hal yang membuat orang marah/jengkel, sumber kejengkelan. 2 gangguan. i. of the membranes gangguan pada selaput-selaput. nervous i. gangguan (urat) saraf.
is	lih be.
is.	[island, isle] pulau.
isinglass	kb. 1 perekat (berasal dari ikan). 2 mika.
isl.	[island, isle] pulau.
islam	kb. islam. followers of i. pengikut agama islam.
islamic	ks. yang berhubungan dengan islam. i. traditions adat lembaga islam.
islamization	kb. peng-islaman.
islamize	kkt. mengislamkan.
island	kb. 1 pulau. 2 kelompok. islands of resistance here and there kelompok-kelompok yang mengadakan perlawanan disana-sini 3 (traffic) bagian atau tempat (yang aman) di tengah-tengah jalan.
islander	kb. penduduk dari suatu pulau.
isle	kb. pulau (kecil). the british isles kepulauan britania.
ism	kb. aliran.
isn't	[is not] lih be.
isobar	kb. isobar, garis khayalan di peta bumi yang menghubungkan tempat-tempat yang sama tekanan udaranya.
isogloss	kb. garis pada peta yang memisahkan daerah-daerah yang berbeda dalam beberapa sifat-sifat bahasa.
isolate	kkt. 1 mengasingkan. to i. from others mengasingkan dari orang lain. 2 memisahkan. to i. oxygen from hydrogen memisahkan zat asam dari zat air. to i. o.s. from menjauhkan diri dari. -isolated ks. terpencil. i. area daerah yang terpencil.
isolation	kb. isolasi, pengasingan, keterpencilan, pemisahan.
isolationist	kb., ks. (orang) yang suka mengasingkan negerinya dari dunia.
isosceles	ks. samakaki. i. triangle segitiga samakaki.
isotope	kb. isotop.
israeli	kb. orang israel. -ks. yang berhubungan dengan israel.
issuance	kb. pengeluaran. i. of new stamps pengeluaran perangko baru.
issue	kb.1 (pokok) persoalan. 2 terbitan, nomor. 3 hasil.4 anak. -kkt. 1 mengeluarkan (magazines, money, stamp). 2 memberikan (uniforms, parking tickets). 3 membagikan (uniform). -kki. keluar.
isth.	[isthmus] genting tanah.
isthmus	kb. genting tanah. the kra i. genting tanah kra.
istinerary	kb. (j. -ries) rencana perjalanan.
it	kb. sl.: daya seks. -kg. 1 dia, ia. 2 -nya. 3 itu.
it'll	[it will] lih will.
it's	it's
it(al).	[italy] itali(a). 2 [italian) orang itali ; bahasa itali.
italian	kb., ks. 1 orang itali. 2 bahasa itali. i. accent logat itali.
italicize	kkt. menuliskan dengan huruf miring.
italics	kb., j. huruf miring, kursif. the i. are mine tulisan miring itu saya yang membuatnya.
italy	kb. itali(a).
itch	kb. 1 penyakit gatal. 2 keinginan yang besar. -kkt. membuat gatal. -kki. gatal. -itching kb. kegatalan. she has i. feet ia ingin bepergian.
itchiness	kb. 1 hasrat. 2 rasa gatal.
itchy	ks. 1 gatal. 2 gelisah. i. fingers tangan yang selalu ingin menembak.
item	kb. 1 barang, artikel. 2 hal, soal. 3 (news) berita. 4 pokok. 5 nomor.
itemization	kb. perincian.
itemize	kkt. memerinci(kan). itemized bill rekening dengan perhitungan terperinci.
itinerant	ks. yang (pergi) berkeliling. i. farmer petani yang berpindah-pindah tempat. i. preacher khatib yang berkeliling.
its	kg. -nya, kepunyaan. in i. proper place pada tempat yang sebenarnya.
itself	lih self.
iud	[intrautiren device] kb. spiral.
ivied	ks. dijalari tanaman ivy.
ivory	kb. (j. -ries) gading. i. task taring gading. i. coast panitia gading. -ivories j. sl.: tuts-tuts, mata piano.
ivy	kb. semacam tumbuhan menjalar. i. league lembaga/organisasi atletik daripada delapan buah universitas di bagian timur-laut a.s.
j	kb. huruf yang kesepuluh dari abjad inggeris.
j.	1[journal] 1 majalah. 2 [justice] kehakiman.
j. p.	justice of the peace) hakim tingkat rendah di a.s.
j.a.g.	[judge advocate general] ketua kejaksaan agung militer.
j.d.	[doctor of jurisprudence] dokter hukum. 2 [juvenile delinguent] crossboy, crossgirl.
j.v.	[junior varsity] kb. regu olahraga kelas rendah.
ja	[judge advocate] pengacara tentara.
ja.	ja.
jab	kb. 1 tusukan (with needle, spear). 2 box.: jotosan. -kkt. (jabbed) menusuk. to j. s.o's eye out menusuk mata seseorang keluar, mencukil mata seseorang.
jabber	kb. ocehan, obrolan. -kki. mengecek, mengoceh, mengobrol.
jack	kb. 1 auto.: dongkerak. 2 bridge : yoker. 3 elec.: stop kontak. -jacks j. permainan simbang. -kkt. to j. up 1 mendongkerak (a car) 2 menaikkan (prices). 3 memperbaiki, meningkatkan. j. rabbit kelinci yang bertelinga dan berkaki belakang yang panjang.
jackal	kb. serigala, jakal.
jackass	kb. 1 (mule) keledai jantan. 2 orang tolol.
jacket	kb. 1 jas. winter j. jaket musim dingin. 2 sampul (of books). 3 selubung. bed j. baju tempat tidur.
jackfruit	kb. buah nangka, cempedak.
jackhammer	kb. alat pelobang karang atau beton dll.
jackknife	kb. pisau lipat yang besar. -kkt. berlipat. the trailer truck skidded and jackknifed truck gandengan itu tergelincir dan berlipat.
jackladder	kb. tangga dari tali (pada kapal).
jackpot	kb. pot perjudian, hadiah main kartu. to hit the j. memenangkan hadiah besar/pertama.
jackstraws	kb. permainan anak-anak dengan sejumlah biji-biji permainan yang ditaruh tak beraturan, kemudian dipungut satu persatu tanpa menyentuh yang lain.
jacob	kb. yakub. j.'s ladder = jackladder.
jade	kb. permata jade, batu nefrit/lumut.
jaded	ks. letih, sayu, lesu, payah. j. look pandangan yang lesu.
jag	kb. 1 sl.: perasaan, keinginan, kesibukan, kesukaan. crying j. suka menangis. 2 sl.: pesta mabuk-mabukan.
jagged	ks. bergerigi, berigi-rigi. j. edge of a piece of wood pinggir sepotong kayu yang bergerigi.
jaguar	kb. semacam macan tutul di a.s.
jail	kb. penjara, bui. to break j. meloloskan diri dari penjara. -kkt. memenjarakan.
jailbird	kb. penghuni penjara, orang hukuman.
jailbreak	kb. pembongkaran/penjebolan penjara.
jailer	kb. sipir (penjara).
jake	ks. sl.: baik. everything is j. at our end semuanya baik saja pada pihak kami.
jalopy	kb. (j. -pies) inf.: mobil tua.
jam	kb. 1 sele. 2 kemacetan (lalulintas). 3 kesukaran. -kkt. (jammed) 1 menyumbat. 2 mengganggu (broadcast). 3 menekan (the helm). 4 menjepit. 5 berdesak-desakan. -kki. 1 menjadi ketat. 2 berdesak - desakan. -jammed ks. macet. -jamming kb. gangguan.
jamaica	kb. j. shorts celana yang pendek sekali.
jamb	kb. kosen/jenang pintu, tiang (pintu, jendela dsb).
jamboree	kb. inf.: jambore.
jamproof	ks. tahan gangguan. j. transmitter pemancar tahan gangguan.
jan.	[january] bulan january.
jangle	kkt. membunyikan (bells). -kki. berkerincing. jangled nerves saraf yang terganggu
janitor	kb. (pen)jaga gedung/rumah-rumah, portier, pembersih kantor.
janitorial	ks. mengenai jaga rumah. j. service penjagaan gedung.
january	kb. (j. -ries) bulan januari. in j. dalam bulan januari.
jap.	1 [japan] jepang. 2 [japanese] orang jepang ; bahasa jepang.
japan	kb. (negeri) jepang.
japanese	kb. 1 orang jepang. 2 bahasa jepang. -ks. jepang. j. embassy kedutaan besar jepang.
jar	kb. kendi, buli-buli, botol, guci. -kkt. (jarred) 1 menggetarkan. 2 mengejutkan. 3 menggegerkan. -kki. to j. on o's nerves mengganggu saraf. -jarring ks. menggelegar, menderu-deru/gemuruh. j. sound suara/bunyi yang menggelegar.
jargon	kb. bahasa golongan tertentu, logat khusus. political j. bahasa golongan politik.
jasmin(e)	kb. bunga melati/melur.
jaundice	kb. penyakit kuning. -kkt. menyebabkan penuh prasangka. to j. o's view menyebabkan pandangannya penuh prasangka.
jaunt	kb. tamasya, pesiar.
jaunty	jaunty
jav.	[javanese] 1 bahasa jawa. 2 orang jawa.
java	kb. 1 jawa. 2 sl.: kopi. archaeol.: j.man manusia jawa.
javanese	kb. bahasa jawa. a j. seorang jawa. -ks. yang berhubungan dengan jawa.
javelin	kb. lembing, tombak. j. throw lempar lembing.
jaw	kb. anat.: rahang. 2 kekangan, jepitan (of a vise). -kki. sl.: ngobrol.
jawbreaker	kb. sl.: 1 kembang gula yang keras. 2 kata yang sulit diucapkan.
jay	kb. semacam burung.
jaycee	[junior chamber of commerce] kb. inf.: 1 dewan perdagangan junior a.s. 2 anggota dari dewan tersebut.
jayvee	[junior varsity] kb. : regu yunior universitas.
jaywalk	kki. inf.: menyeberang jalan tanpa memperhatikan tanda lalulintas.
jaywalker	kb. inf.: penyeberang jalan yang tidak memperhatikan tanda-tanda lalulintas.
jazz	kb. 1 (musik) jazz. j. band orkes/band jazz. 2 omong kosong. -kkt. sl.: to j. up membuat meriah, meramaikan.
jazzy	ks. inf.: menyolok, terlalu ramai (colors).
jcs, j.c.s.	joint chiefs of staff] gabungan kepala-kepala staf (angkatan bersenjata).
jct(n).	(junction) persimpangan (jalan).
jealous	ks. iri hati, cemburu (of pada, terhadap). -jealously kk. dengan hati-hati, dengan penuh kewaspadaan.
jealousy	kb. (j. -sies) kecemburuan, perasaan iri hati.
jean	kb. kain drill. -jeans j. (celana) jengki.
jeep	kb. jip, jeep, yip.
jeepers	kseru. sompret !
jeer	kb. ejekan, cemooh. -kkt. mencemoohkan, memperolok-olokkan, mengejek. -kki. to j. at mencemoohkan. -jeering kb. sorakan/teriakan cemoohan.
jehovah	kb. tuhan orang yahudi.
jejune	ks. kurus-kering.
jell	kki. 1 membeku (salad, plans). 2 mengental, mengeras (of jello).
jellied	ks. yang dibeku. j. salad selada yang dibeku.
jello	kb. makanan agar-agar diberi bau buah-buahan.
jelly	kb. (j. -lies) sele.
jellybean	kb. semacam gula-gula agar.
jellyfish	kb. 1 ubur-ubur. 2 inf.: orang yang wataknya lemah.
jellyroll	kb. bolu-gulung pakai sele halus.
jeopardize	kkt. membahayakan. the plans were jeopardized when... rencana itu terancam bahaya ketika....
jeopardy	kb. bahaya, risiko. to be in j. dalam bahaya.
jerk	kb. 1 sentakan, renggutan (of rope). 2 sl.: orang tolol. -kkt. merenggutkan. -kki. tersentak.
jerkwater	ks. sl.: tidak terletak di jalan besar. j. town kota yang letaknya jauh dari jalan besar.
jerky	ks. tersentak-sentak, tertegun-tegun. his hand is j. tangannya tersentak-sentak.
jerry	ks. j. can jerigen, jeriken. jerry-built ks. dibangun secara serampangan. j. -built house rumah yang tidak kuat buatannya.
jersey	kb. 1 baju kaos. football j. baju kaos pemain sepak-bola. 2 kain rajutan. j. lembu jersey (cow). isle of j. pulau jersey.
jerusalem	kb. bait'almukaddis.
jest	kb. olok-olok, senda-gurau, lelucon. he made the remark in j. dia mengeluarkan ucapan dengan senda gurau. -kki. berolok-olok. to j. at menertawakan.
jester	kb. pelawak.
jesting	jesting
jesus	kb. nabi isa.
jet	kb. 1 av.: jet. 2 pancaran (of water). -kki. (jetted) 1 memancar. 2 naik jet. -ks. hitam pekat. j. hair rambut yang hitam pekat. jet-black ks. hitam legam/pekat.
jetliner	kb. pesawat penumpang jet.
jetsam	kb. barang-barang yang dibuang dari kapal (untuk meringankan kapal).
jettison	kkt. membuang barang-barang keluar (dari kapal atau pesawat terbang untuk meringankannya).
jetty	kb. (j. -ties) dermaga, tembok di laut, pelindung pelabuhan.
jew	kb. orang yahudi. jew-baiting kb. penguberan orang-orang yahudi. -kkt. sl.: menawar sampai harga rendah. jew's-harp kecapi mulut.
jewel	kb. 1 (batu) permata. 2 batu (in a watch). she a real j. dia sungguh-sungguh seorang yang amat baik.
jeweler	kb. jauhari, tukang emas.
jewelry	kb. barang-barang perhiasan. costume j. barang perhiasan (dari permata bikinan).
jewess	kb. yahudi wanita.
jewish	ks. yahudi. he is j. dia yahudi.
jewry	kb. golongan yahudi.
jg, j.g.	[junior grade] lih lieutenant.
jib	kb. tlayar topang. inf.: i like the cut of his j. saya senang melihat tampannya.
jibe	kki. bersesuaian, cocok (with dengan). the two stories do not j. kedua cerita itu tidak cocok satu sama lain.
jiffy	kb. (j. -ties) inf.: sekejap mata, dengan cepat. to do s.t. in a j. mengerjakan sesuatu dalam sekejap mata.
jig	kb. tarian gerak cepat. sl.: the j. is up sudah tidak ada harapan lagi. -kki. (jigged) menari (dengan irama cepat), berjoget (cepat).
jigger	kb. 1 gelas kecil (untuk mengukur minuman kecil). 2 inf.: anu. what's that j. called ? anu itu apa namanya? -kkt. sl.: menyunglap (angka), mengacau-balaukan.
jiggle	kkt. menggoncangkan. -kki. bergoncang.
jigsaw	kb. gergaji ukir. j. pattern pola/potongan mozaik. j. puzzle teka-teki menyusun potongan-potongan gambar.
jilt	kkt. menolak cinta, memutuskan hubungan percintaan.
jim	kb. j. grow orang negro. j. -crow car kereta khusus untuk orang-orang negro. jim-dandy kb. sl.: seseorang yang sangat bagus. ks. sl.: bagus sekali. j.-dandy car mobil yang bagus sekali.
jimmy	kb. (j. -mies) linggis kecil. -kkt.(jimmied) mendobrak, mengungkit.
jingle	kb. 1 bunyi. 2 sajak. -kkt. menggerincingkan (a bell, coin, keys). -kki. bergemerinsing (of a bell, keys, coins).
jingoism	kb. cinta tanah air yang berlebih-lebihan.
jinx	kb. sl.: nasib malang, orang/barang yang membawa sial. -kkt. sl.: membawa nasib malang/sial. to j. s.o. membawa sial bagi seseorang.
jitney	kb. sl.: opelet, bis rakyat.
jitterbug	kki. inf.: berdansa jitterbug.
jitters	kb., j. inf.: kegugupan (yang luar biasa). to get the j. menjadi gugup. she gives me the j. ia membuat saya gugup sekali.
jittery	ks. gelisah, gugup.
jiu-jitsu	kb. jiu-jitsu, bela diri cara jepang.
jive	kb. 1 sl.: logat. 2 sl.: dansa jive. -kki. sl.: menyesuaikan diri untuk.
job	kb. 1 pekerjaan. 2 tugas. 3 kesusahan. to be out of a j. menganggur, tunakarya. by the j. secara borongan. j. lot barang kodian/borongan. j. printer pencetak surat sebaran, kartu dll.
jobber	kb. pemborong.
jobholder	kb. 1 pegawai tetap. 2 pekerja tetap.
jobless	ks. the j. kaum pengangguran/tunakarya. menganggur, tunakarya. kb.
jockey	kb. joki, anak pacuan. -kki. to j. for merebut untuk (position).
jockstrap	kb. cawat olahraga.
jocose	ks. lucu, jenaka.
jocular	ks. yang lucu. j. remarks komentar-komentar yang lucu.
joe	kb. sl.: orang (laki-laki). he's a good j. dia adalah orang yang baik. sl.: j. blow orang biasa.
jog	kb. 1 jalan-jalan. 2 sentakan. -kkt. (jogged) menyentakkan. -kki. berjalan/lari pelan-pelan.
john	kb. sl.: kakus, w.c. j. doe nama sembarang orang. inf.: j. hancock tandatangan. j. q. public umum, orang ramai.
johnny	kb. (j. -nies) inf.: pemuda luntang-lantung. johnny-come-lately orang baru, masih hijau. inf.: j. on the spot kb. siap-sedia, siap-siaga.
join	kkt. 1 ikut serta dengan. 2 menyusul. 3 menjadi anggota (club, party). 4 memeluk. 5 menghubungkan. 6 mengikat. 7 berbatasan/berhubungan dengan. -kki. 1 berhubungan. 2 menjadi anggota.
joiner	kb. 1 inf.: seseorang yang suka menjadi anggota perkumpulan-perkumpulan. 2 carp.: tukang kayu yang membuat mebel.
joint	kb. 1 anat.: tulang sendi. 2 sl.: tempat kelas rendah (restoran, bar, hotel). 3 lipatan (of knife). -ks. bersama. -jointly kk. bersama-sama.
joist	kb. kasau, kasok, balok silang.
joke	kb. lelucon, dagelan. to crack a j. berkelakar, menceritakan lelucon. -kki. berkelakar, bergurau. -joking kb. senda-gurau. -jokingly kk. secara berkelakar/bersenda-gurau, tidak sungguh-sungguh.
joker	kb. 1 badut, pelawak. 2 batu penarung, "udang dibalik batu". 3 sl.: siapa orangnya.
jokester	kb. badut, pelawak.
jolly	ks. gembira, riang, ria. -kkt. membuat gembira, menghibur. try to j. him a bit cobalah hibur dia sedikit.
jolt	kb. 1 sentakan. 2 pukulan. -kkt. menggoyangkan. -kki. terguncang- guncang, tergoyang-goyang.
jonquil	kb. semacam bunga.
josh	josh
jostle	kkt., kki. berdesak-desakan. -jostling kb. dorong-mendorong, desak-mendesak.
jot	kkt. (jotted) mencatat. to j. down s.o's name mencatat nama seseorang. -jotting kb. memo, catatan.
journal	kb. 1 majalah. learned j. majalah ilmiah. 2 suratkabar. 3 (diary) buku/ catatan harian.
journalese	kb. bahasa surat-kabar.
journalism	kb. jurnalistik, kewartawanan.
journey	kb. kepergian, perjalanan. to set out on a j. pergi mengadakan perjalanan. -kki. bepergian, mengadakan perjalanan. he has journeyed to every part of the world dia telah menjelajahi tiap pelosok bumi.
jove	kb. by j. ! masya allah ! busyet ! astaga !
jovial	ks. periang, baik hati dan gembira.
jowl	kb. 1 daging/gemuk dibawah dagu (pada orang gemuk). 2 rahang.
joy	kb. 1 kegembiraan, keriaan, keriangan. to leap with j. melompat-ompat kegirangan. 2 kesenangan. acool drink is a real j. minuman yang dingin benar-benar merupakan kesenangan. inf.: j. ride bersenang-senang/pelesiran naik mobil.
joyful	ks. bergembira. j. evening malam yang menggembirakan.
joyless	ks. bergembira, tampa kegembiraan.
joyous	ks. bergembira, riang-gembira. j. occasion peristiwa yang penuh kegirangan.
jr., jr.	[junior] anak dari, bin.
jt.	[joint] bersama.
jubilant	ks. bersorak kegirangan, bergembira sekali (over atas).
jubilation	kb. sorak-sorai kegirangan.
jubilee	kb. hari peringatan. diamond j. hari peringatan 60 tahun.
judaism	kb. 1 agama yahudi. 2 adat istiadat yahudi.
judge	kb. 1 hakim. 2 wasit, salah seorang juri (of a track meet, horse show). -kkt. 1 menilai, mempertimbangkan (the merits of s.t.). 2 mengeritik. 3 mewasiti (a contest). 4 menduga. 5 law : mengadili (a case). -kki. it's hard to j. sukar untuk menilainya.
judgement	kb. = judgment.
judgeship	kb. 1 jabatan hakim. 2 masa jabatan seorang hakim.
judgment	kb. 1 pendapat. 2 keputusan. 3 pertimbangan. to show good j. menunjukkan pendangan yang baik. to sit in on j. bersidang mengadili. j. seat kursi pengadilan.
judicial	ks. yang berhubungan dengan pengadilan. j. decision keputusan pengadilan. j. district distrik pengadilan.
judiciary	kb. (j. -ries) pengadilan, kehakiman.
judicious	ks. bijaksana.
judo	kb. judo, yudo.
jug	kb. 1 kendi. 2 (earthenware) buyung, bocong. 3 sl.: penjara.
jugful	kb. sekendi, sebuyung. a. j. of water sekendi penuh dengan air.
juggernaut	kb. 1 teng atau kereta raksasa yang menggilas segala sesuatu yang ada di jalannya. 2 nafsu, kebutuhan atau hal-hal lain yang meminta korban (manusia).
juggle	kkt. menyulap (a ball, figures). -juggling kb. main sunglap (dengan bola).
juggler	kb. pemain sunglap.
jughead	kb. sl.: orang tolol.
jugular	ks. dari atau berhubungan dengan leher atau kerongkongan. j. vein urat merih.
juice	kb. 1 air/sari buah. orange j. air jeruk. 2 getah. gastric j. getah lambung/perut besar. inf.: to stew in o's own j. merasakan akibat dari perbuatan sendiri.
juiceless	ks. tidak berair.
juiciness	kb. keadaan/sifat banyak airnya/sarinya.
juicy	ks. 1 yang banyak airnya, yang mengandung banyak air. 2 inf.: yang menarik, nakal. j. pasage in a novel beberapa kalimat yang nakal dalam roman.
jujitsu	= jiu-jitsu.
jukebox	kb. sl.: gramopon otomat.
jul.	[july] bulan juli.
julep	kb. mint j. semacam minuman dibuat dari wiski atau brendi, gula dan es dan bumbu yang segar.
july	kb. bulan juli. in j. dalam bulan juli.
jumble	kb. kumpulan campur-aduk. -kkt. mencampur-adukkan, mencampur-baurkan. the clothes were jumbled together pakaian- pakaian itu dicampur- adukkan.
jumbo	ks. inf.: yang luar biasa besarnya. i want the j. size saya mau ukuran yang besar.
jump	kb. 1 loncatan. 2 loncat. 3 lompat. 4 kenaikan. -kkt. melompati. -kki. 1 meloncat. 2 melompat. 3 naik. jumping jack mainan anak-anak berupa orang atau binatang yang sendi-sendinya digerakkan dengan seutas tali.
jumper	kb. 1 peloncat (person, horse). 2 cloth.: baju sweater. 3 semacam baju tak berlengan yang biasanya dipakai dengan blus didalamnya.
jumpy	ks. gugup, gelisah.
jun	[june] bulan juni.
jun.	1 [june] bulan juni. 2 [junior] (lebih) muda.
junct.	[junction] persimpangan jalan.
junction	kb. 1 persimpangan jalan. 2 pertemuan dua jalan kereta api.
juncture	kb. 1 titik waktu. at this j. of his career pada titik waktu kariernya. 2 ling.: hubungan suara.
june	kb. bulan juni. j. bug semacam kumbang.
jungketeer	kb. pelancong dengan sesuatu tugas.
jungle	kb. hutan, rimba.
junior	kb. pelajar kelas rendahan di s.m.a. 2 mahasiswa tingkat iii di a.s. -ks. muda. j. partner rekan muda.
juniper	kb. semacam tumbuh-tumbuhan atau pohon. j. berry jintan saru.
junk	kb. inf.: 1 barang-barang rombengan/rosokan/rongsokan/ loakan. 2 nau.: jung. -kkt. inf.: 1 membuang, merombengkan. 2 mengesampingkan. j. dealer tukang loak. j. heap timbunan barang-barang rongsokan.
junket	kb. 1 (trip) perjalanan kerja tetapi seringkali bersenang-senang. 2 susu kental yang asam. -kki. berpesiar/bepergian untuk bersenang-senang sambil bertugas.
junketeering	ks. (ber)keliling. j. professor gurubesar berkeliling.
junkie	kb. sl.: pemadat, pencandu.
junkman	kb. (j. -men) tukang loak.
junky	ks. bermutu rendah. j. merchandise barang dagangan yang bermutu rendah.
junkyard	kb. tempat barang-barang rongsokan.
junta	kb. dewan komplotan.
jupiter	kb. musytari.
juridical	ks. 1 kehakiman. j. rights hak-hak (menurut ) hukum. 2 dari atau berhubungan dengan tatausaha hukum.
jurisdiction	kb. yurisdiksi. j. over hak hukum atas. within o's j. termasuk hak hukum atau batas kekuasaan seseorang.
jurisdictional	ks. berhubungan dengan hukum. j. dispute perselisihan (mengenai ) hukum.
jurisprudence	kb. ilmu hukum, yurisprudensi. medical j. hukum kedokteran.
jurist	kb. yuris, ahli hukum.
jurnalist	kb. wartawan, jurnalis, kuli tinta.
jurnalistic	ks. mengenai kewartawanan/jurnalistik. j. style gaya surat- kabar, gaya bahasa seorang jurnalis.
juror	kb. anggota juri.
jury	jury
juryman	kb. (j. -men) anggota juri.
jus.	[justice] keadilan.
just	ks. adil. 2 pantas. -kk. 1 baru saja. 2 masih. 3 benar-benar. 4 tepat. 5 persis. 6 agak. 7 hanya. 8 -lah. -justly kk. 1 pantas, tepat. 2 secara adil.
justice	kb. 1 keadilan. social j. keadilan sosial. 2 peradilan. to bring s.o. to j. menjatuhkan hukuman yang setimpal. j. of the peace hakim setempat.
justifiable	ks. yang dapat dibenarkan. j. homicide pembunuhan yang dipertanggung-jawabkan. -justifiably kk. berhak. he is j. proud of... dia berhak untuk bangga atas...
justification	kb. pembenaran, dasar kebenaran
justified	lih justify.
justifies	lih justify.
justify	kkt. (justified) 1 membenarkan, menyungguhkan, memberikan alasan. he is justified in leaving early dia dibenarkan untuk berangkat lebih dulu/cepat. 2 memberikan garis tepi (in typing or printing).
justness	kb. kebenaran, keadilan. the j. of his cause keadilan halnya.
jut	kki. (jutted) menonjol,menganjur. the roof juts out two feet from the house atap rumah itu menganjur keluar sepanjang dua kaki.
jute	kb. rami, guni, goni.
juvenile	kb. anak-anak, anak muda. -ks. muda. j. literature bacaan anak muda.
juxtapose	kkt. mendekatkan, menjajarkan.
juxtaposition	kb. penjajaran.
k,k	kb. huruf yang kesebelas dari abjad inggris.
k.o., ko	[knockout] kb. sl.; pukulan yang membuat tidak berdaya. -kkt. menggulingkan, menjatuhkan.
k.p.	[kitchen police] kb. 1 tugas dapur (tentara). 2 prajurit yang bertugas di dapur.
kaiser	kb. kaisar, maharaja.
kale	kb. sayur hijau, semacam kanggkung atau bayam.
kaleidoscope	kb. kaledoskop.
kaleidoscopic	ks. senantiasa berubah-ubah dengan cepat.
kalsomine	kb. = calcimine.
kangaroo	kb. kangguru. inf.: k. court pengadilan yang tak sah.
kans.	[kansas] negarabagian di a.s.
kaolin	kb. tanah liat yang dipakai untuk membuat porselen.
kapok	kb. kapok.
karat	kb. = carat.
katydid	kb. tonggeret.
kayak	kb. sampan kecil dipergunakan oleh orang eskimo.
kayo	kb. sl.: pukulan knockout. -kkt. sl.: memukul dengan kuat dan keras sehingga orang jatuh pingsan.
keel	kb. lunas. k. laying perletakan lunas. -kki. to k. over 1 jatuh pingsan. 2 terbalik, terjungkel (of a ship).
keen	ks. 1 tajam (of knife, rezor blade, sense of humor). 2 tekun, giat. 3 keras. 4 hebat, sengit. -keenly kk. dengan/secara teliti/tajam.
keenness	kb. 1 ketajaman (otak/pikiran, pendengaran dsb). his k. is well-known ketajaman otaknya sangat terkenal. 2 kegemaran. k. for hiking kegemaran melakukan perjalanan kaki.
keep	kb. pencaharian, nafkah. to work for o's k. bekerja mencari nafkah. -kkt. (kept). 1 menjaga. 2 memelihara (children). 3 membuat catatan (books, records). 4 menyimpan. 5 menerima. 6 menunjukkan. 7 turut. 8 menahan. 9 terus. -keeping kb. pemeliharaan .
keeper	kb. 1 pengawas, penjaga. 2 pemelihara (of bees). 3 kurator (of manuscripts). 4 pengurus,pengusaha (of an inn).
keepsake	kb. tandamata, kenang-kenangan.
keg	kb. tong.
ken	kb. pengetahuan, penglihatan. beyond o's k. diluar pengetahuannya.
kennel	kb. kandang (anjing).
kept	lih keep.
kerchief	kb. 1 kain kepala. 2 sapu-tangan.
kernel	kb. 1 (stone, pit) biji. 2 inti. a k. of truth setitik kebenaran.
kerosene	kb. minyak tanah.
kerplunk	kk., kseru. gedebak, gedebuk. it went k. gedebuk bunyinya..
ketchup	kb. = catsup.
kettle	kb. ceret. that's a fine/pretty k. of fish ! keadaannya kacau-balau !
kettledrum	kb. genderang terbuat dari kuningan/tembaga yang cekung yang ditutup dengan kulit.
key	kb. 1 kunci. 2 (piano) tuts, mata piano. 3 tombol jari (typewriter). 4 petunjuk, pedoman, buku jawaban (to a texbook). 5 mus.: (kunci) nada. 6 batu karang, pulau rendah. -ks. pokok. 2 utama, penting. -kkt. menyetem.
keyboard	kb. 1 papan tuts/mata (of a piano). 2 papan tombol jari (of a typewriter).
keyhole	kb. lubang kunci. k. saw gergaji pelubang tempat kunci.
keynote	kb. 1 dasar pikiran, garis pokok. 2 inti, sari, tema. k. address pidato pokok/dasar/utama. -kkt. menyampaikan garis-garis pokok.
keystone	kb. dasar (keimanan).
khaki	kb. dril, (kain) kepar.
kibitz	kki. inf.: orang yang suka ikut-campur dalam urusan orang lain.
kibosh	kb. sl.: 1 omong kosong, bukan-bukan. 2 rintangan, penghalang. to put the k. on s.o./s.t. 1 menahan, menghalangi. 2 menyelesaikan seseorang, sesuatu.
kick	kb. 1 tendangan (of horse). 2 sentakan (of gun). 3 sports : sepak. 4 inf.: keluhan. 5 perangsang. 6 sl.: getaran hati, sensasi.
kickback	kb. sl.: 1 pembayaran kembali. 2 reaksi.
kicker	kb. 1 orang yang menyepak bola. 2 inf.: orang yang suka mengeluh.
kickoff	kb. inf.: pembukaan, permulaan (of a compaign, football).
kid	kb. 1 anak. 2 anak kambing. -ks. muda. -kkt. (kidded) memperolok-olok, mempermain- mainkan. inf.: to k. o.s. membohongi dirinya sendiri. -kki. memperolok-olok
kiddie	= kiddy.
kiddy	kb. (j. -dies) kanak-kanak, anak muda. k. car kereta roda tiga mainan anak-anak.
kidnap	kkt. (kidnapped) menculik. -kidnapping kb. penculikan.
kidnap(per)	kb. penculik.
kidney	kb. ginjal. k. bean kacang merah. kidney-shaped ks. berbentuk ginjal/ lonjong (table).
kill	kb. mangsa. -kkt. 1 membunuh (person, animal). 2 menghilangkan. 3 menolak. 4 mematikan (engine). 5 mematahkan, melumpuhkan. -kki. membunuh. -killing kb. 1 keuntungan besar(on stock market). 2 pembunuhan. ks. hebat, keras.
killer	kb. pembunuh. sl.: k. diller seorang atau sesuatu yang menggemparkan. k. whale semacam ikan paus.
killjoy	kb. orang yang suka merusak kesenangan orang lain.
kiln	kb. tempat/alat pembakaran/ pengeringan.
kilo	kb. 1 kilogram. 2 kilometer.
kilocycle	kb. kilosaikel.
kilogram	kb. kilogram.
kilometer	kb. kilometer.
kilowatt	kb. kilowat. k. hour jam kilowat.
kilt	kb. rok pendek yang dipakai orang scot.
kilter	kb. inf.: out of k. rusak.
kimono	kb. kimono.
kin	kb. sanak, famili. she is k. to him dia pamili dengan dia. dia pamilinya.
kind	kb. macam. to kinds of material dua macam bahan. -ks. baik hati, manis, sayang. kind-hearted ks. baik hati, peramah. k.-hearted person orang yang baik hati.
kindergarten	kb. taman kanak-kanak, sekolah prebel.
kindle	kkt. 1 menyatakan (fire). 2 menghidupkan (the imagination). 3 mengobarkan. 4 membangkitkan (on interest) (in terhadap). -kki. 1 menyala. 2 bercahaya (of a fire). -kindling kb. kayu (ranting-ranting kecil).
kindliness	kb. kebaikan (hati).
kindly	ks. yang penyayang, yang murah hati. -kk. dengan baik hati, sayang
kindness	kb. 1 kebaikan (hati). 2 jasa. to do s.o. a k. berbuat jasa terhadap seseorang.
kindred	kb. keluarga. -ks. yang sama. k. spirit orang yang mempunyai perhatian yang sama.
kinetic	kb. kinetics j. ilmu gerak. -ks. kinetis. k. energy tenaga gerak.
kinfolk	kb. = kinsfolk.
king	kb. raja (ruler, chess). steel k. raja industri baja. bible : kings raja-raja. k. crab belangkas. king-size(d) ks. 1 berukuran besar (of a bed). 2 ukuran panjang (of cigarettes).
kingdom	kb. kerajaan. k. pf bhutan kerajaan bhutan. 2 dunia. animal k. dunia hewan. k. of heaven sorga.
kingfisher	kb. (burung) pekakak.
kingly	ks. seperti raja. he has a k. appearance dia mempunyai tampang seorang raja.
kingpin	kb. inf.: orang yang paling penting, tokoh, gembong.
kingship	kb. pangkat/martabat raja.
kink	kb. kekusutan (in rope or line). 2 kekejangan, kekakuan, perasaan kaku.
kinky	ks. keriting, sangat kusut.
kinsfolk	kb. kaum keluarga/kerabat.
kinship	kb. kekeluargaan, pertalian keluarga.
kinsman	kb. (j. -men). sanak.
kiosk	kb. kios.
kiss	kb. 1 ciuman. -kkt. mencium. to take e. o. saling berciuman. -kki. bercium(an). k. of death sesuatu yang merugikan. -kissing kb. bercium(an). k. kin famili rapat.
kisser	kb. 1 pencium. 2 sl.: mulut.
kit	kb. 1 kotak. 2 peti. 3 buntil, ransel (for traveling). the whole k. and caboodle seluruh keluarga, gerombolan, rombongan.
kitbag	kb. tas barang-barnag perlengkapan.
kitchen	kb. dapur. k. cabinet lemari dapur. k. sink tempat mencuci piring. k. stove kompor.
kitchenette	kb. dapur kecil.
kitchenware	kb. alat-alat dapur.
kite	kb. layang-layang. to fly a k. a) bermain layang-layang. b) sl.: enyah. -kki. inf.: pergi. to k. off to europe pergi ke eropah. to k. a long inf.: meluncur dengan cepat.
kith	kb. kawan-kawan, kenalan-kenalan. k. and kin handai -tolan dan sanak keluarga.
kitten	kb. anak kucing. sl.: to have kittens gelisah, sangat terganggu.
kittenish	ks. genit.
kitty	kb. (j. -ties) 1 kucing. k.! k.! pus ! pus ! 2 (funds) celengan, kotak pot.
klaxon	kb. klakson, sirene.
kleenex	kb. sapu tangan kertas.
kleptomania	kb. kleptomani.
kleptomaniac	kb. orang yang suka mencuri, orang yang berpenyakit panjang tangan.
km	[kilometer] kilometer. km2 ( kilometer persegi). km3 ( kilometer kubik).
knack	kb. kepandaian khusus, ketangkasan. to have the happy k. of doing the right thing memiliki ketangkasan untuk mengambil/ melakukan tindakan yang tepat.
knapsack	kb. ransel, buntil.
knave	kb. 1 bangsat. 2 bridge : yonker.
knead	kkt. menguli, meremas, meramas, mengadoni.
knee	kb. lutut. on bended k. dengan berlipat/bertekuk lutu. -kkt. mengenai/menggebuk dengan lututnya. knee-deep ks. 1 setinggi lutut. 2 terbenam. knee-high ks. setinggi lutut.
kneecap	kb. tempurung lutut.
kneel	kki.(knelt) 1 berlutut. to k. to pick up s.t. berlutut untuk memungut sesuatu. 2 bersujud. to k. in prayer (with the forehead on the ground) bersujud melakukan sembahyang.
kneepad	kb. pelindung lutut.
knell	kb. bunyi lonceng yang dibunyikan perlahan-lahan. -kki. berbunyi dengan perlahan-lahan
knelt	lih kneel.
knew	lih know.
knickers	kb., j. celana tanggung.
knickknack	kb. perhiasan kecil.
knife	kb. (j. knives) pisau. to put the k. in s.o. and twist it menusukkan pisau pada (tubuh) seseorang. lalu memutarkannya. inf.: to go under the k. mengalami pembedahan. -kkt. 1 menikam (dengan pisau). 2 menghantam/mengalahkan. knife-edged ks. tajam.
knifepoint	kb.ujung pisau. to rob s.o. at k. membegal seseorang dengan ancaman pisau belati.
knight	kb. 1 k(e)satria. 2 chess : kuda. -kkt. memberi gelar bangsawan kepada.
knighthood	kb. kesatriaan.
knightly	ks. (bersifat) kesatriaan. k. deed perbuatan kekesatriaan.
knit	kkt. (knitted) merajut (sweater). -kki 1 merajut. 2 bersambung kembali, bersatu kembali (of bones). -knitted,knit ks. yang dirajut.k. garment pakaian yang dirajut. -knitting kb. pekerjaan rajutan. k. needle jarum rajut.
knitwear	kb. pakaian hasil rajutan.
knives	lih knife.
knob	kb. 1 tombol, kenop (door, tv set). 2 pegangan (umbrella). 3 kepala (cane).
knobby	ks. yang menonjol.
knock	knock
knockabout	ks. sehari-hari. to wear casual k. clothes memakai pakaian asal saja.
knockdown	kb. pemukulan/penjotosan sampai roboh, pukulan yang menjatuhkan lawan. sl.: knockdown-drag-out ks. hebat sekali. k.-drag-out fight perkelahian yang hebat sekali.
knocker	kb.pengetuk.
knockout	kb. 1 k.o., pukulan yang membuat lawan tidak berdaya. 2 sl.: orang atau barang yang menyolok/ mempesonakan.
knoll	kb. bukit kecil, busut.
knot	knot
knothole	kb. lobang yang terdapat pada papan bekas dahan/mata kayu.
knotty	ks. 1 bermata (pada kayu). k. pine kayu cemara yang bermata. 2 rumit, ruwet (problem).
know	kb. in the k. tahu. s.o. in the k. orang dalam (yang mengetahuinya). -kkt. (knew, known) 1 kenal pada, mengenal. 2 tahu. 3 menguasai. 4 mengetahui. know-(it)-al kb. orang yang serba tahu.know-how kb. kecakapan tehnik, ketrampilan.
knowkedgeable	ks. yang banyak mengetahui. yang berpengetahuan banyaik.
knowledge	kb. 1 pengetahuan. 2 ilmu pengetahuan. 3 kekuasaan.
known	lih know.
knuckle	kb. 1 anat.: buku jari. rap on the k. teguran pedas, celaan. 2 tulang kaki babi. -kki. to k. down membanting tulang. to k. under mengalah, menyerah kalah.
knucklebone	kb. tulang buku jari.
knucklehead	kb. sl.: orang bodoh.
kodak	kb. kodak, alat potret/pemotret, kamera.
kooky	ks. sl.: aneh, ganjil, istimewa.
koran	kb. qur'an.
korean	kb. 1 orang korea. 2 bahasa korea.
kosher	ks. 1 halal. k. meat daging yang halal. 2 jujur, baik. what you have in mind is not k. apa yang ada di pikiranmu itu tidak baik.
kowtow	kkt. 1 bersujud/berlutu sampai ke tanah (to a superior). 2 menjilat, mengambil muka.
kris	kb. keris. = creese.
kt.	[karat] karat.
kudos	kb., j. inf.: pujian.
kw.	[kilowatt] kilowat.
ky.	[kentucky] negarabagian di a.s.
l	kb. 1 kereta api l (yang ditinggikan). 2 sambungan yang berbentuk l pada pipa.
l, l	kb. 1 huruf yang keduabelas dari abjad inggris. 2 limapuluh dalam angka romawi.
l.	1 [left] kiri. 2 [liter] liter. 3 [low] rendah.
l.a.	[los angeles] kb. kota los angeles.
l.c.	[library of congress] perpustakaan kongres di a.s.
l.c., lc	[lower case] huruf kecil.
l.c.d.	[lowest common denominator] pembagi persekutuan terbesar.
l.h.d.	[doctor of human letters] doktor dalam sastra dan filsafat.
l.i.	[long island] nama pulau termasuk kota new york.
l.s.t.	[local standard time] waktu tolok setempat.
la-di-da	ks. sl.: sok, berlagak.
la.	[louisiana] negarabagian a.s.
lab	inf.: = laboratory.
lab.	[laboratory] laboratorium.
label	kb. 1 etiket (on bottle). 2 nama. to give a group a l. memberikan nama kepada kelompok. -kkt. 1 memberi etiket. 2 menamakan, memberikan nama.
labial	ks. yang berhubungan dengan bibir. l. sound bunyi bibir.
labor	kb. 1 tenaga kerja. 2 buruh. 3 tugas. 4 kerja. hard l. a) kerja berat. b) kerja paksa. -labored ks.1 sukar, sulit. 2 dibuat-buat, tidak wajar. -laboring ks. yang bekerja.
laboratory	kb. (j. -ries) l. assistant asisten/pembantu laboran. l. technician mantri/perakit laboran.
laborer	kb. buruh, pekerja
laborious	ks. sulit, yang memintakan banyak tenaga, susah payah.
labyrinth	kb. 1 suatu susunan yang membingungkan. 2 anat.: labirin.
lace	kb. 1 renda. 2 (shoe) tali. -kkt. 1 mengikat tali (sepatunya). 2 menyusur. -lacing kb. inf.: hantaman.
lacerate	kkt. menoyakkan, mencabit. his feet were locerated by the lava kakinya koyak kena lahar. -lacerated ks. koyak. l. wound luka yang koyak.
laceration	laceration
lachrymal	ks. yang berhubungan dengan air mata. l. gland kelenjar air mata.
lachrymose	ks. yang membuat airmata meleleh/bercucuran (karena mengharukan/memilukan).
lack	kb. 1 kekurangan. 2 ketiadaan. -kkt. 1 kekurangan. 2 kurang. 3 tak punya. -lacking ks. tak cukup. -kd. karena tak ada sesuatu yang baik untuk dikerjakan, saya tidur saja.
lackadaisical	ks. lesu.
lackey	kb. 1 pesuruh, antek. 2 kacung, bujang.
lackluster	ks. tidak bersemangat/bersemarak.
laconic	ks. singkat, pendek. l. reply jawaban yang singkat.
lacquer	kb. lak(a), pernis, sampang. -kkt. memberi sampang/pernis.
lacrosse	kb. permainan yang memakai bola dan tongkat panjang yang berajut.
lactation	kb. 1 hal menyusukan anak. 2 masa menyusukan anak.
lactic	ks. yang berhubungan dengan susu. l. acid asam susu/laktat.
lacuna	kb. (j. -nas, -nae). kekosongan.
lad	kb. anak laki-laki, kacung.
ladder	kb. tangga, jenjang. to climb the social i. menaiki jenjang kehidupan sosial. ladder-back chair kursi yang tempat bersandarnya berjejak yang melintang.
laden	ks. dimuat. the wagons were l. with produce kereta itu dimuat dengan hasil bumi. -lading kb. muatan. lih bill.
ladies	j. lih lady.
ladle	kb. sendok besar, pencedok, pengerok. -kkt. menyendok. to l. (out) soup menyendok sup.
lady	kb. (j. ladies) 1 wanita. a beautiful l. seorang wanita yang cantik. 2 nyonya. ladies and gentlemen ! tuan-tuan dan nyonya-nyonya (yang terhormat)! sl.: lady-killer kb. hidung belang, sibuaya, pemikat wanita.
ladybug	kb. semacam belalang, kumbang kecil.
ladyfinger	kb. semacam kue berbentuk jari.
ladylike	ks. seperti wanita terhormat. to act in a l. manner bertindak dengan sikap wanita yang terhormat.
ladylove	kb. pacar wanita, wanita kesayangan.
lag	kb. 1 ketinggalan. 2 kelambatan. -kki. (lagged) ketinggalan.
lager	kb. l. beer bir yang tidak keras.
laggard	kb. pencorot, orang yang terlambat.
lagoon	kb. danau di pinggir laut.
laid	lih lay.
lain	lih lie.
lair	kb. sarang, jerumun.
laity	kb. (j. -ties) kaum awam.
lake	kb. danau, telaga.
lakefront	kb. halaman yang menghadap ke danau.
lakeside	kb. tepi danau.
lam	kb. sl.: to take it on the l. melarikan diri.
lamb	kb. anak biri-biri. baby l. anak domba (yang masih kecil). l. chop potongan daging domba biasanya dengan sepotong tulang rusuk.
lambaste	kkt. 1 (hit) memukul. 2 menegur, mencerca. -lambasting kb. 1 cercaan, serangan (fom the press). 2 hantaman.
lame	ks. 1 pincang, timpang (physically). 2 lemah, tidak memuaskan. -kkt. membuat pincang. lame-brained ks. bodoh, dungu, berotak-udang. -lamely kk. 1 pincang. 2 dengan tertegun-tegun.
lameness	kb. kepincangan, ketimpangan.
lament	kb. ratapan, keluh-kesah. -kkt. 1 meratapi (the death of s.o.). 2 menyesali (the fact that). -lamented ks. almarhum.
lamentable	ks. disayangkan, disesalkan. it is l. that... sungguh disayangkan bahwa...
lamentation	kb. ratapan, keluhan.
laminated	ks. berlapis-lapis.
lamp	kb. lampu. table l. lampu meja. l. chimney semperong. l. shade kap lampu.
lampblack	kb. sulang (asap), jelaga.
lamplight	kb. cahaya lampu. to read by l. membaca dengan lampu pelita.
lampoon	kb. cercaan dalam bentuk tulisan atau lukisan. -kkt. mengecam, menyerang.
lamprey	kb. semacam malung, semacam ikan belut besar.
lance	kb. lembing, tombak. -kkt. membuka, menusuk, memotong dengan pisau pembedah (abscess, boil).
land	kb. 1 tanah. 2 negeri.3 daratan.- kkt. 1 mendaratkan (plane_. 2 sl.: menjatuhkan. 3 inf.: mendapat (job). -kki. 1 mendarat. 2 masuk. land-based ks. berpengkalan di daratan. -landed ks. bertanah. -landing kb. 1 pendaratan. 2 tempat penyeberangan perahu.
landfall	kb. 1 pendaratan. 2 daratan yang kelihatan.
landlady	kb. (j. -dies) wanita pemilik penginapan/pondokan.
landlocked	ks. terkurung oleh daratan. l. harbor pelabuhan terkurung oleh daratan.
landlord	kb. 1 tuan tanah. 2 lelaki pemilik penginapan, pondokan atau rumah sewaan.
landlubber	kb. orang darat (tak biasa hidup di laut atau tinggal di kapal).
landmark	kb. 1 (guide) penunjuk. 2 sesuatu yang mudah dilihat atau dikenal. 3 hal yang menonjol. 4 kejadian/peristiwa penting.
landowner	kb. 1 tuan tanah. 2 pemilik tanah.
landscape	kb. 1 pemandangan (alam). 2 bentang darat. -kkt. menanam tanam-tanaman secara teratur/tersusun. -landscaping kb. seni pertamanan/taman.
landslide	kb. longsoran, tanah longsor. to win by a l. menang dengan kelebihan suara yang amat banyak.
landward	kk. arah/menuju ke darat.
lane	kb. 1 jalan kecil/pedesaan. 2 jalur. center l. for left turn only jalur tengah hanya untuk belokan ke kiri.
lang.	[language] bahasa.
language	kb. bahasa. the japanese l. bahasa jepang.
languid	ks. lemah, lesu, tidak bersemangat.
languish	kki. 1 merana. to l. in a hospital merana di rumah sakit. 2 layu (flowers). 3 kendor. his vigilance never languished kewaspadaannya tak pernah kendor.
languor	kb. 1 kelesuan. 2 ketenangan.
lanky	ks. semampai, ramping dan lemas, kurus.
lantern	kb. lentera. l. slide gambar sorot. paper l. lampion.
lanyard	kb. tali penyandang, tali-temali kapal, tali pendek pengikat.
lao	kb. 1 orang lao. 2 bahasa lao.
laos	kb. laos.
laotian	kb. 1 orang lao. 2 bahasa lao.
lap	kb. 1 pangkuan. 2 putaran. 3 bagian. -kkt. (lapped) to l. up 1 meminum (dengan lidah), menghirup. 2 menelan. -kki. memukul-mukul. to l. over tersusun, berjejer. l. dog anjing piaraan yang kecil. l. robe selimut penutup badan bagian bawah.
lapboard	kb. papan alas/pangkuan.
lapel	kb. kelepak.
lapful	kb. sepangkuan.
lapse	kb. 1 kehilangan. l. of memory kehilangan ingatan. 2 selang, jarak waktu. 3 perubahan. 4 penyelewengan. -kki. 1 tergelincir, menjadi. 2 keliwatan waktunya.
larceny	kb. (j. -nies) pencurian.
lard	kb. lemak babi. -kkt. 1 meminyaki (a pan). 2 membungai, menyelingi (o's speech).
larder	kb. tempat penyimpanan makanan.
large	ks. 1 besar. 2 luas. 3 besar-besar. large-scale ks. besar-besaran. -largely kk. sebagian besar.
largess	kb. hadiah, pemberian, sumbangan.
lariat	kb. tali yang dipakai gembala sapi untuk menangkap ternak, tali penjerat ternak.
lark	kb. 1 semacam burung yang suka menyanyi. 2 inf.: kesukaan, permainan riang gembira. 3 senda-gurau, kelakar.
larva	kb. (j. -vae) 1 jentik-jentik, cuk (of mosquito). 2 tempayak. 3 anak serangga.
laryngal	ks. yang berhubungan dengan pangkal tenggorokan.
laryngeal	ks. = laryngal.
laryngitis	kb. radang tenggorokan.
larynx	kb. pangkal tenggorokan.
lascivious	ks. yang menimbulkan nafsu berahi, yang menerbitkan gairah.
laser	kb. laser. l. beam sinar laser.
lash	kb. 1 cambukan. 2 kibasan, pukulan (of a tail). 3 (eye) bulu mata. -kkt. 1 mencambuk, mencemeti. 2 mengibas (sails, tail). 3 mengikatkan. -lashing kb. 1 cacian, serangan. 2 pukulan.
lass	kb. (anak) gadis.
lassitude	kb. kelesuan, kelemahan.
lasso	kb. = lariat. -kkt. menjerat.
last	kb. 1 kelebut. 2 penghabisan. 3 saat terakhir. 4 terakhir, paling akhir. -ks. 1 yang terakhir. 2 penghabisan. 3 yang lalu. -kk. terakhir. -kki. 1 mencukupi. 2 tahan 3 hidup. 4 bertahan. -lastly kk. akhirnya. -lasting ks. abadi, kekal.
lat.	[latitude] garis lintang, pembalik.
latch	kb. kancing, grendel, palang pintu. -kkt. mengancing, memalang, memasang palang/grendel.
latchstring	kb. tali kancing. the l. is always out orang selalu diterima dengan senang hati.
late	ks. 1 yang baru-baru ini. 2 terlambat. 3 almarhum. 4 bekas. -kk. terlambat. -later ks. yang belakangan. -latest ks. 1 yang terakhir. 2 terbaru. 3 selambat-lambatnya. -lately kk. akhir-akhit ini, belakangan ini.
latecomer	kb. 1 orang/pendatang baru. 2 orang yang terlambat.
lateness	kb. keadaan sudah jauh malam, sudah lewat waktunya. the l. of the hour keadaan jauh malam.
latent	ks. 1 terpendam, tersembunyi. l. talent bakat terpendam. 2 tersembunyi, belum kelihatan. l. infection infeksi yang belum kelihatan.
lateral	kb. bunyi lateral. -ks. cabang samping. l. branch of the family cabang samping dari keluarga itu. -lateralty kk. secara menyamping, arah ke samping, disamping, sampingan.
latex	kb. getah.
latfoot	kb. sl.: polisi.
lath	kb. bilah, belebas.
lathe	kb. mesin bubut.
lather	kb. 1 busa (on horse). 2 busa sabun. -kkt. menyabuni (the face). -kki. 1 membusa (of a horse). 2 berbusa (of soap)
latin	kb. bahasa latin. l. america amerika latin. l. american orang amerika latin.
latitude	kb. 1 geog.: garis lintang, pembalik. 2 kebebasan, ruang gerak. to have wide l. mendapat ruang gerak yang luas.
latrine	kb. kakus.
latter	ks. 1 yang belakangan/terakhir. 2 akhir.
lattice	kb. 1 kisi-kisi. 2 pola-pola geometris dari molekul-molekul, atom-atom dll. -kkt. memberi berkisi-kisi.
latticework	kb. kisi-kisi.
laud	kkt. memuji, menyanjung.
laudable	ks. patut dipuji, terpuji. l. quality sifat yang terpuji.
laudatory	ks. bersifat pujian. l. remarks ucapan-ucapan yang berisi pujian.
laugh	kb. tertawa(an), gelak. -kki. tertawa. -laughing kb. ketawa-ketawa, tertawa, gelak.
laughable	ks. menggelikan, menjadikan tertawa, menjadi tertawaan, menertawakan. l. mistake kesalahan yang menjadi tertawaan.
laughingstock	kb. sasaran olok-olok.
laughter	kb. gelak, ketawa, gelak-tertawa. there was l. after his remarks terdengar gelak ketawa setelah dia memberi komentar.
launch	kb. 1 kapal berkas/barkas. 2 penurunan ke air, lancaran (of ship). 3 luncuran (of a space vehicle, missile). -kkt. 1 meluncurkan. 2 melancarkan, memasukkan (s.o. in business). 3 mengadakan (attack, compaign). 4 melontarkan, mengajukan.
launder	kkt., kki. mencuci. to have a blouse laundered menyuruh cuci blus.
laundress	kb. penatu (perempuan), tukang cuci.
laundromat	kb. tempat cuci otomat.
laundry	kb. (j. -ries) 1 penatu, binatu. 2 pakaian kotor, cucian. l. soap sabun cuci.
laundryman	kb. (j. -men) tukang penatu/binatu.
laureate	kb. lih poet.
laurel	kb. pohon salam. l. weath kalung daun salam. -laurels j. tennis laurels rangkaian kemenangan- kemenangannya dalam tenis.
lava	kb. lahar.
lavatory	kb. (j. -ries) 1 (basin) bak mandi. 2 (w.c) kamar kecil. 3 kamar mandi.
lavender	kb. warna lembayung muda.
lavish	ks. mewah. 2 berlebih-lebihan. 3 boros. -kkt. 1 mencurahkan (offection) (on pada). 2 menghamburkan (money) (on untuk). -lavishly kk. dengan boros/royal.
law	kb. 1 hukum. 2 dalil. 3 alat-alat hukum, polisi. 4 undang-undang. law-abiding ks. yang patuh pada hukum. l. court pengadilan (hukum), kantor pengadilan. l. enforcement pelaksanaan hukum.
lawbook	kb. 1 buku hukum. 2 kitab undang-undang.
lawbreaker	kb. pelanggar hukum.
