alto	kb. 1 penyanyi dengan suara alto. 2 nada suara wanita yang terendah.
altogether	kb. in the a. dengan telanjang bulat. --kk. 1 semuanya. 2 sama sekali. 3 pada keseluruhannya.
altruism	kb. altruisme, sifat mementingkan kepentingan orang lain.
altruistic	ks. altruistik. that foundation is most a. yayasan itu sangat altruistik. yayasan itu melulu mementingkan kepentingan orang lain.
alum	kb. tawas.
aluminum	kb. aluminium. a. foil kertas aluminium. a. ware barang-barang aluminium.
alumna	kb. (j. -ae). tamatan, lulusan, wanita bekas murid dari sesuatu sekolah.
alumnae	kb. j. dari alumna.
alumni	kb.j. dari alumnus.
alumnus	kb. (j. -ni). lulusan, tamatan, bekas pelajar lelaki sesuatu sekolah.
alveolar	ks. yang berhubungan dengan alveolus.
alveolus	kb. 1 lobang tempat gigi di rahang. 2 gelembung paru.
always	kk. selalu, senantiasa. she is a. singing ia selalu menyanyi.
am	lih be
am.	1 (america) amerika. 2 (american) orang amerika.
amalgam	kb. 1 campuran. 2 = alloy.
amalgamate	kkt. mencampur, menjadikan satu. to a. mercury with other metals mencampur air raksa dengan logam lain. --kki. menjadi satu, bercampur. the two unions amalgamated dua serikat buruh itu menjadi satu.
amalgamation	kb. 1 tindakan atau proses percampuran. 2 penggabungan. a. of the two trade unions penggabungan kedua serikat buruh itu.
amass	kkt. mengumpulkan, menumpuk, menimbun, menghimpun. to a. a fortune mengumpulkan kekayaan.
amateur	kb. 1 amatir. 2 pekerjaan seseorang yang tidak begitu baik. a. standing keamatiran.
amateurish	ks. secara kurang baik, tidak secara ahli.
amateurishly	kk. kurang baik. the work was a. done pekerjaan itu dikerjakan dengan kurang baik.
amatory	ks. penuh rasa kasih, dengan asmara cinta, dengan kasih sayang. an a. look pandangan dengan penuh rasa kasih.
amaze	kkt. mengherankan, mengagumkan, menakjubkan.
amazed	ks. kagum, heran, takjub.
amazement	kb. keheranan, katakjuban, kekaguman. to my utter a. he wont ia menang dan hal itu sangat mengherankan saya. ia menang samasekali diluar dugaan saya.
amazing	amazing
ambassador	kb. duta besar, dubes. ambassador-at-large duta besar keliling. a. extraordinary duta luar biasa. a. plenipotentiary duta besar dengan kekuasaan penuh..
ambassadress	kb. dutawati (besar), dutabesar wanita, dubes wanita.
amber	kb., ks. (warna) kuning sawo (lampu lalu lintas). a. light cahaya kuning (gading), cahaya kekuning-kuningan
ambidexterity	kb. 1 kecakapan mempergunakan kedua tangan dengan sama baiknya. 2 ketangkasan/kecakapan luar biasa.
ambidexterous	ks. 1 cakap mempergunakan kedua belah tangan dengan sama baiknya. 2 sangat tangkas/pandai.
ambiguity	(dj. -ties) ati-dua, kedwiartian, kemenduaan.
ambiguous	ks. berarti-dua.
ambition	kb. ambisi, hasrat, cita-cita. his a. life is to be a lawyer cita-cita hidupnya ialah menjadi pengacara. to make it s.o.'s a. menjadikan cita-cita seseorang.
ambitious	ks. ambisius, berambisi. he is very a. ia ambisinya keras. ia berambisi keras. ia bercita-cita keras.
ambivalence	kb. ambivalensi, dua perasaan yang bertentangan.
ambivalent	ks. ambivalen, berperasaan yang bertentangan.
amble	kki. 1 berjalan seenaknya, berjalan tanpa tergesa-gesa. he ambled along at a leisurely pace ia berjalan seenaknya tanpa tergesa-gesa. 2 berligas (of a horse)
ambrosia	kb. 1 makanan atau suguhan dewa-dewa dalam mitologi yunani. 2 masakan yang terdiri dari pisang yang diiris-iris, jeruk dan kelapa.
ambulance	kb. ambulans.
ambulatory	ks. dapat berjalan. an a. patient orang sakit yang dapat berjalan-jalan.
ambush	kb. penyerangan, penyergapan, pengadangan dengan tiba-tiba. --kkt. mengadang, menyerang dengan tiba-tiba.
ameba	= amoeba.
ameliorate	kkt. menjadi lebih senang/baik, memperbaiki.
amelioration	kb. perbaikan, perbuatan memperbaiki, kemajuan.
ameliorative	ks. yang memperbaiki, bersifat memperbaiki. the regulation has a. effect peraturan itu mengakibatkan perbaikan.
amen	kb. amin, amien.
amenable	ks.1 setuju dengan, menyetujui, menerima. i'll go along if you are a. to the conditions saya akan menyetujui kalau saudara menerima syarat-syaratnya. 2 dapat dipertanggung-jawabkan.
amendment	kb. amandemen.
amends	kb. j. kerugian. you'll have to make amends for the damage kau harus membayar kerugian untuk kerusakan itu. --kkt. mengamandemen, merubah. the law has been amended undang-undang itu telah diamandemen.
amenity	kb. (j. -ties) sikap ramah-tamah. saying "thank you" is an a. that should be taught to children mengatakan terimakasih adalah sikap ramah-tamah yang harus diajarkan kepada anak-anak. -- amenities j. 1 kesenangan, nikmat. 2 fasilitas-fasilitas.
america	kb. amerika.
american	kb. orang amerika. --ks. amerika. he's an a. citizen ia seorang warganegara amerika. a indian orang indian.
americanism	kb.1 logat amerika. this word is an a. kata ini logat amerika. 2 sifat amerika. his a. is very strong sifat amerikanya sangat kuat. 3 adat kebiasaan. that custom is an a. adat itu khusus adat kebiasaan amerika.
americanization	kb. amerikanisasi.
americanize	kkt. menjadi seperti orang amerika. he is completely americanized after a one-year stay ia sama sekali menjadi seperti orang amerika setelah berdiam satu tahun disana.
amerindian	kb., ks. yang bertautan dengan orang indian.
amethyst	kb. batu-batuan, semacam permata, semacam nilam berwarna kecubung atau lembayung.
amiability	kb. keramahan, keramah-tamahan.
amiable	ks. ramah, ramah-tamah. he's a most a. person ia sangat ramah-tamah.
amicability	kb. keramah-tamahan, kebaikan.
amicable	ks. ramah-tamah, baik hati.an a. settlement penyelesaian yang ramah-tamah.
amicably	kk. secara damai. the dispute was settled a. perselisihan itu diselesaikan secara damai.
amid	kd. ditengah-tengah, di kalangan. we stood a. the many tombstones kita berdiri ditengah-tengah batu-batu kuburan yang banyak itu.
amidships	kk. tengah-tengah kapal.
amidst	=amid.
amiss	ks., kk. keliru, salah. i hope nothing is a. saya harap tak ada yang keliru. please don't take this a. harap supaya hal ini jangan diteima salah.
amity	kb. (j. -ties) persahabatan, hubungan baik.
ammo	kb. sl.: = ammunition.
ammonia	kb. amonia.
ammoniac	kb. semacam getah dipakai untuk obat-obatan, juga untuk pelekat barang-barang porselin.
ammunition	kb. amunisi. a. dump gudang amunisi.
amnesia	kb. amnesi(a).
amnesty	kb. (j. -ties) amnesti, pengampunan.
amoeba	kb. amoeba, amuba.
amoebic	ks. amubawi. a. dysentery disenteri amubawi.
amok	kb. amuk, mata-gelap. to run a. mengamuk
among	kd. diantara. to wander a. the ruins berjalan-jalan diantara puing-puing. a. other things antara lain, diantaranya. a. other things, she sings in the choir antara lain dia menyanyi di paduan suara. a. ourselves antara kita..
amongst	= among.
amoral	ks. a-susila, tak sopan.
amorous	ks. berisi/bersifat cinta-kasih. an a. note surat cinta-kasih.
amorphous	ks. tak berbentuk. some objects are a. beberapa benda tak berbentuk.
amortization	kb. amortisasi.
amortize	kkt. melunasi (dengan angsuran). to a. a loan melunasi hutang dengan angsuran.
amount	kb. 1 jumlah, kwantitas. 2 banyak. 3 penuh. --kki. 1 berjumlah. 2 sama dengan.
amour	kb. asmara, cinta (kasih; teristimewa percintaan yang dirahasiakan/klandestin.
amp	sl.: = ampere.
ampere	kb. amper.
ampersand	= &.
amphibian	kb. amphibi. a toad is an a. katak adalah amphibi. --ks. yang berhubungan dengan amphibi. an a. tank tank amphibi.
amphibious	ks. bersifat amphibi. a. troops pasukan amphibi. a. attack serangan dari darat dan laut.
amphitheater	kb. amphiteater.
ample	ks. 1 banyak, luas .a.parking banyak tempat parkir. there's a. room in this car banyak tempat di mobil ini. 2 cukup. do you have an a. supply of food? adakah cukup persediaan makanan?
amplifes	lih amplify
amplification	kb. 1 pengerasan. a. of his speach is difficultin this hall sukar untuk mengeraskan pidatonya didalam ruangan ini. 2 penjelasan tambahan. this statement requires some a. keterangan ini memerlukan penjelasan tambahan.
amplified	lih amplify
amplifier	kb. (pesawat) pengeras. sound a. pengeras suara.
amplify	kkt. (amplified) 1 menjelaskan. i shall a. my statement at a press conference saya akan menjelaskan penegasan saya di konperensi pers. 2 memperkuat, menguatkan, memperkeras. the loudspeaker amplifies the sound pengeras suara memperkuat suara.
amplitude	kb. luas/lebar ayunan.
amputate	kkt. memotong, mengamputasi.
amputation	kb. amputasi, pemotongan.
amputee	kb. invalide, orang cacad, orang yang dipotong sebagian atau seluruh lengan atau kakinya.
amuck	= amok.
amulet	kb. azimat, jimat.
amuse	kkt. 1 membuat orang tertawa, menggelikan hati. 2 memikat, menawan, menarik perhatian. 3 geli. --amused ks. girang, terhibur, senang hati. --amusing ks. lucu.
amusement	kb.1 hiburan. i went there only for a. saya kesana hanya untuk hiburan saja. a. center tempat hiburan. 2 kegirangan, kesenangan, the clown's antics coused a great deal of a. kejenakaan pelawak itu mendatangkan banyak kegirangan.
an	ksst. 1 sebuah, satu, dsb. may i have an orange, please? bolehkah saya ambil sebuah jeruk? 2 per, tiap. he gets a dollar an hour ia mendapat satu dolar per jam. lih a.
anachistic	ks. anarkhistis.
anachronism	kb. anakhronisme, penempatan kejadian pada waktu yang salah.
anachronistic	ks. yg bertentangan ttg zaman, menyalahi zaman, mengandung anakhronisme.
anaemia	=anemia.
anaemic	=anemic.
anaesthesia	anaesthesia
anagram	kb. anagram, penukaran huruf dlm kata-kata sehingga kata itu mempunyai arti lain , seperti lived menjadi devil.
anal	ks. yang bertautan dengan dubur.
analgesia	kb. tahan/tanpa sakit.
analgesic	kb. obat atau cara lain yang menyebabkan tahan sakit.
analistic(al)	ks. analistis, analitik. a. geometry ilmu ukur analitis.
analog	= analogue
analogical	ks. analogis, bertautan dengan analogi, berdasar mengandung/menunjukkan persamaan.
analogize	kkt. memperlihatkan/mempertunjukkan berdasar analogi/persamaan.
analogous	ks. 1 sekilas, sejalan. 2 dapat disamakan. the wings of a plane are a. to those of a bird sayap kapal terbang dapat disamakan dengan sayap burung.
analogue	kb. analog.
analogy	kb. (j. -gies) analogi, persamaan, kias. one can see the a. between an ant colony and human society orang dapat melihat persamaan antara masyarakat semut dan masyarakat manusia. by a. secara perbandingan.
analysis	kb. (j. -ses) 1 analisa, pemisahan. 2 pemeriksaan yang teliti. in the final a. pada hakekatnya. in the final a. it is the performance that counts pada hakekatnya yang terpenting ialah penyelenggaraan.
analyzable	ks. dapat diselidiki (dalam bagian-bagiannya), dapat dipisah/dipecah. this problem is easily a. soal ini dapat dipisah dengan mudah.
analyze	kkt. 1 menganalisa, menganalisir. 2 mengurai(kan), mencerai. 3 memisah.
anarchism	kb. anarkhisme.
anarchist	kb. anarkhis, anarsis.
anarchy	kb. anarki, anarsi.
anathema	kb. laknat, haram, kutuk. drinking is a. to many people miinum minuman keras adalah laknat bagi banyak orang.
anatomical	ks. anatomis. a. specimen contoh anatomi.
anatomist	kb. ahli pengurai tubuh manusia.
anatomy	kb. (j. -mies) anatomi, ilmu urai tubuh.
ancestor	kb.datuk, nenek moyang, leluhur. a. worship penyembahan nenekmoyang.
ancestral	ks. keturunan leluhur/nenekmoyang, berasal leluhur. a. home rumah keturunan/pusaka.
ancestry	kb. (j. -ries) keturunan, asal, leluhur. he can trase his a. back to george washington ia dapat menyusut leluhurnya hingga george washington. of noble a. keturunan bangsawan.
anchor	kb. jangkar, sauh . --kkt. berlabuh, menjangkarkan, membuang sauh.. --kki. berlabuh the boat anchored to the dock kapal berlabuh di dermaga.
anchorage	kb. pe(r)labuhan. to leave a. meninggalkan bersauh.
anchovy	kb. (j. -vies) ikan kecil ( semacam haring).
ancient	ks. 1 kuno. this is an a. piece of furniture ini adalah perabot yang kuno. a. bali bali kuno. 2 purbakala. a. history sejarah purbakala. 3 purba. a. man manusia purba.
ancillary	ks. tambahan, penyokong. a. subject of study mata pelajaran tambahan.
and	ksam. 1 dan. you a. i kau dan aku. 2 tambah. two a. two make four dua tambah dua menjadi empat. his indonesian is getting better a. better bahasa indonesianya makin lama makin baik.
andiron	kb. besi penupang kayu bakar di perapian.
anecdotal	ks. bersifat anekdot. this book is a. in nature buku ini berisi cerita-cerita yang bersifat anekdot.
anecdote	kb. anekdot.
anemia	kb. anemi(a).
anemic	ks. yang menderita kurang darah.
anemometer	kb. alat pengukur jurusan dan kekuatan angin.
anesthesia	kb. matirasa.
anesthesiologist	kb. ahli ilmu bius.
anesthesiology	kb. ilmu pemakaian obat bius.
anesthetic	kb. obat bius (eter, chloroform, dsb).
anesthetist	kb. ahli (pemakaian) obat bius.
anesthtize	kkt. membiuskan, menghilangkan kesadaran.
aneurysm	kb. pembengkakan buluh darah, gondok nadi.
anew	kk. (sekali) lagi, dari semula. he had to begin a. after the accident ia harus mulai sekali lagi sesudah kecelakaan itu.
angel	kb. 1 bidadari. 2 malaikat. a. of death malaikat maut. 3 sl.: penyokong keuangan. who is the a. of this musical? siapa penyokong keuangan sandiwara? be an a. and set the table for me tolong persiapkan meja (makan) untuk saya. a. food cake semacam kue.
anger	kb. marah, kemarahan, amarah, murka, keberangan, kegusaran. his a. showed on his face marahnya tampak pada (air) mukanya. --kkt. memarahkan, membuat marah. his reply angered the traffic cop. jawabnya memarahkan polisi lalulintas.
angina pectoris	kb. kejang jantung.
angle	kb. 1 sudut. 2 segi. 3 inf.: segi (pandangan). --kki. 1 memancing. 2 membelok.
angler	kb. 1 memancing. 2 seorang yang licik, seorang yang pandai memakai tipu muslihat untuk mencapai sesuatu tujuan.
anglicism	kb. anglisisme, keinggris-inggrisan. " jolly good ! is an a. " jolly good" adalah perkataan inggris yang khas.
anglicize	kkt. menginggriskan kata, ungkapan, atau kebiasaan, memberi corak inggris.
angling	angling
anglo-saxon	kb., ks. anglo-saxon. a) bahasa inggris kuno. b) seorang turunan inggris, anglo-saxon.
anglophile	kb. pencinta inggris atau pencinta semua hal yang bersifat inggris.
anglophobe	kb. orang yang sangat membeci atau mencurigai segala yang berbau inggris.
angry	ks. 1 marah, gusar, naik darah. why are you so a.? mengapa kau begitu marah? a. at/with marah pada/dgn. 2 besar. that's an a. sore you have on your thigh itu luka besar yang ada di pahamu. 3 bergejolak. the a. sea laut yang besar ombaknya.
anguish	kb. 1 kesedihan yang mendalam. he was filled with a. ia sangat sedih. 2 derita, penderitaan yang berat.he was in a. until given a shot ia sangat menderita sebelum ia mendapat suntikan. 3 penderitaan. mental a. penderitaan batin.
angular	ks. 1 kaku. he walked with a. movements gerak jalannya kaku. 2 bersiku-siku. 3 kurus, tulangnya kelihatan. he was tall and a. ia tinggi kurus.
angularity	kb. (j. -ties) kekakuan karena kekurusan. the a. of his body was pronounced kakakuan badanya sangat menonjol.
animal	kb. 1 (wild) binatang. 2 (domesticated) hewan. a. fats lemak hewan. --ks. hewani. a. protein protein hewani. a. husbandry ilmu pemeliharaan hewan, ilmu peternakan.a. spirits semangat, jiwa sehat.
animate	ks. yang hidup, bernyawa. --kkt 1 menghidupkan, menjiwai, menggelorakan, menyemarakkan.
animated	ks. 1 yang mengasyikkan an a. discussion diskusi yang mengasyikkan. 2 hidup. a. cartoon kartun hidup.a. doll boneka yang seolah-olah hidup.
animation	kb. semangat, semarak, gelora, kegembiraan. his discussion was full of a. diskusinya penuh semangat.
animism	kb. animisme, penjiwaan (benda-benda).
animist	kb. penganut animisme.
animistic	ks. animistis.
animosity	kb. (j. -ties) dendam, kebencian, rasa permusuhan. he exhibited no a. toward his neighbor ia tidak memperlihatkan dendam terhadap tetangganya.
animus	kb. = animosity.
anise	kb. = aniseed. a. oil minyak adas manis.
aniseed	kb. adas manis.
anisette	kb. minuman yang mengandung adas manis.
ankle	kb. pergelangan kaki. i turned my a. pergelangan kaki saya keseleo. ankle-deep ks. sedalam pergelangan kaki. he was a. -deep in mud ia berdiri di lumpur sedalam pergelangan kaki.
anklet	kb. gelang kaki
ann.	(annual) tahunan.
annals	kb., j. tawarikh, sejarah.
annamese	kb. 1 seorang annam. 2 bahasa annam.
annapolis	kb. sebuah kota di negara bagian maryland. he is at a. dia belajar di akademi al di annapolis.
anneal	kkt. menguatkan (umpama baja, gelas dengan proses memanasi, kemudian mendinginkan). to a. an alloy menguatkan suatu logam campur.
annex	kb. 1 ruangan tambahan. 2 pavilyun. i stayed in the hotel a. saya menginap di pavilyun hotel itu. --kkt. 1 mencaplok, menyerobot. to a. an area mencaplok daerah. 2 menggabungkan.
annexation	kb. pencaplokan, penyerobotan. 2 penggabungan (dengan).
annihilate	kkt. menghancurkan, membinasakan, membasmi, menghapuskan. the army was annihilated tentara itu dihancurkan.
annihilation	kb. penghancuran, pembinasaan, pembasmian, penghapusan.
anniversary	kb. (j. -ries) (hari) peringatan, hari jadi, hari ulang tahun. tomorrow is their twentieth wedding a. besok adalah hari peringatan perkawinan mereka yang keduapuluh.a. edition terbitan peringatan, terbitan hari jadi, terbitan ulang tahun.
annotate	kkt. membubuhi keterangan. the play will have to be annotated sandiwara itu perlu dilengkapi dengan keterangan.
annotated	ks. beranotasi, bercatatan. a. bibliography bibliografi beranotasi.
annotation	kb. anotasi, catatan, keterangan.
annotator	kb. orang yang membuat anotasi/catatan-catatan.
announce	kkt. mengumumkan, memberitahukan, mempermaklumkan. she announced her engagement to mr. kasim ia mengumumkan pertunangannya dengan sdr. kasim.
announcement	kb. 1 pengumuman, pemberitahuan, maklumat. the a. of the meeting was made today pengumuman mengenai rapat itu dikeluarkan hari ini. 2 beriita, maklumat. wedding a. berita/maklumat pernikahan.
announcer	kb. (juru) penyiar. radio a. penyiar radio.
annoy	kkt. 1 mengganggu, menjengkelkan. 2 menggemaskan.
annoyance	kb. gangguan, kejengkelan.
annoying	annoying
annual	kb. 1 buku tahunan. 2 tanaman tahunan (of plants) --ks. 1 tahunan. a. report laporan tahunan. 2 tiap tahun. christmas is an a. event hari natal dirayakan tiap tahun.
annualy	kk. tiap-tiap/setiap tahun. we pay taxes a. kita membayar pajak tiap- tahun.
annuity	kb. (j. -ties) tunjangan hidup (simpanan untuk hari tua.).
annul	kkt. (annulled) membatalkan. the marriage was annulled perkawinan itu dibatalkan.
annulment	kb. pembatalan.
annum	lih per.
anoint	kkt. 1 meminyaki, memberi salep. 2 memberi upacara peminyakan suci. the priest was anointed by the bishop pendeta itu diberi upacara peminyakan suci oleh uskup.
anomalous	ks. ganjil, menyimpang dari yang biasa. the situation of a foreman without real authority is a. kedudukan seorang mandor tanpa kekuasaan yang sesungguhnya adalah ganjil.
anomaly	kb. (j. -lies) 1 kelainan. 2 keganjilan, keanehan, penyimpangan dari yang biasa.
anon	kk. segera. i'll be there a. saya akan segera kesana.
anon.	(anonymous) tanpa nama, tidak diketahui namanya.
anonymity	kb. keadaan tanpa nama.
anonymous	ks. tanpa nama, tidak diketahui namanya. he prefers to remain a. ia lebih suka tidak diketahui namanya. a. letter surat kaleng/buta.
another	ks. 1 yang lain. please give me a. banana, i don't like this one berilah saya pisang yang lain, saya tak suka yang ini. 2 satu lagi. please give me a. banana; i've eaten this o. berilah saya pisang satu lagi. yang tadi sudah saya makan..
ans.	1 (answer) jawaban. 2 (answered) dijawab.
answer	kb. 1 jawaban, sahutan. 2 balasan. --kkt. 1 menjawab, menyahut, membalas. 2 membuka. 3 memenuhi. 4 mengabulkan. to a. back membantah. to a. for 1 bertanggung jawab, menanggung. 2 dipakai (sebagai pengganti) to a. to 1 memenuhi, cocok, sesuai dengan.
answerable	ks. 1 dapat dipertanggung jawabkan/dipersalahkan. he is a. for his crimes ia dapat dipertanggung- jawabkan atas kejahatannya. 2 dapat dijawab. that question is not a. pertanyaan itu tak dapat dijawab.
ant	kb. semut. a. hill sarang semut, busut. flying a. kelekatu, laron. red a. kerangga. white a. anai-anai.
antacid	kb. asam semut, asam yang menetralkan asam-asam.
antagonism	kb..antagonisme, permusuhan, perlawanan, kebencian, pertentangan, peringkaran.
antagonist	kb. 1 lawan. he was a powerful a. ia seorang lawan yang kuat. 2 musuh. the hero defeated each a. pahlawan itu mengalahkan tiap musuh.
antagonistic	ks. bermusuhan, berlawanan, menentang. he had an a. attitude ia sikapnya bermusuhan.
antagonize	kkt. menimbulkan, membuat benci. the will antagonized her surat warisan itu menimbulkan kemarahannya.
antarctic	kb., ks. daerah kutub selatan.
ante	kb. 1 pot, bank, taruhan, pancang (dalam permaian kartu). 2 sl.: sokongan, sumbangan, kontribusi, iuran. --kki. to a. up memberi sokongan/sumbangan.
ante meridiem	sebelum tengah hari. 2 a.m. jam 2 pagi.
anteater	kb. trenggiling.
antebellum	ks. sebelum perang (terutama sebelum perang saudara as). an a. home rumah sebelum perang saudara.
antecedent	kb., ks. kata atau bagian kalimat yang mendahului kata pengganti. in the phrase "the car which i bought", "car" is the a. dalam bagian kalimat "the car which i bought", "car" adalah kata yang mendahului..
antedate	kkt. 1 mendahului, terjadi lebih dulu. the automobile antedates the airplane mobil mendahului kapal terbang. 2 memberi tanggal lebih dulu daripada yang sebenarnya kepada kwitansi.
antediluvian	ks. kuno (sekali), sangat tua. i have an a. car mobil saya kuno sekali.
antelope	kb. semacam kujang bertanduk tanpa ranting.
antenna	kb. 1 antena (radio atau tv). 2 piarit, sungut-sungut serangga, kumis serangga (of insects).
antepenultimate	kb., ks. ketiga dari yang terakhir. the stress falls on the a. syllable tekanan jatuh pada sukukata yang ketiga dari yang terakhir.
anterior	ks. depan, lebih dahulu, muka.
anthem	kb. lagu/nyanyian gereja. national a. lagu kebangsaan.
anthology	kb. (j. -gies) bungarampai.
anthracite	kb. antrasit, batubara keras yang mengkilap.
anthropocentric	ks. anthroposentris.
anthropoid	kb. 1 yang menyerupai manusia. 2 kera besar tak berekor yang mirip manusia seperti oranghutan, gorila, simpanse dsb. --ks. yang menyerupai manusia.
anthropological	ks. yang berhubungan dengan anthropologi
anthropologist	kb. ahli anthropologi.
anthropology	kb. anthrolopologi
anthropometry	kb. anthropometri
anthropomorphic	ks. anthropomorphis
anti- aircraft	ks. a. gun penangkis serangan kapal udara.
anti- imperialist	kb. anti-imperialis.
anti-american	ks. bertentangan dengan kepentingan atau orang amerika.
anti-submarine	ks. melawan kapal-selam. a. warfare peperangan melawan kapal selam.
antibiotic	kb. antibiotika.
antibody	kb. (j. -dies) antibodi, zat dalam darah manusia yang membunuh atau melemahkan bakteri dan racun-racun lain.
anticipate	kkt. 1 mengharapkan. 2 mendahului 3 memenuhi lebih dahulu. 4 mengetahui lebih dulu, merasakan. 5 sangka.
anticipation	kb. 1 mengharapkan, menanti - nanti kan 2 mendahului 3 menunggu, menantikan. we stayed here in a. of his coming kami tinggal disini menunggu kedatangannya.
anticipatory	ks. yang (bersifat) lebih dulu. an a. investment investasi yang ditanam lebih dulu.
anticlimactic	ks. yang bersifat antiklimaks.
anticoagulant	kb. sesuatu yang mencegah pembekuan darah.
anticolonialism	anticolonialism
anticommunist	kb., ks. antikomunis.
antics	kb., j. kelakar, kejenakaan. we laughed at the clown's a. kita ketawa melihat kelakar pelawak itu.
antidote	kb. 1 penangkal (racun). what is good a. for that poison? apakah penangkal yang baik untuk racun itu? 2 pencegah. a boy's club can be a good a. to juvenile delinquency perkumpulan pemuda dapat menjadi pencegah yang baik terhadap soal crossboy.
antifreeze	kb. bahan antibeku.
antihistamine	kb. obat pencegah alergy, antihistamin.
antiklimax	kb. antiklimaks
antimony	kb. logam keputih-putihan yang rapuh untuk membuat obat dan untuk pengeras campuran logam.
antipathy	kb. (j. -thies) antipati. perasaan benci terhadap sesuatu atau seseorang.
antipodes	kb.,j. 1 antipoda, daerah-daerah diatas bumi yang berlawanan letaknya. 2 berlawanan, bertentangan.
antiquarian	ks. yang berhubungan dengan zaman kuno. a. bookshop toko buku yang menjual buku-buku kuno dan tua.
antiquary	kb. (j. -ries) orang yang mempelajari atau mengumpulkan barang-barang kuno
antiquated	ks. kuno. my house and car are a. rumah dan mobil saya sudah kuno.
antique	kb., ks. (barang) antik. that table is an a. meja itu barang antik. a. furniture perabot rumah model kuno. a. shop toko barang-barang antik.
antiquity	kb. zaman purbakala. --antiquities j. barang-barang zaman kuno dari zaman roma.
antiseptic	kb., ks. penangkal infeksi. iodine is an a. yodium adalah penangkal infeksi.
antisocial	ks. anti-sosial. a. behavior tingkah-laku anti-sosial.
antithesis	kb. lawan yang tepat.
antitoxin	kb. antitoksin, penolak bisa.
antitrust	ks. yang menentang penggabungan industri-industri. a. law undang-undang yang menentang penggabungan industri-industri.
antler	kb. angga, tanduk (rusa).
antonym	kb. kata lawan.
anus	kb. dubur, pelepasan.
anvil	kb. paron, landasan.
anxiety	kb. (j. -ties) 1 kegelisahan. a. is a symptom of our time. kegelisahan adalah suatu gejala zaman kita. 2 keinginan. his a. to succeed is praiseworthy keinginannya supaya berhasil patut dipuji
anxious	ks. 1 khawatir, cemas, gelisah. 2 mencemaskan. 3 (eager) menginginkan, ingin (sekali)
any	ks. 1 apa saja, yang mana saja, sembarang saja. 2 satu atau beberapa (dalam pertanyaan-pertanyaan).3 sedikit. 4 lagi. --kg. sesuatu.
anybody	kg. 1 siapa saja. a. who wishes may come to the meeting siapa saja yang ingin boleh datang ke rapat itu. 2 seseorang. will a. volunteer to go? adakah seseorang yang mau pergi dengan sukarela?
anyhow	kk. 1 bagaimanapun juga. i'm sure he would have gone a. saya yakin bahwa ia bagaimanapun juga akan pergi. 2 toh, namun demikian. idid not want to go, but i went a. saya tidak ingin pergi, tetapi saya toh pergi. = anyway.
anyone	kg. 1 siapapun. a. can do it siapapun dapat melakukan itu. 2 siapa saja, seseorang. please let a. have it berikanlah kepada siapa saja. = anybody.
anyplace	kk. inf.: di/ke manapun (juga).
anything	kg. 1 apa saja. you may have a. on this table kau boleh ambil apa saja yang ada di meja ini. 2 sesuatu. do you wish anything else? apakah sesuatu yang saudara inginkan? 3 faedahnya.--kk. a. but samasekali tidak.
anyway	kk. 1 bagaimanapun juga, toh, namun demikian. she wants to come with us a. bagaimanapun juga dia mau pergi dengan kami. 2 bagaimanapun. a. i go about it, i fail bagaimanapun saya mengusahakan nya/mengerjakannya saya tidak berhasil.
anywhere	kk. 1 di/ke manapun (juga), kemana saja. i'll go a. in the world saya sudi pergi kemanapun di dunia ini. 2 kira-kira, boleh jadi..
aorta	kb. batang nadi.
ap	( associated press) nama sebuah kantor berita as.
apace	kk. dengan cepat. winter is coming on a. musim dingin tiba dengan cepat.
apart	kk. berpisahan. the couple decided to live a. pasangan itu memutuskan untuk hidup berpisahan. a. from 1 selain daripada. 2 terlepas. to stand a. menyendiri. that house stand a. from the others rumah itu terasing dari yang lain.
apartment	kb. flat, apartemen. a. house/building gedung apartemen, rumah flat.
apathetic	ks. apatis, tidak menghiraukan, tidak acuh, lesu. he was completely a. towards the matter ia apatis sama sekali terhadap soal itu.
apathy	kb. apati, kelesuan.
ape	kb. siamang, kera, monyet, beruk. --kkt. meniru. the little gir aped her older sister gadis kecil itu meniru kakaknya.
aperture.	kb. 1 lobang, celah, lekah. 2 phot. : lubang lensa.
apex	kb. puncak. he was at the a. of his career ia berada di puncak kariernya.
aphasia	kb. aphasi, kehilangan kemampuan memakai atau memahami kata-kata karena suatu penyakit otak.
aphorism	kb. aphorisme. "there is never a good war or a bad peace" is an a. "tak ada peperangan yang baik atau perdamaian yang buruk"adalah suatu aphorisme.
aphrodisiac	kb. zat perangsang nafsu berahi.
apiary	kb. (j. -ries) tempat pemeliharaan lebah.
apical	ks. apikal, yang menyentuh langit-langit mulut. "t" is an a. sound "t" adalah bunyi yang dibentuk dengan penyentuhan lidah ke langit-langit.
apiculture	kb. pemeliharaan lebah.
apiece	ks. 1 sebuah, sepotong, dsb. the apples are ten cent a. apel itu sepuluh sen sebuah. 2 masing-masing. you may have one cookie a. ambillah kuenya masing-masing satu
aplenty	kk. banyak sekali. he had money a. uangnya banyak sekali.
aplomb	kk. kepercayaan pada diri sendiri. he possessed considerable a. ia mempunyai kepercayaan yang besar pada dirinya.
apocalypse	kb. wahyu, penyingkapan.
apocope	kb. apokope, penghilangan bunyi, huruf, atau suku pada satu perkataan, mis.: tho dari though.
apocryphal	ks. 1 yang sebenarnya diragukan. an a, story cerita yang sebenarnya diragukan. 2 tidak asli. an a. part of the bible bagian injl yang tidak sah.
apogee	kb. 1 titik terjauh dari bumi dalam peredaran suatu satelit. 2 puncak. the majapahit era reached its a. at the time of gajah mada zaman mojopahit mencapai puncaknya pada waktu gajah mada.
apolitical	ks. buta politik, tanpa sifat/hubungan politik.
apologetic(al)	ks. bersifat minta maaf. he sent me an a. letter ia mengirimkan surat minta maaf. kepada saya. he was a. about calling so late ia meminta maaf karena menelpon begitu malam.
apologist	kb. orang yang membela atau mempertahankan suatu pendirian, keyakinan dsb., pembela.
apologize	kki. minta maaf. i apologized to her for coming late saya minta maaf kepadanya karena terlambat datang. i apologized for my appearance saya minta maaf karena pakaian saya kurang pantas.
apology	kb. (j. -gies) 1 permintaan maaf. please accept my apologies terimalah permintaan maaf saya. 2 pengganti yang tidak seimbang. one cup of coffee is only an a. for breakfast semangkok kopi hanyalah pengganti yg tidak seimbang untuk makan pagi.
apoplectic	ks. bersifat, yang berhubungan dengan atau menyebabkan, penyakit apoplexia. a. stroke sawan bangkai.
apoplexy	kb. apoplexia, penyakit pitam , sawan bangkai, ayan.
apostasy	kb. (j. -sies) ridat, kemurtadan.
apostate	kb. orang yang ingkar terhadap agama atau partai.
apostle	kb. rasul.
apostolic	ks. kerasulan, apostolik. a. vicar vikaris apostolik
apostrophe	kb. tanda', tanda apostrof/penghilangan.
apothecary	kb. (j. -ries) ahli obat.
apotheosis	kb. (j. -ses) 1 pendewaan. 2 perwujudan yang sempurna.
appall	kkt. 1 mengerikan, menggemparkan. 2 mengejutkan.
appalling	ks. 1 mengejutkan, mengerikan, menggemparkan. 2 menjijikkan.
apparatus	kb. (j. -ratus atau ratuses) aparat, peralatan, alat, perlengkapan.
apparel	kb. pakaian.
apparent	ks. nyata,jelas kelihatan. the a. size ukuran menurut penglihatan.
apparently	kk. rupanya. a he's not coming today rupanya ia tidak akan datang hari ini.
apparition	kb. 1 hantu. 2 sesuatu yang aneh dan muncul dengan tiba-tiba. the dark a. made the child scream anak itu menjerit ketika melihat bayangan hitam.
appeal	kb. 1 seruan. 2 permohonan (dari hati ke hati) . 3 banding, apel, pertimbangan. 4 daya penarik. kki. to a. a case naik banding (dalam suatu perkara.). --kki. 1 menarik 2 memohon kepada (dari hati ke hati) 3 naik banding.
appealing	ks. menarik.
appear	kki 1 kelihatan. 2 menghadap. 3 muncul 4 terbit. 5 bermain. 6 nampak, tampak, kelihatan. 7 tampil, muncul.
appearance	kb. 1 rupa. 2 kelihatan, penampilan. 3 pertunjukan. 4 keluar dimuka umum. 5 muncul. --appearances j. yang kelihatan. from all appearances kelihatannya, dipandang dari segala segi. to all appearances dalam segala keadaan.
appease	kkt. menenangkan, menentramkan, meredakan. she appreased her mother by making promises ia menenangkan ibunya dengan memberikan janji-janji.2 memenuhi tuntutan. to a. certain countries memenuhi tuntutan-tuntutan negara-negara yang tertentu.
appeasement	kb. 1 penenangan, peredaan, penenteraman. 2 ketenangan, keredaan, ketenteraman.
appellate	ks. yang berhubungan dengan berwewenang dalam naik banding. a. court pengadilan yang berwewenang untuk meninjau kembali putusan hakim.
appellation	kb.sebutan, panggilan, gelar seseorang sebagaimana ia dikenal umum.
append	kkt. membubuhkan. melampirkan, menambahkan. to a. a signature to a document membubuhkan tandatangan pada dokumen. appended to this document is a letter pada dokumen ini dilampirkan sebuah surat.
appendage	kb. 1 anggauta badan. legs are appendages kaki adalah anggauta badan. 2 tambahan, embel-embel.
appendectomy	kb. (j. -mies) pembedahan usus buntu.
appendices	lih appendix
appendictis	kb. radang usus buntu.
appendix	kb. (j. -xes, -dices) 1 med.: usus buntu. 2 tambahan, lampiran. there is an a. to this book buku ini mempunyai tambahan didalamnya.
appertizer	kb. perangsang/pembangkit selera. pickles make good appettizers acar adalah perangsang selera yang baik.
appetite	kb. 1 nafsu makan, selera. a growing boy has a big a. anak laki-laki yang sedang tumbuh mempunyai nafsu makan yang besar. 2 keinginan besar, nafsu, hasrat. he has an a. for research work ia menaruh keinginan besar terhadap pekerjaan penelitian/riset.
appetizing	ks. yang merangsang selera. the food looks a. makanan itu merangsang selera.
applaud	kkt. menghargai/menyambut dengan tepuk-tangan. --kki. bertepuk tangan.
applause	kb. tepuk-tangan, tepukan, sorakan.
apple	kb. buah apel. she's the a. of her father's eye ia kasihsayang ayahnya. a. butter semacam selei apel. a. pie kue tar apel. inf.: as easy as a. pie dengan mudah. to apple-polish inf.: menggula, menjilat, memuji-muji supaya disayangi..
applecart	kb. gerobak memuat aperl inf.: i don't want to do anything to upset the a. cart saya tidak mau melakukan sesuatu untuk mengacaukan usaha itu.
applesauce	kb. saus apel. sl.: that's all a. itu semuanya omong kosong.
appliance	kb. alat-alat. household a. alat-alat rumahtangga.
applicable	ks dapat dipakai. use whatever is a. pergunakanlah apa saja yang dapat dipakai.
applicant	kb. pelamar.
application	kb. 1 (surat) lamaran/permintaan. 2 penggunaaan, pent(e)rapan.3 ketekunan.
applicator	kb. alat pemakai, kwas.
applied	lih apply.
applies	lih apply.
apply	kkt. (applied) 1 memakai, mempergunakan. 2 menginjak. 3 mempergunakan, mengerahkan. 4 memakai, mempergunakan. --kki. 1 berlaku. 2 melamar.
appoint	kkt. 1 mengangkat. 2 menunjuk. 3 menentukan. --appointed ks. ditetapkan.
appointee	kb. orang yang diangkat. he's a political a. ia adalah orang yang diangkat berdasarkan politik.
appointment	kb. 1 pengangkatan, penunjukan. the a. is for two years pengangkatan itu adalah untuk dua tahun. 2 janji. i have an a. with the teacher saya ada janji dengan guru.
apportion	kkt. membagi secara adil. to a. property membagi harta secara adil.
apportionment	kb. pembagian secara adil.
apposite	ks. tepat, pantas. that was an a. remark itu adalah komentar yang tepat.
apposition	kb. keterangan tambahan, (seperti "my sister dalam kalimat "sue, my sister, was married last week" "sue, adik perempuan saya, kawin minggu yang lalu").
appraisal	kb. penilaian, penaksiran, pengharapan.
appraise	kkt. 1 menilai, menghargai. an employer must a. the ability of his employees seorang majikan harus menilai kesanggupan pegawai - pegawainya. 2 menaksir. please a. this diamond for me cobalah taksir intan ini untuk saya.
appraiser	kb. juru taksir.
appreciable	ks. cukup besar, lumayan. the difference in cost was a. selisih biaya itu cukup besar.
appreciate	kkt. 1 menghargai. 2 menilai, menghargai. 3 menyadari, mengerti. to a. the fact memahami.
appreciation	kb. 1 penghargaan, apresiasi. he doesn't show any a. ia tidak memperlihatkan penghargaan sedikitpun. 2 pengertian, pengetahuan, apresiasi. he has no a. for music ia tidak dapat menghargai musik.
appreciative	ks. senang, menghargai, memperlihatkan bahwa ia menghargai. she seemed so a. of our coming ia kelihatannya sangat senang dengan kedatangan kami.
apprehend	kkt. 1 menahan, menawan (a thief). 2 memahami. it impossible to a. what he was saying tak mungkin untuk memahami apa yang dikatakannya. 3 melihat. the thief apprehends danger in every sound maling itu melihat bahaya dalam tiap bunyi.
apprehensible	ks. dapat dipahami/dimengerti. what he said was fully a. apa yang dikatakannya dapat dipahami sepenuhnya.
apprehension	kb. 1 keprihatinan, katakutan pada sesuatu yang akan terjadi. 2 penangkapan, penahanan. 3 kepandaian, pengertian.
apprehensive	ks. kuatir, takut, prihatin, gelisah. he's quite a. about the future ia sangat kuatir pada masa depan
apprentice	apprentice
apprenticeship	kb. pekerjaan sebagai magang, masa belajar suatu keahlian.
apprise	kkt. memberitahukan, memberi kabar. we were appraised of the accident kami diberitahukan tentang kecelakaan itu.
approach	kb. 1 mendekatnya, datangnya, menjelang, tibanya. 2 jalan. 3 perdekatan, pendekatan.
approachable	ks. 1 dapat didatangi. his house is easily a. rumahnya mudah didatangi. 2 mudah ditemui. he's an a. chap ia dapat mudah ditemui.
approaches	kkt. 1 mendekati, mendatangi. 2 berbicara dengan. 3 menemui. 4 hampir. 5 menjelang.
approaching	approaching
approbation	kb. penerimaan dengan baik. everything he did met with a. semua yang dikerjakannya diterima dengan baik.
appropriate	ks. 1 tepat. he came at the a. moment ia datang pada waktu yang tepat. 2 cocok, pantas, kena.. --kkt. 1 menyediakan. 2 mengambil untuk diri sendiri.
appropriateness	kb. kepatutan, kelayakan,kepantasan.
appropriation	kb. derma, pemberian. the school received an a. of $200,00 sekolah itu menerima derma sebanyak $200,000. state a. derma/pemberian oleh negara bagian.
approval	kb. izin, restu, persetujuan. you have my a. to go on the trip saudara mendapat izin saya untuk perjalanan itu. on a. sebagai percobaan. she took the typewriter on a. ia mengambil mesin tik sebagai percobaan.
approve	kkt., kki. menyetujui, setuju.
approved	ks. diakui. an a. college perguruan tinggi yang diakui.
approving	ks. mengakui, menyetujui. she gave him an a. nod ia memberi anggukan yang menyetujuinya.
approvingly	kk. dengan rasa senang/gembira/bangga.
approximate	kkt./ks. kira-kira, kurang lebih. --kkt. 1 berjumlah kira-kira.2 mengira-ngirakan.
approximately	kk. kira-kira. a. how much is it? kira-kira berapa harganya.
approximation	kb. perkiraan, penaksiran, taksiran.
appurtenance	kb. perlengkapan, alat-alat. tvs, radios and other appurtenance of modern life televisi , radio dan lain-lain perlengkapan (tambahan) kehidupan modern.
apr.	april.
apricot	kb. aberikos, aprikot.
april	kb. april. a. fool's day hari pertama bulan april (hari untuk berolok-olok).
apron.	kb. 1 cloth: rok kerja. he is tied to his mother's a. string ia dikuasai oleh ibunya (= selamanya berada dibawah perintah ibunya). 2 pinggir. the plane is parked on the a. kapal terbang itu diparkir di pinggir depan bangsalnya.
apropos	ks. tepat. an a. remark ucapan tepat. a. of mengenai. a. of that, i... mengenai hal itu saya...
apse	kb. sebagian gereja yang menonjol dan berbentuk setengah bundar.
apt	ks. 1 tepat, cocok, kena. 2 tangkas, cerdas. 3 mungkin. 4 suka, condong, mudah. --aptly kk. kena, tepat, jitu. what you have just said is a. put apa yang saudara katakan itu kena sekali.
apt.	(apartement) flat, flet.
aptitude	kb. bakat, kecerdasan, ketangkasan. i have no a. for music saya tak berbakat untuk musik.
aptness	kb. 1 kecocokan. 2 kecerdasan, ketangkasan. 3 kemungkinan. 4 kecondongan.
aquacade	kb. demonstrasi kecakapan-kecakapan olahraga air seperti lompat indah, renang, menyelam, dsb.
aqualung	kb. alat paru-paru air, alat bernafas untuk menyelam (biasanya semacam tengki kecil diikat kepada punggung penyelam).
aquamarine	ks. 1 biru laut. 2 hijau biru.
aquaplane	kb. papan dipakai untuk orang berdiri yang ditarik oleh kapal motor cepat.
aquarium	kb. 1 palung ikan, kolam kaca. 2 gedung untuk memperlihatkan ikan hidup dan tanam-tanaman air.
aquarius	kb. kumba.
aquatic	ks. yang bertautan dengan air. a. plants tanaman-tanaman air. a. sports olahraga air.
aqueduct	kb. saluran/pipa besar untuk jalan air dari jauh, terowongan air.
aqueous	ks. encer.
aquiline	ks. 1 seperti rajawali. 2 (of a nose) bengkok seperti paruh rajawali.
aquiver	kk. gemetar, menggigil. she's all a. with excitement ia samasekali gemetar karena kegembiraan.
arab	kb. orang arab. --ks. arab.
arabian	kb. = arab. --ks. arab. a. horse kuda arab.
arabic	kb. bahasa arab. --ks. arab. a. language bahasa arab. a. numeral angka arab.
arable	ks. baik untuk ditanami. a. land tanah yang dapat/baik untuk ditanami.
arak	kb. arak.
arbiter	kb. juru pisah, wasit.
arbitrary	ks. 1 sewenang-wenang. a. decision keputusan sewenang-wenang. 2 berubah-ubah. an a. character tabiat yang berubah-ubah.
arbitrate	kkt.,kkt mengadili, mengambil keputusan sesudah mendengar kedua belah pihak. to a. alabor dispute memutus/menimbang percekcokan buruh.
arbitration	kb. perwasitan, arbitrasi.
arbitrator	kb. wasit, juru pisah.
arbor	kb.1 punjung, anjang-anjang. 2 rumah kecil (di halaman) yang dinaungi oleh tanam-tanaman yang menjalar.
arc	kb. busar. --kki. (arced /arkt) memancarkan (bunga api listrik). the wires arced when they touched kawat-kawat itu memancarkan bunga api listrik ketika bersentuhan.
arcade	kb. 1 gang beratap. 2 gedung yang mempunyai gang yang beratap biasanya ditempati toko-toko.
arch	kb. lengkungan. a. of the instep bagian telapak kaki yang melengkung..-- arches j. tapak, telapak. fallen arches kaki dengan tapak yang rata, tapak rata. --kkt. 1 melengkungkan. 2 membuat jalan masuk dengan pedang-pedang terangkat.
archaeological	ks. kepurbakalaan. a. service dinas purbakala.
archaeologist	kb. ahli (ilmu) purbakala.
archaeology	kb. ilmu purbakala.
archaic	ks. tidak dipakai lagi, kuno, kolot, lama. an a. expression perkataan yang tidak dipakai lagi
archaism	kb. perkataan kuno/kolot, arkhaisme.
archangel	kb. malaekat yang terpenting.
archbishop	kb. uskup besar.
archbishopric	kb. keuskupan agung.
archdiocese	kb. keuskupan agung.
archduke	kb. pengeran dari kerajaan austria dan beberapa negara lain zaman dahulu.
archenemy	kb. (j. -mies) musuh utama/terbesar.
archeologist	= archaeologist
archeology	= archaeology
archer	kb. pemanah.
archery	kb. panahan, (seni) pemanahan.
archetype	kb. pola dasar. that old model-t is the a. of the ford model-t yang kuno itu merupakan pola dasar bagi ford tahun 1968.
archipelago	kb. nusantara.
architect	kb. ahli bangunan, arsitek.
architectural	ks. yang bertautan dengan arsitektur. a. engineer insinyur bangun-bangunan.
architecture	kb. ilmu bangunan, arsitektur.
archives	kb., j. 1 arsip. 2 tempat penyimpanan dokumen-dokumen.
archivist	kb. petugas/juru arsip, arkhivaris.
archrival	kb. lawan utama, saingan yang paling besar. the two high schools are archrivals kedua sma itu lawan utama.
archway	kb. bagian terbuka/jalan dibawah atap yang melengkung.
arctic	kb., ks. 1 arktik, (kutub) utara. a. circle lingkaran daerah kutub utara. 2 sangat dingin. a. weather hawa yang sangat dingin. --arctics j. sepatu panas yang tahan air meliputi sepatu biasa. (dipakai di daerah dingin).
ardent	ks. sangat rajin. she's an a. student of languages ia seorang pelajar bahasa-bahasa yang sangat rajin. 2 birahi, bergairah bernafsu. he is an a. lover. ia pencinta yang birahi. ia pencumbu yang berapi-api. ia kekasih/perayu yang bergairah.
ardor	kb. 1 semangat. patriotic a. semangat yang patriotik. 2 hasrat, keinginan. his a. overwhelmed her kegairahannya menundukkan hati wanita itu
arduous	ks. sukar, sulit. an a. task tugas yang sulit. an a. path jalan kecil yang sukar.
are	lih be
area	kb. 1 daerah, tempat. this a. is roped off daerah ini ditutup. 2 luas (daerah). what is the a. of this park? berapakah luas taman ini? 3 bidang. the a. of physics bidang fisika.
areca	kb. pinang. a. nut buah pinang.
aren't	(are not) a. you coming? apakah kau tidak datang? lih be.
arena	kb. 1 gelanggang. 2 tempat pertandingan. boxing a. tempat pertandingan/gelanggang tinju.
argot	kb. bahasa/dialek sesuatu golongan political a. dialek politik.
arguable	ks. dapat didebat/disangkal. an a. point pasal yang dapat didebat.
argue	kkt. 1 memperdebatkan, menentang, membantah. 2 mendesak, menganjurkan (dengan kuat).3 membuktikan, memperlihatkan. --kki membantah. to a. against menentang, membantah. to a. for mengusulkan, mendesak.
argument	kb. 1 perbedaan pendapat, percekcokan. 2 alasan, penyanggahan. 3 uraian, penjelasan.
argumentation	kb. argumentasi, uraian, pembuktian.
argumentative	ks. suka menentang/mendebat. an a. person seorang yang suka menentang.
argus-eyed	ks. sangat awas, bermata tajam.
aria	kb. nyanyian tunggal.
arid	ks. 1 gersang, kering. a. land tanah gersang. 2 membosankan, tak menarik, memualkan. an a. field of study lapangan studi yang membosankan
aries	kb. burjamhal.
arise	kki. (arose,arisen) 1 bangun. we a. each morning at 7 kami bangun tiap hari jam 7. 2 timbul. a storm arose angin ribut timbul. 3 berdiri. he arose from the chair ia berdiri dari kursi.
arisen	lih arise.
aristocracy	kb. (j. -cies) 1 aristrokrasi, keningratan. 2 kaum ningrat
aristocrat	kb. anggauta golongan bangsawan, orang ningrat.
aristocratic	ks. 1 aristokratis. he has an a. attitude ia sikapnya aristokratis. 2 bangsawan. he is of an a. family ia berasal keluarga bangsawan.
arithmetic	kb. ilmu hitung/hisab.
arithmetical	ks. mengenai/berhubungan dengan ilmu hitung. an a. problem persoalan mengenai ilmu hitung
ariz.	(arizona) negara bagian di as.
ark	kb. tabut, jung (bahtera nabi nuh), perahu, bahtera.
ark.	(arkansas) negara bagian di as.
arm	kb. 1 lengan. 2 tangan. 3 kekuasaan wewenang. --arms j. senjata, persenjataan. -- kkt. 1 mempersenjatai. 2 memperlengkapi. -armed ks. bersenjata.
armada	kb kesatuan kapal - kapal perang.
armament	kb alat perang . (s) j alat - alat perang.
armature	kb. 1 angker dinamo. 2 perlindungan (of an animal).
armband	kb. ban lengan.
armchair	kb. kursi tangan. a. general jenderal (yang hanya duduk dibelakang meja)
armful	kb. serangkul(an). an a. of books serangkul(an) buku.
armistice	kb. gencatan senjata.
armless	ks. tanpa lengan.
armload	kb. sepemuatan/sepenuh kedua belah tangan. an a. of books buku sepemuatan kedua belah tangan.
armor	kb. baju baja (biasanya dipakai waktu perang zaman dulu). a. plate lapis baja. untuk pelindung kapal perang, teng, mobil dsb.
armored	ks. berlapis baja. an a. car mobil berlapis baja. a. cruiser kapal penjelajah berlapis baja.
armory	kb. (j. -ries) 1 gudang persenjataan. 2 pabrik senjata.
armpit	kb. ketiak, kelek.
armrest	kb. 1 tangan kursi. 2 tangan-tangan di mobil dsb. untuk meletakkan lengan.
army	kb. (j. mies) 1 tentara, bala tentara, lasykar, asykar. to join, enter or go into, the a. masuk tentara. a. surplus barang-barang kelebihan tentara. 2 (ground forces) angkatan darat. a.cadet teruna, taruna, pelonco. a. corps korps ketentaraan. .
aroma	kb. bau harum. the a. of coffy bau harum kopi.
aromatic	ks. berbau sedap/harum. a. flower. rasa yang harum.
arose	lih arise.
around	kd. 1 keliling, sekitar. 2 inf.: dekat-dekat. 3 inf.: terserak-serak sekeliling --kk. 1 inf.: kira-kira. 2 disekitarnya.
arouse	kkt. 1 membangunkan. she tried to a. her mother ia mencoba membangunkan ibu. 2 menimbulkan her actions aroused my suspicion tingkah lakunya menimbulkan kecurigaanku. 3 menggetarkan., menggerakkan.
arrack	= arak.
arraign	kki. 1 mendakwa, menuduh, menyalakan. to a. s.o. on a charge of manslaughter mendakwa seseorang atas tuduhan pembunuhan. 2 menghadapkan (in court).
arraignment	kb. tuduhan, dakwaan.
arrange	kkt. 1 menyusun, menata. 2 mengadakan. 3 mengatur. 4 menyusun, mengubah. 5 menetapkan
arrangement	kb. 1 rencana 2 susunan, rencana. 3 aransemen, susunan musik. 4 persiapan. 5 penetapan.
array	kb. 1 kesatuan tempur/perang, susunan, aturan. 2 perhiasan, dandanan. 3 pertunjukan, pameran. --kkt. mengatur, mempersiapkan, menyusun.
arrears	kb. tunggakan. our rent was in a. for several monts sewa kami tertunggak beberapa bulan.
arrest	kb. penangkapan, penahanan. --kkt. 1 menangkap, menahan. 2 menawan. 3 menahan (pertumbuhannya, penyebarannya,dsb). under a. ditahan, ditangkap.
arresting	ks. yang menawan, yang menarik hati.
arrival	kb. 1 kedatangan, sampainya, tibanya. a. time waktu tiba. 2 yang baru datang. the new arrivals pendatang-pendatang baru itu. on a. setibanya. he was dead on a. at the hospital setibanya di rumah sakit, ia meninggal.
arrive	kki. 1 tiba, sampai. 2 datang. 3 mencapai (hasil). to a. at 1 mengambil, mencapai. 2 tiba di (a place).
arrogance	kb. kecongkakan, kesombongan, keangkuhan.
arrogant	ks. congkak, sombong, angkuh.
arrogate	kki. merebut. he has arrogated to himself the authority formely held by his chief ia merebut kekuasaanya yang dulu di pegang oleh majikannya untuk diri sendiri.
arrow	kb. 1 (anak) panah. 2 tanda panah. the a. points to utica (tanda) panah itu menunjuk ke utica.
arrowhead	kb. kepala/mata/ujung panah.
arrowroot	kb. ararut.
arrt	kb. 1 seni. a. of teaching seni mendidik. 2 kesenian, seni. art and crafts seni dan kerajinan tangan.. 3 lih be. --arts j.ilmu-ilmu sastra.. arts college, faculty of arts fakultas sastra.
arsenal	kb. 1 gudang senjata. 2 penyimpanan alat senjata.
arsenic	kb. warangan, berangan.
arson	kb. pembakaran rumah dengan sengaja.
arsonist	kb. pembakar rumah (dengan sengaja), tukang sundut. penunu.
arterial	ks. yang bertautan dengan urat nadi. a. highway jalan raya yang terpenting, pusat lalu lintas yang berhubungan dengan jalan-jalan lain.
arteriosclerosis	kb. penyempitan pembuluh nadi, pengerasan nadi.
artery	kb. (j. -ries) pembuluh/buluh nadi, urat nadi/denyut. main a. of traffict urat nadi lalulintas jalan raya.
artful	ks. licik, licin. a. schemes rencana - rencana yang licik.
arthritic	kb. he's an a. ia menderita encok. --ks. yang bertautan dengan encok. a. pains sakitnya encok.
arthritis	kb. radang sendi.
arthropod	kb. arthropoda.
artichoke	kb. semacam tumbuhan yang bunganya dimakan sebagai sayur.
article	kb. 1 karangan, tulisan ( dalam suratkabar, majalah). 2 barang, benda. 3 pasal.
articulate	kkt./ ks. pandai berbicara, pandai mengeluarkan pikirannya. --kkt. mengucapkan kata-kata dengan jelas. --kki. bersambung.
articulation	kb. 1 artikulasi, pengucapan. a. of the words artikulasi kata-kata. 2 sambungan. a. of the bones sambungan/persendian tulang-tulang.
artifact	kb. benda, barang-barang hasil kecerdasan manusia seperti perkakas, senjata dsb.
artifice	kb. kelicikan, kecerdasan. she used every a. to gain her end ia mempergunakan segala macam kelicikannya untuk mencapai tujuannya.
artificial	ks. 1 buatan, bikinan. a.fertilizer pupuk buatan. 2 tiruan, palsu. a. flowers bunga-bunga tiruan/kertas. 3 dibuat-buat. her smile is a. senyumannya dibuat-buat.
artificiality	kb. (. -ties) kepalsuan, sifat/corak tiruan. the a. of her smile kepalsuan senyumannya.
artikulatory	ks. yang berhubungan dengan artikulasi. a. position kedudukan (alat-alat bicara) pada waktu mengucapkan.
artillery	kb. artileri, pasukan bagian meriam.
artisan	kb. pekerja tangan yang ahli, mis.: tukang batu, tukang kayu.
artist	kb. 1 seniman, artis. 2 (female) seniwati.
artistic	ks. artistik.
artistry	kb. (j. -ries) ketrampilan seniman.
artless	ks. 1 tanpa seni/keahlian. 2 naif, bersahaja. a. questions pertanyaan-pertanyaan yang naif. alamiah. a. beauty keindahan alamiah.
arty	ks. inf.: sok seniman. he is a member of the a. set ia anggota golongan sok seniman.
as	kk. 1 sebagai. 2 seperti. 3 selama, sambil, seraya. as far as 1 sampai, sejauh. 2 sepanjang, setahu. 3 bagi. as for 1 kalau. 2 mengenai, tentang. as good as praktis, boleh dikatakan. as long as selama, mumpung. as much sebanyak itu..
asbestos	kb. asbes.
ascend	kkt 1 naik. 2 mendaki. --kki . naik.
ascendancy	kb.kb. kekuasaan, pengaruh yang menguasai.
ascendant	kb. kekuasaan, pengawasan. the authority of the crown is in the a. wewenang raja terletak didalam kekuasaan.
ascending	ascending
ascension	kb. 1 rel.: mi'raj. 2 kenaikan.
ascent	kb. pendakian, kenaikan.
ascertain	kkt. mengetahui (dengan pasti). menegaskan, memastikan. he finally ascertained what his boss wanted akhirnya diketahuinya dengan pasti apa yang diinginkan atasannya.
ascertainable	ks. dapat diketahui. his views are readily a. pandangannya dapat segera diketahui.
ascetic	kb. pertapa. he is a. by nature ia sifatnya seperti orang pertapa.
asceticism	kb. pertapaan, tapabrata.
aschan	kb. tempat sampah/abu.
ascribe	kkt. menganggap berasal. the article was ascribe to young writer tulisan itu dianggap berasal dari seorang pengarang muda.
aseptic	ks. suci hama. these surgical instrument are a. alat-alat operasi adalah suci hama.
asexual	ks. 1 tdk berkelamin. 2 tanpa hubungan kelamin. some lower forms of life have a. reproduction beberapa bentuk hidup tingkat rendah berkembang biak tanpa hubungan kelamin.
ash	kb. 1 abu. there are too many ashes in the stove terlalu banyak abu dalam kompor.2 pohon. a wednesday rebo ketujuh sblm paskah, hari pertama puasa masehi
ashamed	ks. malu. i am a. of his behavior saya malu karena perbuatannya.
ashen	ks. kelabu, abu-abu. his face was a. mukanya menjadi kelabu.
ashore	kk. di/ke darat we wanted to go a. kami ingin turun/naik ke darat. the ship ran a. kapal itu kandas di pantai.
ashtray	kb. tempat abu, asbak.
asia	kb. asia. a. minor asia kecil.
asian	kb. orang asia. --ks. asia. a. countries negeri-negeri asia. a. flu flu/demam asia.
aside	kb. suara rendah, bisikan. the actor delivered an a. aktor itu berbicara dalam suara rendah. --kk. disamping. a. from 1 selain/terlepas dari. 2 disamping.
asinine	ks. (sangat) bodoh, tolol. an a. remark ucapan yang sangat bodoh.
ask	1 menanyakan kepada 2 menanyakan. 3 minta . 4 meminta. 5 mengundang.
askance	kb. dengan rasa tidak setuju, dengan rasa curiga. he looked a. at the low offer ia kelihatannya tidak setuju dengan tawaran yang rendah itu.
askew	kk. miring, serong. his hat is a. topinya miring.
asking	kb. cuma-cuma, tinggal minta.
aslant	kk. miring, serong, condong.
asleep	ks. 1 (sedang, lagi) tidur. she was a. when i called i lagi tidur ketika saya telpon. 2 semutan. my foot is a. kaki saya semutan. 3 tidak sadar. fortunately, she was a. to the danger untungnya, ia tidak sadar akan bahaya itu. 4 macet, tidak jalan.
asocial	ks. asosial, tidak suka bergaul dengan orang lain. his attitude is a. sikapnya asosial.
asp	kb.sejenis ular kecil yang berbisa.
asparagus	kb. asperges, aspersi, asperjis.
aspect	kb. 1 segi, aspek. consider every a. of the situation pertimbangkanlah setiap segi dari keadaan itu. 2 pemandangan (of a city, setting). 3 roman, muka (of a person).
aspen	kb. semacam pohon yang daunnya ringan.
aspersion	kb. (kata-kata) yang menjelek-jelekkan, fitnah(an). he cast aspersions upon my character ia menjelek-jelekkan tabiat saya.
asphalt	kb.aspal. kkt. mengaspal (a. road).
asphyxia	kb. keadaan sesak dada.
asphyxiate	kkt. sesak dada/napas. he was asphyxiated by carbon monoxide ia sesak napas karena zat karbon
asphyxiation	kb. sesak napas karena kurang zat asam di darah.
aspic	kb. aspik, semacam agar dibuat dari daging, tomat dsb.
aspirant	kb. calon.
aspirate	kb. bunyi aspirasi. --kkt. mengucapkan bunyi dengan bunyi h (seprti pin, what dsb).
aspirated	ks. "p" in english "pin" is an a. sound "p" dalam bahasa inggris "pin" mengandung bunyi aspirasi.
aspiration	kb. 1 aspirasi, cita-cita. he has no aspirations ia mempunyai cita-cita. 2 aspirasi. english "p" has a. dalam bahasa inggris mengandung aspirasi.
aspire	kki. bercita-cita, menginginkan. he aspires to be president some day ia bercita-cita menjadi presiden pada suatu ketika.
aspirin	kb. aspirin.
aspiring	aspiring
ass	kb. 1 (animal) keledai. 2 orang yang bodoh. don't be a silly a. janganlah sebodoh itu. 3 vlug.: pantat.
assail	kkt. 1 membantah, menyerang. she assailed the speaker with questions ia membantah pembicara itu dengan pertanyaan-pertanyaan. 2 menyerang, menyerbu. the enemy assailed the fortress musuh menyerang benteng itu.
assailant	kb. penyerang, pemerkosa.
assassin	kb. pembunuh.
assassinate	kkt. membunuh.
assassination	kb. pembunuhan.
assault	kb. penyerangan, serangan. --kkt. 1 menyerang. 2 memperkosa.
assay	kb. (peng)ujian kadar logam. --kkt. menguji kadar logam. to a. are menguji kadar logam dari bijih.
assemblage	kb. orang-orang yang berkumpul. the entire a. stood and gave the speaker an ovation semua orang yang berkumpul berdiri dan memberikan sambutan yang hangat kepada pembicara itu.
assemble	kkt. memasang. these cars are assembled by... mobil-mobil ini dipasang oleh... --kki berkumpul. will the group please a. here? rombongan dipersilahkan berkumpul disini.
assembly	kb. (j. -lies) 1 pertemuan, kumpulan. 2 majelis. 3 pemasangan.
assent	kb. persetujuan. --kki. menyetujui, membenarkan, mengiakan.
assert	kki. 1 menyatakan, menegaskan. 2 menuntut, memaksakan. to a. o.s. menonjolkan diri, menuntut hak.
assertion	kb. 1 pernyataan yang tegas. 2 tuntutan. 3 penonjolan.
assertive	ks. 1 tegas. i'm an a. person saya seorang yang tegas. 2 sombong.
assess	kkt. 1 menaksir. the city assessed my property at a higher amount kotapraja menaksir milik saya lebih tinggi. dari yang sesungguhnya. 2 membebani. 3 menilai. how do you a. the situation? bagaimana penilaianmu terhadap keadaan itu?
assessable	ks. wajib pajak.
assessment	kb. 1 taksiran, penaksiran. a. of a house taksiran sebuah rumah. 2 penilaian. a. of a situation penilaian keadaan. 3 beban, pembebanan, pemikulan.
assessor	kb. juru taksir, penaksir.
asset	kb. modal, milik, sifat yang bernilai. tact is a useful a. in a young man bijaksana adalah modal (yang baik) bagi seorang pemuda. --assets j. aktiva. the assets of this firm are astimated at two million dollars aktiva firma ini ditaksir dua juta dollar.
assidnous	ks. tekun, penuh perhatian. he's a. in his studies ia tekun dalam studinya.
assiduity	kb. 1 ketekunan, kerajinan. he displays a. in everything he does ia memperlihatkan ketekunan dalam segala sesuatu yang dikerjakannya. 2 sikap selalu penuh perhatian.
assign	kkt. 1 memberikan. 2 mengangkat, menempatkan. 3 menetapkan, menentukan. 4 menyerahkan. 5 menugaskan. 6 menyebutkan dengan pasti.
assignment	kb. 1 tugas. i am glad to undertake this a. saya girang melakukan tugas ini. 2 penugasan. 3 pengangkatan, penempatan. 4 penetapan. 5 penyerahan (hak atau milik). 6 pekerjaan.
assimilate	kkt. 1 memahamkan, mengerti, menerima. 2 mengasimilasi. 3 mencernakan. --kki. berasimilasi, menerima, menjadi sama.
assimilation	kb. asimilasi, perpaduan, percampuran yang harmonis, penerimaan (yang merata).
assist	kb. bantuan. he received an a. when his tire went flat ia menerima bantuan ketika bannya pecah. --kkt., kki. membantu, menolong. she assisted me ia membantu saya.
assistance	kb. bantuan, pertolongan. he came to her a. ia datang membantu wanita itu. can i be of any a.? apakah saya dapat membantu?
assistant	kb. 1 pembantu, asisten. 2 wakil, pembantu. a. director wakil direktur. a. professor rektor.
assn.	(association) (per)himpunan, persatuan.
associate	kb. 1 teman sejawat, kompanyon, kolega. 2 maskapai. 3 teman, rekan, sekutu. --ks. luar biasa, tidak penuh. --kkt. menghubungkan. --kki bergaul, bercampur gaul.
association	kb. 1 perkumpulan, persatuan. the writers' a. persatuan pengarang. 2 asosiasi, gabungan. 3 persahabatan, pergaulan. knowing you has been a happy a. kenal dengan kau adalah suatu persahabatan yang menyenangkan.
assonance	kb. purwakanti.
assort	kkt. menyusun. --kki. 1 bergaul. 2 cocok, sejenis.
assorted	ks. 1 rupa-rupa, bermacam-macam, berjenis-jenis 2 campuran.
assortment	kb. bermacam-macam, campuran, golongan. there's a nize a. of books in that shop ada bermacam-macam buku yang baik di toko itu.
assuage	kkt. 1 meredakan, menenangkan, mengurangi. to a. her fears meredakan ketakutannya. 2 mengakhiri, menghilangkan. ice water assuages my thirst air es menghilangkan kehausan saya.
assume	kkt. 1 mengambil. 2 memikul, menerima, menanggung. 3 memangku, mulai bekerja. 4 menganggap. -kki. 1 mengira, menganggap, mengharap. 2 bukan.
assumed	ks. pura-pura, sok.
assumption	kb. 1 penerimaan. 2 pengiraan, pra-anggapan. 3 anggapan, perandaian.
assurance	kb. 1 kepastian, jaminan. can you give some a. that they will be here? dapatkah kau memberi kepastian bahwa mereka akan ada disini? 2 ayem, tenang. he has an air of a. about him ia kelihatannya ayem sekali.
assure	kkt. 1 jamin, tanggung. 2 percaya, yakin.
assured	ks. 1 percaya, yakin. 2 pasti, terjamin.
assuredly	kk. pasti, tentu.
aster	kb. aster (semacam bunga).
asterisk	kb. asterisk, (tanda) bintang.
astern	kk. bagian belakang, di buritan. the boat moved rapidly a. kapal itu mundur dengan cepat. full speed a. mundur (dengan kecepatan) penuh.
asteroid	kb. asteroida.
asthma	kb. sakit bengek, asma.
asthmatic	ks. berpenyakit/menderita asma.
astigmatic	ks. astigmatik.
astigmatism	kb. 1 astigmatisme. 2 penolakan terhadap apa-apa yang benar.
astir	ks., kk. bergerak. not a creature was a. tak ada satupun makhluk yang bergerak.
astonish	kkt. mengherankan. her conduct astonished me tingkah lakunya mengherankan saya.
astonished	ks. heran.
astonishing	ks. mengherankan. his generosity was a. kemurahan hatinya mengherankan.
astonishment	kb. keheranan.
astound	kkt. sangat mengherankan/mengejutkan. his sudden death astounded us wafatnya dengan tiba-tiba sangat mengherankan kami.
astral	ks. yang berhubungan dengan bintang-bintang.
astray	kk. (ter)sesat, kesasar. i'm afraid you've gone a. saya kuatir engkau sesat. to lead s.o. a. menyesatkan seseorang. to go a. 1 menjadi nakal (of a person). 2 kesasar/tidak sampai (of a letter).
astride	kk. mengangkang (seperti naik kuda, sepeda dsb). he sat a. his motorcycle ia duduk mengangkang diatas sepeda motornya.
astringent	kb. zat yang menciutkan.
astrologer	kb. ahli nujum.
astrological	ks yang berhubungan dengan ilmu nujum.
astrology	kb. ilmu nujum perbintangan.
astronautics	kb. astronotika.
astronomer	kb. ahli astronomi/falak/bintang-bintang.
astronomical	ks. 1 yang berhubungan dengan ilmu falak. a. computations hitung-hitungan astronomi. 2 jumlah yang amat besar. a. observatory gardu penilikan bintang.
astronomy	kb. astronomi, ilmu falak/bintang(-bintang).
astronout	kb. astronot, angkasawan, juru angkasa. woman a.... angkasawati.
astrophysicist	kb. ahli astrofisika.
astrophysics	kb. astrofisika.
astute	ks. lihay, cerdik, tajam. he's an a. bussinessman ia adalah seorang pengusaha yang lihay.
astuteness	kb. kecerdikan, kelihayan.
asunder	kk. hancur remuk. the log was split a. kayu gelondongan itu hancur remuk.
asylum	kb. 1 suaka, asli asyl. he sought a. in another country ia mencari suaka di negara lain. 2 rumah sakit. insane/mental a. rumah sakit gila.
asymmetrical	ks. asimetris.
asymmetry	kb. asimetri.
asymptote	kb. asimtot, garis lurus yang mendekati suatu kurva, tetapi tidak memotongnya pada jarak yang dekat.
at	kd. 1 di. 2 pada. 3 atas. 4 kepada. 5 dengan. 6 menurut. at all 1 sama sekali. 2 juga. at all coats bagaimanapun juga. at best sebaiknya, dalam keadaan sebaik-baiknya. at first mula-mula. at last akhirnya. at times kadang-kadang.
atavism	kb. atavisme.
atavistic	ks. yang berhubungan dengan atavisme.
ataxia	kb. ataxia, kehilangan perasaan keseimbangan.
ate	lih eat.
atelier	kb. studio, kamar/tempat kerja, loka cipta.
atheism	kb. atheisme, keatheisan.
atheist	kb. atheis. the atheists j. kaum dahriah.
atheistic(al)	ks. atheistis.
athematic	ks. tanpa tema (musik).
athlete	kb. olahragawan, olahragawati, atlit.
athletic	ks. keolahragaan.
athletics	kb., j. olahraga, sport.
athwart	kk. (arah) melintang.
atlantic	kb., ks. atlantik. a. ocean samudera atlantik.
atlas	kb. atlas, buku peta. road a. peta jalan.
atmosphere	kb. 1 atmosfir, lapisan udara atau gas-gas yang meliputi bumi. 2 udara. 3 suasana. 4 phys.: satuan dalam tekanan udara.
atmospheric	ks. yang berhubungan dengan atmosfir.
atoll	kb. atol, pulau karang yang merupakan lingkaran di laut-laut tropika.
atom	kb. atom. a. bomb bom atom. not an a. sezarrahpun tidak. a. smashing penghancuran atom.
atomic	kb., j. atomics bagian ilmu alam yang mempelajari teori atom, struktur, tenaga, dsb. -ks. yang berkaitan dengan atom. a. pile reaktor. a.waste sisa-sisa proses penghasilan tenaga atom. a. weight berat/bobot atom.
atomize	kkt. 1 memisahkan menjadi atom. 2 menyemprotkan suatu cairan. 3 mengubah zat/cair menjadi bagian-bagian yang sangat kecil.
atomizer	kb. 1 alat penyemprot. 2 pompa semprot. 3 pengabut.
atonal	ks. mus.: tanpa nada.
atone	kki. bertobat, menebus. we must a. for our sins kita harus bertobat atas dosa-dosa kita.
atonement	kb. taubat, tobat, penebusan kesalahan atau dosa . day of a. hari penebusan (dosa). to make a. for bertobat atas.
atonic	ks. 1 tanpa tenaga, lemah. 2 tanpa tekanan atau suara. an a. syllable sukukata tanpa tekanan.
atop	ks. di puncak, diatas. he sat a. a flagpole ia duduk di puncak tiang bendera.
atrocious	ks. 1 tidak sopan, kurang ajar, kasar. he has a. manners tingkah lakunya tidak sopan. 2 kejam, mengerikan. that was an a. crime itu adalah kejahatan yang kejam. 3 buruk sekali (of food).
atrocity	kb. (j. -ties) 1 kekejaman, kekejian 2 inf.: ketidak sopanan, kekasaran.
atrophied	kki. mengalami atrophia.
att.	(attorney) pengacara.
attach	kkt. 1 melampirkan, mencantelkan, mengikatkan. 2 mempekerjakan. 3 membubuhkan. 4 memberikan. 5 mengambil, memotong. 6 menyematkan. -kki. melekat/terletak pada.
attache	kb. atase. military a. atase militer. a. bag/case tas atase, tas diplomat.
attached	ks. dempet.
attachment	kb. 1 alat pelengkap/tambahan. 2 kasih sayang, cinta.
attack	kb. 1 serangan, penyerbuan. to be on the a. a) sedang menyerang. b) menjadi pihak yang menyerang. 2 bangkitan (of nerves). -kkt. 1 menyerang (a town). 2 memecahkan (a problem). -kki. menyerang.
attacker	kb. penyerang, penyerbu.
attacking	attacking
attain	kkt. mencapai. he's attained the age of 70 ia telah mencapai usia 70 tahun. -kki. to a. to mencapai. he finally attained to a very high position akhirnya ia mencapai kedudukan yang sangat tinggi.
attainable	ks. dapat dicapai. that goal is a. tujuan itu dapat dicapai.
attainment	kb. 1 hasil yang dicapai. 2 pencapaian, tindakan atau proses mencapai sesuatu. 3 hasil karya.
attempt	kb. percobaan, usaha. he will succeed or perish in the a. ia akan berhasil atau mati didalam percobaan. -kkt. mencoba. the plane attemped a landing kapal terbang itu mencoba mendarat.
attend	kkt. 1 menghadiri (a meeting). 2 mengurus, merawat. 3 menyertai. 4 mengikuti.
attendance	kb. 1 kehadiran. compulsory a. kehadiran yang diharuskan. 2 orang yang hadir. the a. at the meeting was poor orang yang hadir pada rapat itu sedikit sekali.
attendant	kb. pembantu, pelayan. -ks. 1 yang hadir. 2 menyertai.
attention	kb. 1 perhatian. to call a. to meminta perhatian pada. he called my a. to the error ia meminta perhatian saya pada kesalahan itu. 2 mil.: siap.
