lawful	ks. sah menurut hukum. l. owner pemilik yang sah.
lawless	ks. tidak pada hukum, ingkar akan hukum. l. group gerombolan yang tidak menurut perintah.
lawlessness	kb. pelanggaran hukum.
lawmaker	kb. pembuat undang-undang.
lawmaking	ks. legislatip. l. body badan legislatip.
lawn	kb. halaman rumput. l. mower mesin pemotong rumput.
lawsuit	kb. perkara hukum, penuntutan perkara.
lawyer	kb. pengacara, adpokat.
lax	lax
laxative	kb. obat pencahar/urus-urus/cuci perut.
laxity	kb. 1 kelemahan (of discipline). 2 kelalaian (in o's duty).
lay	kb. 1 nyanyian. 2 syair. -ks. awam, biasa. -kkt. (laid) 1 meletakkan. 2 memasang (a floor, brick). 3 menelurkan (egg). 4 menempatkan. 5 membuat(plans). 6 menutup (a table). 7 memberikan. -kki. poul.: bertelur. -laying hen ayam yang (sedang) bertelur.
layaway	ks. l. plan angsuran, cicilan sampai lunas.
layer	kb. 1 lapis(an).two layers of paint dua lapis cat. 2 poul.: (ayam) babon, petelur.
layette	kb. pakaian bayi.
layman	kb. (j. -men) orang awam.
layoff	kb. pemberhentian (sementara.)
layout	kb. 1 susunan, tataruang (of magazine). 2 rancangan (of building, apartment).
layover	kb. singgah, berhenti sebentar. a fifteen minute l. in buffalo singgah selama 15 menit di buffalo.
laze	kki. bermalas-malas. to l. in the sun bermalas-malas(an) dibawah sinar matahari.
laziness	kb. kemalasan.
lazy	ks. malas. l. susan baki/talam makanan yang berputar.
lazybones	kb. : pemalas.
lb(s).	[pound (s) ] pon (pon).
lc	[landing craft] kapal pendarat.
leach	kkt. 1 melepaskan. the rains leached the soil of its salts hujan melepaskan tanah dari garam-garamnya. 2 meluluhkan, melumerkan.
lead	kb. timah. l. pencil potlot. lead-colored ks. lebam(-hitam), kelam(-lebam). inf.: lead-pipe cinch a) kepastian, hal yang sudah pasti. b) gampang mudah.
leaden	ks. 1 kelam. l. skies langit kelam. 2 terbuat dari timah.
leader	kb. 1 pemimpin (of a group, orchestra). born l. pemimpin yang berbakat. 2 tokoh (in the social sciences).
leadership	kb. pimpinan, kepemimpinan.
leaf	kb. (j. leaves) 1 daun. 2 furn.: daun meja. 3 lembaran (of book). -kkt. to l. through membalik-balik halaman (a book).
leaflet	kb. surat sebaran/selebaran.
leafy	ks. 1 rindang, berdaun banyak (of trees, shrubs). 2 terdiri/terbuat dari daun-daunan (of vegetables).
league	kb. 1 perkumpulan, perserikatan. 2 liga, persatuan. 3 persatuan, ikatan.
leak	kb. kebocoran, tirisan (in pipe, information). -kki. bocor.
leakage	kb. kebocoran, tirisan.
leakproof	ks. tahan bocor.
leaky	ks. bocor (faucet).
lean	ks. 1 kurus. 2 tidak berlemak (of meat). 3 to have a l. year mengalami tahun yang buruk/paceklik. -kkt. menyandarkan. -kki. miring, condong. lean-to kb. sengkuap, sudung. -leaning kb. kecenderungan.
leap	kb. 1 lompatan (of a broad jump, across a stream) 2 langkah. -kkt. (leaped atau leapt) melompati (a fence). -kki. 1 melompat. 2 berjingkrak.
leapfrog	kb. permainan lompat kodok. to play l. bermain loncat katak. -kki. (leapfrogged) melompati, melampaui, menanggulangi.
leapt	lih leap.
learn	kkt. (learned atau learnt) 1 mempelajari. 2 mendengar. -kki. belajar. -learned ks. dipelajari. learned /'learnid/ ks. yang terpelajar. -learning kb. pengetahuan.
learner	kb. 1 pelajar. 2 orang yang baru mulai.
learnt	lih learn.
lease	kb. 1 sewa, kontrak, pak, kontrak sewa, sewa-menyewa. 2 kesempatan. -kkt. 1 menyewa. 2 menyewakan.
leash	kb. pengikat binatang. -kkt. mengikat/memegang dengan tali.
least	kb. yang paling sedikit. -ks. paling kurang. -kk. l. of all paling tidak/sedikit.
leastwise	kk. inf.: sedikit-sedikitnya.
leather	kb. kulit. l. goods barang-barang (dari) kulit. l. jocket jaket kulit.
leathercraft	kb. kerajinan kulit.
leatherneck	kb. sl.: anggota kko di a.s.
leathery	ks. kasar, keras (skin).
leave	kb. cuti, perlop. -kkt. (left) 1 meninggalkan (town). 2 membiarkan. 3 menyerahkan. 4 menunda. 5 mewariskan (a fortune, home). -kki. berangkat, pergi. leave-taking kb. berpisah. -leavings kb., j. sis-sisa, rimah-rimah, repih-repih.
leaven	kb. ragi, adonan asam.
leaves	lih leaf.
lecher	kb. orang gasang/jangak, pelepas nafsu birahi.
lecherous	ks. bejat, gasang, (bersifat) bandot.
lechery	kb. (pelepasan) nafsu birahi.
lectern	kb. mimbar, podium, lesnar.
lecture	kb. 1 acad.: kuliah. 2 ceramah. 3 omelan. 4 kata-kata nasihat. -kkt. 1 menasehati. 2 mengomeli. -kki. mengkuliahkan, memberi kuliah. l. hall/room ruangan kuliah.
lecturer	kb. 1 acad.: lektor. 2 pemberi kuliah. 3 penceramah.
lectureship	kb. jabatan dosen/lektor.
led	lih lead kkt.
ledge	kb. 1 birai (of window). 2 langkan ( of a building).
ledger	kb. bukubesar, buku kas induk.
lee	kb. tempat teduh, bawah angin. in the l. keteduhan. l. side lambung yang dibawah angin.
leech	kb. 1 pacat, lintah. 2 (usurer) lintah darat.
leek	kb. bawang perai.
leer	kb. lirikan, kerlingan. -kkt. melirik, mengerling (at kepada).
leery	ks. curiga. l. of curiga terhadap. 2 sangsi. i've gotten l. about following his advice saya agak sangsi untuk mengikuti nasihatnya.
lees	kb., j. sisa (makanan, minuman, dsb), sampah, ampas.
leeway	kb. 1 waktu ekstra, peluang. a half hour l. waktu ekstra setengah jam. 2 kemajuan.
left	kb. 1 sebelah kiri. 2 kaum kiri. -ks. , kk. kiri. sl.: l. fied salah, keliru. left-hand ks. tangan kiri. left-handed ks. kidal. left-hander kb. seorang kidal. left-of-center ks. sikap kiri. left-winger kb. orang yang anggota dari sayap kiri.
leftist	kb. anggota sayap kiri. -ks. beraliran kiri.
leftover	kb. (ke)lebihan, sisa. luncheon leftovers sisa makan siang.
lefty	kb. (j. -ties) sl.: orang kidal.
leg	kb. 1 kaki. 2 taraf. on o's last legs setengah mati. -kkt. (legged) to l. it berjalan kaki.
leg.	1 [legal] sah. 2 [legislative] legislatip.
legacy	kb. (j. -cies) warisan, harta pusaka/peninggalan. to come into a l. mewarisi.
legal	ks. 1 tentang/menurut undang- undang/hukum. 2 sah. l. document dokumen yang sah. legal-sizeks. yang berukuran cukup untuk dokumen-dokumen hukum. -legally kk. menurut hukum.
legalistic	ks. menurut/memenuhi hukum, sesuai dengan hukum.
legality	kb. (j. -ties) 1 sahnya, kesahan, legalitas. 2 soal yang berkenaan dengan hukum.
legalization	kb. pengabsahan, pengesahan, legalisasi.
legalize	kkt. mengabsahkan, mensahkan, melegalisasikan.
legation	kb. kedutaan.
legend	kb. 1 dongeng(an), legenda. 2 tulisan (beneath photo, picture). 3 tokoh (yang terkenal). he's a l. in that area dia seorang tokoh yang terkenal di daerah itu.
legendary	ks. dari cerita dongeng. l. character tokoh (dalam) dongeng.
legerdemain	kb. permainan sulap.
leggings	kb., j. kap/pembalut kaki.
leggy	ks. berkaki panjang.
legibility	kb. sifat mudah dibaca.
legible	ks. dapat dibaca. -legibly kk. terang.
legion	kb. legiun, pasukan. 2 banyak sekali. l. of merit binatang tanda jasa (tentara amerika).
legionnaire	kb. anggota legiun.
legislate	kkt. mengatur (morality). kki. membuat undang-undang.
legislation	kb. 1 perundang-undangan. 2 pembuatan undang-undang.
legislative	ks. legislatip. l. body badan legislatip. l. assembly dewan dewan perwakilan rakyat.
legislator	kb. pembuat undang-undang.
legislature	kb. badan pembuat undang-undang.
legitimacy	kb. hak kekuasaan, legitimasi.
legitimate	ks. 1 sah.l. government pemerintahan yang sah. 2 logis, masuk akal. l. conclusion kesimpulan yang logis.
legitimaze	kkt. mengesahkan, mengabsahkan.
legroom	kb. ruang untuk kaki (waktu duduk).
legume	kb. tumbuhan polong.
legwork	kb. bepergian kesana-kemari (untuk pekerjaan).
lei	kb. kalung bunga.
leisure	kb. waktu terluang. he is not at l. to see you dia terlalu sibuk untuk dapat menemui saudara.
leisured	ks. mempunyai banyak waktu terluang. the l. class golongan orang-orang senang, golongan orang bersenang-senang (berfoya-foya).
leisurely	ks. yang tidak tergesa-gesa. l. trip perjalanan yang tidak terburu-buru.
lemon	kb. 1 jeruk limun. l. juice air jeruk sitrun. 2 sl.: brengsek, tidak memuaskan. lemon-colored ks. berwarna kuning muda.
lemonade	kb. limun, limonade.
lemur	kb. semacam kukang, kubung, pukang.
lend	kki. (lent) 1 meminjamkan. 2 meminjami. 3 memberi. lend-lease kb. perjanjian pinjam-sewa. -lending kb. meminjamkan.
length	kb. 1 panjang. 2 lamanya. 3 jarak, jauhnya. 4 potong. at l. 1 panjang lebar. 2 akhirnya. ful l. sepanjang. to go to any l. berbuat apa saja. to keep at arm's l. menjauhkan diri, menjaga adanya jarak.
lengthen	kkt. memperpanjang (run away, coat). -kki. menjadi panjang, bersambung menjadi. the shadows lengthened bayangan menjadi panjang.
lengthways	= lengthwise.
lengthwise	kk. menurut panjangnya. slice l. belah dua memanjang.
lengthy	ks. 1 panjang. 2 lama. 3 jauh.
leniency	kb. kemurahan hati, kelonggaran. to show l. towards memberi kelonggaran dalam, bersikap mengampunkan terhadap.
lenient	ks. toleran, lemah lembut, lunak.
lens	kb. 1 lensa (camera). 2 anat.: lensa mata.
lent	lih lend.
lenten	ks. l. period masa 40 hari menjelang paskah.
lentil	kb. miju-miju.
leopard	kb. macan tutul.
leper	kb. penderita penyakit kusta.
leprosarium	kb. (j. -saria, sariums) rumah sakit lepra.
leprosy	kb. (j. -sies) penyakit kusta, lepra.
lesbian	kb. homoseks wanita.
lesion	kb. 1 luka. 2 jejas.
less	kb. 1 tak sebanyak. 2 kurang. -ks. lebih sedikit. -kk. kurang. -kd. kurang.
lessee	kb. penyewa.
lessen	kkt. 1 mengurangi (danger of war, weight of s.t.). 2 memperkecil (s.o's accomplishments). -kki. berkurang. -lessening kb. surutnya, berkurangnya (of tension, fever).
lesser	ks. yang lebih kurang. one of the l. known writers salah seorang dari pengarang-pengarang yang kurang terkenal.
lesson	kb. pelajaran. to give lessons in memberi pelajaran dalam. to take piano lessons belajar main piano. 2 tegoran. a stiff l. by the judge tegoran yang keras oleh hakim.
lessor	kb. orang yang menyewakan.
lest	ksam. 1 kalau/agar tidak. 2 bahwa, kalau-kalau. iwas afraid l. i should be too late saya takut kalau-kalau saya terlambat.
let	kb. tenn.: 1 (ball) bola yang kena net/jaring dan masih masuk. 2 halangan. -kkt. (let) 1 membiarkan. 2 memisalkan, memperkirakan. 3 menyewakan (rooms). 4 memborongkan. 5 melepaskan, mengempeskan, mengembos. 6 (sebagai perintah) mari.
let's	[let us] lih let.
letdown	kb. 1 kekecewaan. 2 (of plane) pendaratan.
lethal	ks. yang mematikan. l. dose dosis yang membawakan maut. l. weapon senjata pembawa maut.
lethargic	ks. lesu, kelesa, malas(-malas). to feel l. after a heavy meal merasa mengantuk sesudah makan terlalu banyak.
lethargy	kb. (j. -gies) kelesuan, kekelesaan.
letter	kb. 1 surat. 2 huruf. 3 isi. 4 sport : medali (in school). -letters j. kesusasteraan. -kkt. menulis huruf. -lettering kb. bentuk huruf-huruf, tulisan.
letterhead	kb. kepala surat, blangko surat.
letterpress	kb. 1 cetakan huruf. 2 mesin cetak.
lettuce	kb. 1 selada, daun sla. 2 sl.: uang kertas.
letup	kb. 1 reda (of rain). 2 hentinya (in traffic, in an argument).
leukemia	leukemia
levee	kb. 1 bendungan, tanggul. 2 (quay, pier) dermaga.
level	kb. 1 tingkat, mutu (of work). 2 dataran, permukaan. 3 tingkat (of a house). 4 waterpos, timbangan datar. 5 derajat. -ks. 1 rata. 2 datar, sama tinggi. 3-kkt. 1 meratakan. 2 menumbangkan. 3 menujukkan. 4 mendatarkan. 5 melontarkan, melancarkan.
leveler	kb. orang atau alat yang menyamaratakan.
lever	kb. pengangkat, pengungkit, pengungkil, pengumpil, tuas, tuil. gearshift l. pengangkat roda persneling.
leverage	kb. 1 pengungkitan, pengungkilan, pengumpilan. 2 pengaruh.
levi's	kb., j. celana levis.
levied	lih levy.
levies	lih levy.
levity	kb. (j. -ties) sikap sembrono, kesembronoan.
levy	kb. (j. -vies) 1 fin.: pajak, retribusi. 2 mil.: orang yang dikumpulkan unutk tentara. -kkt. (levied) 1 mengadakan. 2 memungut (a toll). 3 menarik.
lewd	ks. cabul, kotor. l. film pilem cabul.
lexical	ks. yang berhubungan dengan bahasa. 2 yang berhubungan dengan kamus.
lexicographer	kb. ahli/penyusun kamus, ahli perkamusan.
lexicography	kb. perkamusan.
lexicology	kb. ilmu/study mengenai bentuk, sejarah dan arti kata-kata.
lexicon	kb. 1 kamus. 2 gram.: kosakata.
liability	kb. (j. -ties) kb. 1 pertanggung jawaban. 2 kecenderungan untuk penyakit. 3 kekurangan. -liabilities j. passiva.
liable	ks. 1 dapat dikenakan. 2 dapat dikena. 3 besar kemungkinan. 4 bertanggung jawab (for atas).
liaison	kb. 1 hubungan. l. between the government and the aircraft industry hubungan antara pemerintah dengan industri kapal terbang itu. 2 kepenghubungan. 3 hubungan haram antara lelaki dan perempuan. 4 gram.: sambungan. l. officer perwira penghubung.
liar	kb. pendusta, pembohong.
libel	kb. fitnah, pencemaran nama. to sue for l. menuntut karena memfitnah. -kkt. memfitnah(kan).
libelous	ks. yang memfitnah(kan), yang mencemarkan nama.
liberal	kb. penganut liberalisme. -the liberals j. kaum liberal. -ks. 1 bebas, liberal, tidk picik (in o's thinking). 3 banyak. 4 baik. -liberally kk. 1 dengan bebas. 2 secara royal.
liberalism	kb. liberalisme.
liberate	kkt. 1 membebaskan, memerdekakan. 2 melepaskan. to l. from isolation melepaskan dari isolemen/isolasi.
liberation	kb. pembebasan, tindakan memerdekakan.
liberator	kb. pemerdeka, pembebas.
libertine	kb. orang jangak, orang yang tidak menghormati wanita.
liberty	(j. -ties). kb. 1 kemerdekaan, kebebasan. 2 cuti, libur. to take liberties bertindak melewati kesopanan, bersifat terlalu bebas. to take the l. of memberanikan diri untuk.
libido	kb. nafsu berahi/hidup.
librarian	kb. ahli perpustakaan, pustakawan.
library	kb. (j. -ries) 1 perpustakaan. 2 gedung perpustakaan. l. science ilmu pengetahuan perpustakaan.
librettist	kb. penulis kata-kata nyanyian.
libretto	kb. (j. -tos -ti). 1 kata-kata nyanyian. 2 karangan kata-kata dari komidi musik
lice	lih louse.
license	kb. 1 surat izin, lisensi. 2 (poetic) kebebasan. -kkt. mengizinkan, memberi izin/lisensi. l. plate nomor pelat/bewijs. -licensed ks. yang diizinkan.
licensee	kb. pemegang lisensi.
licentious	ks. tidak bermoral, jangak.
lichen	kb. sebangsa tumbuhan lumut.
lick	kb. 1 jilatan. 2 inf.: sedikit. -kkt. 1 menjilat (a stamp). 2 inf.: memecahkan (a problem). 3 inf.: memukul. 4 inf.: mengalahkan, mengatasi, mencukur. -licking kb. inf.: 1 pukulan. 2 inf.: kekalahan.
lickety-spilt	kk. sl.: dengan kencang (sekali).
licorice	kb. semacam gula-gula yang berwarna hitam.
lid	kb. 1 tutup, penutup. 2 anat.: (eye) pelupuk mata. s.: to flip o's l. menjadi marah, marah-marah. sl.: to blow/lift/take the l. off membuka, menyingkapkan.
lie	kb. dusta, bohong, kebohongan, kedustaan. -kki. berbohong, berdusta (to kepada). l. detector alat penemu kebohongan, pesawat pengungkap kebohongan. -lying kb. pembohongan.
lief	kk. lebih suka. i would as l. go saya lebih suka pergi. saya akan pergi dengan senang hati.
lien	kb. hak gadai. because of the l. on it karena telah digadaikan.
lieu	kb. in l. sebagai pengganti. in l. an exam sebagai pengganti ujian.
lieut.	[lieutenant] letnan.
lieutenant	kb. letnan. first l. letnan satu, letu. second l. letnan dua, letda.
life	kb. (j. lives) 1 hidup. 2 kehidupan. 3 kehidupan, riwayat hidup. 4 jiwa. 5 hayat. 6 semangat. 7 jiwa, penggerak. 8 umur. life-size(d) ks. sebesar badan.
lifeblood	kb. sumber hidup.
lifeboat	kb. sekoci penolong.
lifeguard	kb. pengawal renang (di laut/di kolam renang).
lifeless	ks. tak bernyawa.
lifelike	ks. seperti kehidupan. l. picture lukisan seperti kehidupan yang sebenarnya.
lifelong	ks. kekal, abadi (friendship).
lifesaver	kb. 1 seorang yang menolong orang lain dari bahaya tenggelam. 2 inf.: penolong yang baik.
lifesaving	kb. pertolongan terhadap orang yang hendak tenggelam. to take a course in l. belajar menyelamatkan orang. l. equipment alat-alat penolong.
lifetime	kb. seumur hidup. once in a l. sekali seumur hidup. l. friend teman seumur hidup.
lifework	kb. pekerjaan seumur hidup.
lift	kb. 1 pengangkat. 2 daya angkat. 3 tumpangan, boncengan, goncengan -kkt. 1 mengangkat (box,book). 2 mencabut (controls, a ban). 3 inf.: mencopet, mengambil, mencuri. -kki. menyingsing. lift-off kb. peluncuran atau penembakan (guided missile).
ligament	kb. ikat(an) (sendi) tulang.
ligature	kb. 1 pengikat (tali), benang penjahit luka.
light	kb. 1 cahaya. 2 lampu. 3 api. 4 keterangan. 5 tokoh. -ks. 1 ringan (weapon, industry, work, lunch, jail sentence). 2 terang. 3 muda. 4 tipis. -kkt. (lighted atau lit). 1 menyalakan (fire, cigarette). 2 menyuluhi (the way). 3 menerangi, menyoroti.
lighten	kkt. meringankan, mengurangi (a load). -kki. menjadi terang (of a sky). it's lightening kilat memancar.
lighter	kb. 1 tongkang. 2 (cigarette) geretan.
lighthouse	kb. menara api, mercu suar. l. keeper penjaga mercu suar.
lightness	kb. keringanan. 2 penerangan (of a room).
lightning	kb. kilat, halilintar. l. struck the house halilintar menyambar rumah. l. bug kunang-kunang. l. rod penangkal/penolak kilat.
lightship	kb. kapal suar.
lightweight	kb. sport : petinju kelas ringan. intellectually, he's a l. berbicara perkara intelek, dia termasuk kelas ringan. -ks. kecil, kelas ringan. l. camera alat pemotret yang kecil.
lignite	kb. batu bara muda.
likable	= likeable.
like	kb. kesukaan. -ks. 1 sama. 2 seperti. like-minded ks. sependapat, sependirian. -liking kb. 1 kegemaran. 2 kesukaan.
likeable	ks. yang menyenangkan.
likelihood	kb. kemungkinan. in all l. mungkin sekali.
likely	ks. mungkin. -kk. kemungkinan besar, mungkin sekali.
liken	kkt. mempersamakan, menyamakan (to dengan).
likeness	kb. persamaan, kesamaan. to paint his l. melukis persamaannya.
likewise	kk. 1 demikian juga. to do l. berbuat demikian juga. 2 juga. president and general manager l. direktur dan juga pengurus umum.
lilac	kb. pohon kecil yang bunganya mirip bunga bungur.
lilt	kb. irama.
lily	kb. (j. lilies) (bunga) bakung. l. of the valley semacam teratai. lily-white ks. putih bersih, tak berdosa.
lima	l. bean semacam buncis yang bijinya besar-besar.
limb	kb. 1 dahan, cabang (of tree). inf.: to go out on a l. for s.o berbuat sesuatu yang berbahaya untuk seseorang. 2 tungkai dan lengan, anggota badan. to tear prey l. from l. mengoyak-ngoyak mangsa (sampai berkeping-keping.
limber	ks. lentur, lemah gemulai/lentur. -kki. to l. up melemaskan urat-uratnya.
limbo	kb. tempat bagi orang-orang yang terlantar/dibuang/terlupakan. in l. terlantar.
lime	kb. 1 kapur. l. burning pembakaran kapur. 2 limau. l. juice air jeruk/limau.
limeade	kb. limun.
limekiln	kb. pekapuran.
limelight	kb. 1 pusat perhatian. 2 thea.: sinar/sorotan yang kuat sekali. to be in the l. mendapat sorotan, menjadi pusat perhatian.
limerick	kb. pantun jenaka, sajak lucu yang biasanya terdiri dari lima baris.
limestone	kb. batu gamping/kapur.
limit	kb. batas. -limits j. perbatasan. -kkt. membatasi (the amount). -limited kb. keretaapi/bis ekspres. ks. 1 yang terbatas. 2 perseroan terbatas (p.t.).
limitation	kb. 1 pembatasan, keterbatasan, limitasi. l. on the amount pembatasan jumlah. 2 batas-batas. he has his limitations dia ada batas-batas kemampuannya.
limitless	ks. tak terbatas/habis-habis.
limousine	kb. mobil sedan yang tempat sopirnya terpisah daripada tempat penumpang.
limp	kb. pincang, timpang. to have a bad l. sangat pincang. -ks. 1 lemas. 2 lemah (of a binding). -kki. berjalan pincang.
limpid	ks. terang, jernih.
line	kb. 1 garis. 2 barisan. 3 macam, merek. 4 tali. 5 (electric, telephone) saluran, kawat. 6 lin. 7 jalan. 8 batas. 9 baris (of poetry). 10 jurusan/ macam. 11 perbentengan. 12 deretan. 13 tema. -lining kb. lapisan (book, coat).
lineage	kb. garis silsilah/keturunan.
lineal	ks. langsung. l. descendant keturunan yang langsung.
linear	ks. yang berhubungan dengn garis-garis lurus, bergaris. l. measure ukuran panjang. l. equation persamaan satu tingkat.
lineman	kb. (j. -men). tel.: tukang kawat.
linen	kb. linan.l. closet lemari spre. l. sheet spre linan.
liner	kb. shop.: 1 kapal samudera. 2 penggaris.
linesman	kb. (j. -men) 1 tel.: tukang kawat. 2 sport : penjaga garis, tukang kebut.
linger	kki. 1 tetap hidup (walaupun sudah akan mati). 2 menyambalewa, seakan-akan tidak mau pergi, masih tertinggal. -lingering ks. tak datang-datang/hilang-hilang, yang masih melekat.
lingerie	kb. pakaian dalam (untuk) wanita.
lingo	kb. bahasa (yang aneh/khas).
lingua franca	kb. bahasa perhubungan/pergaulan /perantara.
linguist	kb. ahli bahasa. he's quite a l. ia telah menguasai banyak bahasa.
linguistic	ks. yang berkaiatan dengan ilmu bahasa. l. atlas atlas bahasa-bahasa. l. geography ilmu bumi dialek.
linguistics	kb. ilmu bahasa.
liniment	kb. obat gosok, pelulut.
link	kb. 1 mata rantai (on a chair). 2 hubungan. -links j. lapangan (bermain) golf. -kkt. menghubungkan. link-up kb. (per)hubungan.
linkage	kb. hubungan, pertalian, sambungan.
linoleum	kb. linolium.
linotype	kb. mesin set serupa mesin tik.
linseed	kb. biji (pohon) rami. l. oil minyak biji rami.
lint	kb. kain tiras.
lion	kb. singa. to beard the l. in his den mendatangi seseorang di tempatnya.
lioness	kb. singa betina.
lionize	kkt. memperlakukan seperti orang penting.
lip	kb. bibir. 2 mulut (of a picher). 3 tepi (of a crater). to lip-read memahami kata-kata orang hanya dengan melihat gerak-gerik bibirnya.
lipstick	kb. cat pemerah bibir, gincu.
liq.	[liquid] cairan.
liquefy	kkt. (liquefied) mencairkan. -kki. menjadi cair.
liqueur	kb. sopi manis.
liquid	kb. 1 cairan. l. diet makanan yang cair-cair saja. 2 zat cair. 3 phon.: bunyi/suara likwida.liquid-fueled ks. yang bertenaga gas cair. l. measure ukuran benda cair. l. oxygen zat asam cair.
liquidate	kkt. 1 menghapuskan, membubarkan. 2 menguangkan (assets). 3 memusnahkan (undesirables).
liquidation	kb. 1 likwidasi, pembubaran (of a firm). l. sale jual obral. 2 penghapusan, pemusnahan (of undesirables).
liquidator	kb. 1 juru penyelesai, pelikwidasi. 2 pemusnah, pembubar.
liquor	kb. minuman keras. 2 cairan (of pickles).
lisle	ks. benang linan/kapas. l. hose kaus kaki dari benang lisle.
lisp	kb. telor, pelat. he has a slight l. ia agak pelat. -kki. pelat. he lisps bicaranya pelat.
list	kb. daftar. l. of contents daftar isi. -kkt. mendaftarkan. -kki. miring, condong.
listen	kki. mendengarkan. to l. to music mendengarkan musik. listening post tempat mendengar-dengarkan keadaan musuh.
listener	kb. pendengar. he's a good l. ia seorang yang mau mendengarkan baik-baik.
listless	ks. lesu, tanpa gairah.
lit	lih light kkt., kki.
lit.	1[liter] liter. 2 [literal(ly)] arti harfiah. 3 [literature] kesusasteraan. 4 [literacy] yang berkaitan dengan melek huruf.
lit. d.	[doctor of letters] doktor ilmu sastera.
litany	kb. (j. -nies) serangkaian doa-doa, litani, barzanji.
litchi	kb. lengkeng.
liter	kb.liter.
literacy	kb. melek huruf. l. campaign gerakan pemberantasan buta huruf.
literal	ks. harfiah. l. translation terjemahan harfiah. -literally kk. 1 (secara) harfiah. 2 benar-benar.
literary	ks. yang berkaitan dengan kesusasteraan. l. magazine majalah sastera. l. society perhimpunan kaum pujangga.
literate	ks. 1 melek huruf. 2 terpelajar.
literature	kb. kesusasteraan. rusian l. kesusasteraan rusia. 2 kepustakaan, daftar bacaan.
lithe	ks. lentur, luwes.
lithograph	kb. tulisan/gambar yang dilukiskan pada sepotong logam/batu yang datar.
lithography	kb. cetakan dari batu atau logam yang ditulisi/digambari.
litigant	kb. penggugat, penuntut, pihak yang berperkara.
litigatation	kb. proses pengadilan, jalannya perkara.
litigate	kki. mengajukan perkara, menuntut secara hukum.
litmus	kb. lakmus. l. paper kertas lakmus.
litter	kb.1 sampah, kotoran. 2 seperindukan (of kittens). 3 tandu. 4 (stretcher) tandu orang sakit. -kkt. 1 mengotori (a room). 2 memberi alas. the horses were littered with straw kuda-kuda itu diberi alas tidur jerami.
litterbug	kb. orang yang membuang-buang sampah di jalanan.
little	kb. sedikit. -ks. 1 kecil. 2 sedikit. -kk. sedikit, kecil. l.bear beruang kecil. l. fellow rakyat/orang kecil. l. finger kelingking. little-known ks. yang sedikit diketahui.
littoral	kb. daerah pesisir.
litturgical	ks. yang berkaitan dengan liturgi/peribadatan.
liturgy	kb. (j. -gies) liturgi(a), tata kebaktian, peribadatan.
livable	ks. yang enak didiami.
live	ks. yang hidup. l. snake ular yang hidup. 2 langsung. l. show pertunjukan yang diambil langsung. l. bomb bom yang belum dinyalakan. l. coals bara api. l. match korek api. l. party pesta yang gembira.
liveable	= liveable.
livelihood	kb. mata pencaharian. to teach for a l. mengajar unutk mendapatkan nafkah penghidupan.
liveliness	kb. 1 kegiatan, keaktipan. 2 kegembiraan.
livelong	ks. sepanjang. the l. day sepanjang hari.
lively	ks. 1 lincah. 2 bersemangat (of a tune, conversation). 3 baik, mudah melenting (of a ball). 4 cemerlang. 5 sibuk, giat. 6 yang hidup.
liven	kkt. menggembirakan. to l. up a party menggembirakan sebuah pesta. -kki. meningkat, hidup.
liver	kb. (h)ati. l. extract sari hati. chicken l. ati ayam. 2 orang yang hidup. a long l. seorang yang hidupnya panjang .
liverwurst	kb. sosis yang mengandung cincang.an hati.
lives	lih life.
livestock	kb. ternak, peternakan.
livid	ks. 1 pucat kelabu. l. with rage bermuka pucat kelabu karena marah. 2 hitam kelabu (from blows).
lizard	kb. 1 kadal. 2 cicak.
ll.b	bachelor of laws] sarjana muda ilmu hukum.
ll.d.	[doctor of laws] doktor ilmu hukum.
ll.m	[master of laws] sarjana hukum.
load	kb. 1 beban. 2 muatan. -kkt. 1 memuat.2 memuati. 3 menimbuni. 5 memberati. 6 mengisi. -kki. mengisi. -loaded ks. 1 yang diisi (of box, gun). 2 sl.: mabuk. 3 sl.: kaya sekali. -loading kb. pemuatan.
loader	kb. 1 pemuat. 2 mesin pemuat.
loaf	kb. (j. loaves) papan roti. two loaves of bread dua buah roti. -kki. bermalas-malasan.
loafer	kb. 1 orang uang bermalas-malasan. 2 cloth.: semacam sepatu (tanpa tali).
loam	kb. 1 tanah liat/gemuk. 2 lempung.
loan	kb. pinjaman. on l. from pinjaman dari. -kkt. meminjamkan *sesuatu kepada seseorang), meminjami (seseorang, sesuatu). l. shark lintah darat.
loath	ks. segan. to be l. to accept s.t. segan menerima sesuatu.
loathe	kkt. benci akan. i l. winter saya benci akan/pada musim dingin. -loathing kb. kebencian, kejijikan.
loathsome	ks. menjijikkan, memualkan, memuakkan.
loaves	lih loaf.
lob	kb. tenn.: bola yang dipukul tinggi ke jurusan sebelah belakang lawan. -kkt. (lobbed) memukul (bola) tinggi-tinggi.
lobby	kb. (j. -bies) ruang masuk (gedung). -kki. mencoba mempengaruhi.
lobbyist	kb. seorang yang mencoba mempengaruhi pembuat undang-undang, dll.
lobe	kb. cuping.
lobster	kb. udang karang/laut. l. newburg semacam masakan udang laut.
loc.	[local] setempat.
loc. cit.	pada tempat yang disebutkan.
local	kb. 1 kereta (api) bumel. 2 cabang persatuan. -ks. 1 setempat.2 lokal. 3 daerah. -locally kk. di tempat itu.
locale	kb. tempat terjadinya suatu peristiwa.
locality	kb. (j. -ties) tempat, suatu tempat dan sekitarnya.
localize	kkt. 1 melokalisir, menyetempatkan (blood clot). 2 membatasi (an epidemic, interference).
locate	kkt. 1 menempatkan. 2 menemukan (a friend, book). -kki. menetap. to be located terletak.
location	kb. 1 tempat (for a house). 2 letaknya.
lock	kb. 1 kunci. 2 pintu air (of canal). 3 seikat rambut (of hair). -locks j. rambut ( ikal). -kkt. 1 mengunci (a door). 2 menyangkutkan. -kki. dikunci. lock-box kb. peti uang.
locker	kb. 1 lemari (di sekolah, di station). 2 ruangan yang diberi berhawa dingin untuk menyimpan bahan mekanan yang di-eskan.
locket	kb. anting-anting tempat menyimpan potret atau seikat rambut.
lockjaw	kb. kejang mulut.
lockout	kb. larangan bekerja.
locksmith	kb. tukang kunci.
lockup	kb. kamar tahanan, penjara kerangkeng.
loco	ks. sl.: gila.
locomotion	kb. daya penggerak.
locomotive	kb. lok(omotip). l. engineer masinis.
locus	kb. tempat (of on infection, in geometry).
locust	kb. uir-uir belalang.
locution	kb. cara berkata, cara mengungkapkan perasaan dan pikiran.
lode	kb. lapisan.
lodestar	kb. 1 bintang yang dipakai sebagai pedoman. 2 pedoman.
lodge	kb. 1 pondok, rumah kecil untuk sementara. 2 tempat penginapan. -kkt. 1 mengajukan (a complaint. 2 meletakkan. -kki. 1 menginap (at a resort). 2 menyangkut. to l. with indekos. -lodging kb. penginapan, pondokan.
lodger	kb. penumpang makan, pemondok, orang indekos.
loft	kb. 1 loteng (in a barn). 2 serambi tinggi (in church). 3 kandang. pigeon l. kandang burung merpati.
lofty	ks. 1 tinggi. l. pesk puncak yang tinggi. 2 agung, mulia, megah. 3 angkuh, sombong. -loftily kk. dengan angkuh.
log	kb. 1 batang kayu, kayu bundar/gelondongan. 2 nav.: buku harian (pada kapal atau pesawat terbang). -kkt. 1 menempuh . 2 (to record) mencatatkan dalam buku harian.
log, log.	[logarithm] logaritma.
logarithm	kb. logaritma.
logarithmic	ks. yang berkaitan dengan logaritma. l. table daftar logaritma.
loge	kb. lose.
logger	kb. tukang tebang kayu.
loggerhead	kb. at loggerheads bertengkar, berselisih, bercekcok.
logic	kb. logika, ilmu mantik. to follow s.o's l. mengikuti jalan pemikiran seseorang.
logical	ks. logis. l. outcome akibat yang logis. he has a l. sequence of thoughts cara berpikirnya logis.
logician	kb. ahli logika/mantik.
logistic	kb. logistik.
logjam	kb. jalan buntu, kemacetan.
logrolling	kb. balas jasa (politik).
loin	kb. daging pinggang. l. chap sepotong daging pinggang. -loins j. pinggang, sulbi. to gird up o's loins bersiap-siap, bersiap sedia.
loincloth	kb. kain pinggang, cawat.
loiter	kki. bergelandangan, berkeliaran. don't l. on the way jangan mondar-mandir di jalan.
loiterer	kb. orang gelandangan, orang yang luntang-lanting.
loll	kki. 1 bermalas-malas. 2 bertiduran atau bersandar secara malas.
lollipop	kb. gula-gula (dilekatkan pada sepotong kayu tusuk).
lone	ks. satu-satunya. l. survivor satu-satunya yang selamat. 2 sendirian. that poor l. woman perempuan melarat yang sendirian itu,
loneliness	kb. kesepian, kelengangan.
lonely	ks. sepi, sunyi, lengang. l. spot tempat yang sepi.
loner	kb. inf.: seorang penyendiri.
lonesome	ks. 1 kesepian. she's l. ia kesepian. 2 sepi. l. road jalan sepi. 3 rindu. to be l. for o's family rindu kepada keluarganya.
long	kb. two short and a l. dua pendek dan satu (bunyi pluit) panjang. -ks. 1 panjang (of speech, room). 2 lama. -kk. lama. 2 asalkan, asal saja, selama, jikalau. -kki. 1 ingin. 2 rindu. long-lived ks. berumur panjang. long-standing ks. sudah berjalan lama.
long.	[longitude] garis bujur.
longevity	kb. umur panjang, usia lanjut, dirgahayu.
longhair	kb. 1 sl.: orang intelek, seniman. 2 sl.: pengarang, penggemar/pemain musik klasik.
longhand	kb. tulisan tangan.
longish	ks. agak panjang.
longitude	kb. garis bujur.
longitudinal	ks. membujur. l. beam batang membujur.
longshoreman	kb. (j. -men) buruh/pekerja pelabuhan.
longways	kk. membujur.
longwise	kk. membujur.
look	kb. pandangan. -looks j. 1 wajah, paras. 2 corak. -kkt. nampak. -kki. 1 melihat. 2 kelihatan. 3 begini. sl.: look-see kb. memandang/melihat dengan cepat/sepintas lalu. looking glass kaca, cermin.
looker	kb. sl.: seorang yang menarik/tampan.
lookout	kb. 1 pengintai. 2 tempat meninjau.
loom	kb. perkakas tenun. -kki. 1 nampak. 2 terbayang.
loony	ks. sl.: gila.
loop	kb. 1 akal(an) (of string, rope, garden hose). 2 pesosok. 3 putaran (in a road). sl.: 1 memukul jungkir-balik. 2 membuat lemas. 3 mempesonakan/menaklukkan. -kkt. menyimpulkan.
loophole	kb. jalan keluar, jalan unutk lari/lolos /menerobos.
loose	kb. inf.: on the l. bebas, lepas. -ks. 1 lepas. 2 longgar. 3 goyah. 4 tak tepat. 5 tak cocok. -kkt. melepaskan (a knot, an arrow). l. connection hubungan yang tidak erat. loose-jointed ks. lemas lentur. -loosly kk. dengan longgar.
loosen	kkt. melonggarkan (collar). 2 mengendurkan (string). 3 melepaskan, melonggarkan (a knot, o's tie, a screw).
looseness	kb. kelonggaran (of a collar, tooth). the l. of o's morals kelonggaran/kebebasan. moral.
loot	kb. barang rampasan/gedoran. 2 sl.: uang. -kkt. merampok, merampas. -looting kb. perampasan, perampokan, penggedoran.
looter	kb. perampas, perampok, penggedor.
lop	kkt. memotong. to l. off an ear memotong telinga.
lope	kki. berlari dengan lompatan.
lopsided	ks. berat sebelah, miring, imbal. to hang l. tergantung miring. to win by a l. score menang dengan skor/biji yang menyolok.
loquacious	ks. suka berbicara/berkecek.
loquacity	kb. kesukaan berbicara/berkecek/ mengecek.
lord	kb. 1 raja. the l. a) tuhan. b) jesus kristus. -kki. to l. (it) over berbuat seolah-olah berkuasa atas.
lordly	ks. bersifat agung/mulia.
lore	kb. adat dan pengetahuan. fishing l. adat dan pengetahuan tentang memancing.
lose	kkt. (lost) 1 kehilangan (a pencil). 2 kalah dalam (a sports event). 3 menjadi. 4 hilang. -kki. kalah. -lost ks. 1 hilang, yang tersesat (of a child, dog). 2 yang sia-sia. -losing ks. to play a l. game menjalankan usaha yang akan menemui kegagalan.
loser	kb. orang yang kalah. to be a good l. lapang hati walaupun kalah.
loss	kb. 1 kerugian. 2 kehilangan (of electric power). -losses j. 1 mil.: korban jiwa. 2 fin.: kerugian-kerugian.
lost	lih lose.
lot	kb. 1 bidang, tanah kapling. 2 kumpulan, tumpukan. 3 rombongan, kesatuan. 4 bagian. 5 nasib. -kk. jauh. -lots j. inf.: banyak. lots of work banyak pekerjaan.
lotion	kb. air pembersih, losion.
lottery	kb. (j. -ries) lotere, undian. to win a prize in a l. kena/dapat lotere.
lotus	kb. teratai, seroja.
loud	ks. 1 keras (of cry, laugh, voice). 2 menyolok (of colors). 3 inf.: bising. -loudly kk. dengan keras-keras.
loudmouth	kb. pembual besar.
loudmouthed	ks. suka berbicara dengan keras.
loudness	kb. 1 kerasnya/kekerasan suara. 2 kebisingan.
loudspeaker	kb. pengeras suara.
lounge	kb. 1 kamar duduk. l. car kereta tempat duduk. 2 kursi panjang. -kki. to l. about/around bermalas-malas.
louse	kb. kutu, tuma, caplak. -kkt. sl.: to l. up merusak (an exam, song, joke).
lousy	ks. 1 sl.: jelek (of a movie). l. trick muslihat yang amat buruk. 2 penuh kutu (of a dog, cat) sl.: to be l. with mempunyai banyak.
lout	kb. 1 orang dusun/udik. 2 orang yang kaku.
louver	kb. jalur hias pada jendela.
lovable	ks. yang menimbulkan sayang, yang memikat, yang mendatangkan kesayangan.
love	kb. 1 cinta, asmara. 2 kecintaan. 3 kasih. 4 kasih sayang. 5 tenn.: kosong, nol. 6 pacar, kekasih. -kkt. 1 cinta pada. -kki. mencintai. -loving ks. penuh kasih.
lovebird	kb. orang yang sedang berkasih-kasihan.
loveliness	loveliness
lovelorn	ks. mabuk cinta. advice to the l. nasehat kepada orang yang patah cinta itu.
lovely	ks. bagus. l. hands tangan yang bagus. 2 menyenangkan sekali (of a party). 3 elok-elok (of a gift). inf.: it was l. of you to have us kamu begitu baik budi untuk mengundang kami.
lover	kb. 1 kekasih. 2 penggemar, pencinta (of opera).
lovesick	ks. sakit karena cinta, mabuk kepayang.
low	kb. 1 udara dingin. 2 persneling rendah/satu. 3 dasar. -kki. menguak (of cattle). -ks. 1 rendah (of furniture, voice, grades, water pressure, spirits, temperature). 2 keji, hina. 3 murah. 4 sedikit.
lowbrow	kb. kb. inf.: orang yang tak tahu-menahu, orang yang tak menghargai intelijen atau budaya.
lower	kkt. 1 menurunkan (price, window, box, flag). 2 merendahkan, melembutkan (o's voice). 3 mengurangi (water). -lowering kb. merendahkan, menurunkan, pengurangan.
lowland	kb. daerah lembah, dataran yang rendah.
lowliness	kb. kerendahan hati.
lowly	ks. rendah(an). a l. clerk jurutulis yang rendah.
lowminded	ks. berbudi rendah, busuk hati.
loyal	ks. setia (to pada).
loyalty	kb. (j. -ties) kesetiaan (to kepada). l. oath sumpah setia.
lozenge	kb. obat batuk yang berupa manisan atau tablet.
lp	[long playing (record)] kb. piringan hitam yang lama mainnya.
lsd	[lysergic acid diethylamide] kb. semacam obat bius yang keras. lih acid.
lt.	[lieutenand] letnan.
lt.-col.	[lieutenant-colonel] letnan kolonel.
lt.-comdr.	[lieutenant-commander] mayor (al).
ltd., ltd.	[limited] perseroan terbatas.
ltr.	[letter] surat.
lubricant	kb. minyak lincir (gemuk), minyak pelumas.
lubricate	kkt. meminyaki. lubricating oil minyak pelumas.
lubrication	kb. pemberian minyak (lincir).
lucid	ks. jelas. l. moments saat-saat berpikiran terang, saat-saat yang cerah.
lucidity	kb. keadaan yang terang/jelas/ jernih.
luck	kb. 1 keuntungan, kemujuran. to be a real piece of l. merupakan suatu kemujuran. 2 nasib. as l. would have it... sudah menjadi nasib bahwa...
lucky	ks. mujur, untung. a l. person seorang yang mujur. l. hit tembakan/ pukulan yang kena/mujur. -luckily kk. mujurlah, untunglah.
lucrative	ks. menguntungkan.
lucre	kb. uang.
ludicrous	ks. lucu, menggelikan.
lug	kkt. (lugged) membawa, mengangkat.
luggage	kb. bagasi, barang-barang.
lugubrious	ks. murung, penuh kesedihan.
lukewarm	ks. suam(-suam), hangat kuku.
lull	kb. ketenangan, keteduhan. -kkt. 1 meredakan (o's fears). 2 menidurkan (a child to sleep).
lullaby	kb. (j. -bies) ninabobok.
lulu	kb. sl.: seorang atau sesuatu yang hebat.
lumbago	kb. sakit pinggang, encok sengal pinggang.
lumber	kb. kayu. -kki. berjalan dengan susah payah. l. jacket jaket model penebang pohon. -lumbering ks. lamban, berat dan lambat geraknya (of a plane).
lumberjack	kb. penebang pohon.
lumberyard	kb. tempat penjualan kayu.
luminary	kb. (j. -ries) orang termasyhur, seorang bintang.
luminous	ks. bercahaya, berkilauan. l. hands of a clock jarum jam yang bercahaya.
lump	kb. 1 gumpalan (of dirt). 2 bungkah (of sugar). 3 potong (of coal). 4 bengkak (on the neck).
lumpy	ks. tidak halus, kental.
lunacy	kb. (j. -cies) 1 kegilaan. 2 suatu perbuatan yang kegila-gilaan.
lunar	ks. yang berkaitan dengan bulan. l. eclipse grhana bulan. l. probe penyelidikan bulan. l. year tahun kamariah (kira-kira 354.5 hari).
lunatic	kb. orang gila. -ks. fanatik, gila.
lunch	kb. makan siang. quick l. makan siang cepat-cepat. l. time waktu makan siang. -kkt. makan siang.
luncheon	kb. 1 makan siang. 2 pertemuan makan siang.
luncheonette	kb. restoran yang menyediakan makan siang atau makan-makanan ringan.
lunchroom	kb. 1 = luncheonette. 2 kamar/ruangan tempat makan siang.
lung	kb. paru-paru. l. inflammation radang paru(-paru). to yell at the top of o's lungs berteriak sekuat-kuatnya.
lunge	kb. sergapan, terjangan, serbuan mendadak. -kki. menyerang, menyergap. to l. at s.o. menyerang seseorang.
lurch	kb. gerakan yang tiba-tiba. to make a sudden l. tiba-tiba bergerak. -kki. bergerak/maju dengan tiba-tiba.
lure	kb. pikatan, daya tarik, iming-imingan bujukan.-kkt. memikat.
lurid	ks. seram, mengerikan. l. account serita yang seram.
lurk	kkt. bersembunyi. to l. in the dark mengintai di tempat gelap. lurking suspicion kecurigaan yang tersembunyi.
luscious	ks. 1 lezat. 2 enak.
lush	kb. sl.: pemabuk. -ks. 1 subur (of pasture). 2 lebat (of underbrush, jungle).
lust	kb. 1 nafsu, berahi, gairah. 2 keinginan yang sangat kuat. 3 syahwat. -kki. ingin.
luster	kb. 1 kilauan (of metal). 2 kemasyhuran, keharuman.
lusterless	ks. tak bercahaya (of hair, metal).
lustful	ks. penuh gairah, bernafsu.
lusty	ks. kuat dan sehat. -lustily kk. keras lagi segar.
lute	kb. semacam kecapi.
luxuriant	ks. subur (of grass, beard).
luxuriate	kki. menikmattkan diri.
luxurious	ks. mewah.
luxury	kb. (j. -ries) 1 kemewahan. 2 barang mewah. a car is a l. mobil merupakan barang mewah.
lye	kb. cairan /larutan alkali.
lying	lih lie.
lymph	kb. getah bening. l. gland kelenjar getah.
lynch	kkt. menghukum mati tanpa pemeriksaan pengadilan.
lyric	kb. syair, lirik, sanjak. -lyrics j. sajak untuk nyanyian. -ks. liris l. poet penyair yang liris.
lyrical	ks. penuh dengan kata-kata pujian (about, over terhadap).
m, m	kb. huruf ketigabelas dari abjad inggris.
m.	1 [male, masculine] maskulin, jantan. 2 [meter(s)] meter. 3 [minute (s)] menit. 4 [mile(s)] mil
m.a.	[master of arts] sarjana (gelar yang diberikan oleh universitas kepada seseorang yang sudah selesai belajar tingkatan universitas lanjutan.
m.c.	[master of ceremonies) kb. pemimpin upacara.
m.p.h.	[miles per hour] mil per jam.
m.s.	1 [master of science] sajana. 2 [motor ship] kpal (ber) motor.
m.v.	[motor vessel] kapal motor.
m/sgt	[master sergeant] sersan kepala.
ma	kb. bu.
ma'am	kb. inf.: bu, nyonya.
mac	kb. sl.: bang, bung (kata panggilan).
macabre	ks. mengerikan, menakutkan.
macadam	kb. jalan aspal.
macaroni	kb. makaroni.
mace	kb. 1 (spice) bunga pala. 2 tongkat kebesaran.
machination	kb. akal bulus, intrik, kasak-kusuk.
machine	kb. 1 mesin. 2 mobil. 3 organisasi. the m. age abad mesin. m. gun senapan mesin. machine-made ks. dibuat dengan mesin, jahitan mesin.
machinery	kb. (j. -ries) 1 mesin, mesin-mesin. 2 perlengkapan (for an election).
machinist	kb. masinis, ahli mesin.
mackerel	kb. sejenis ikan air tawar.
macrocosm	kb. makrokosma, alam semesta.
macron	kb. garis makron.
mad	ks. 1 marah. 2 gemar sekali. 3 gila.4 edan. -madly kk. sangat, mabuk. m. in love mabuk cinta.
madam	kb. nyonya. m. chairman nyonya/ ibu ketua.
madcap	ks. yang bukan-bukan, gila.
madden	kkt. memarahkan. -maddening ks. menjengkelkan.
made	lih make.
madhouse	kb. rumah gila. it's like a m. tempat ini jadi gaduh dan membingungkan sekali.
madman	kb. (j, -men) orang gila.
madness	kb. 1 kegilaan. 2 penyakit gila.
maestro	kb. 1 pemimpin orkes simfoni. 2 ahli musik.
maewest	kb. baju pelampung.
magazine	kb. 1 majalah. 2 (powder) gudang senjata. 3 tempat peluru/pelor/mesiu
maggot	kb. tempayak, belatung, ber(e)nga.
magic	kb. 1 sihir. 2 main su(ng)lap. 3 gaya tarik. -ks. gaib. m. power kekuatan gaib, daya sihir. m. eye = electric eye.
magical	ks. gaib. m. powers tenaga-tenaga gaib.
magician	kb. tukang sihir/sulap.
magistrate	kb. hakim.
magnanimity	kb. (j. -ties) keluhuran budi, kemurahan hati.
magnanimous	ks. murah hati.
magnate	kb. tokoh terkemuka, jago. steel m. tokoh terkemuka dalam perusahaan baja.
magnet	kb. 1 maknit, besi/batu berani. 2 daya penarik.
magnetic	ks. 1 maknit. m. compass kompas maknit. 2 amat menarik. m. personality kepribadian yang amat menarik. m. field medan gaya. m. tape pita perekam suara.
magnetism	kb. 1 kemaknitan. 2 daya tarik (of personality)
magnificence	kb. 1 kecemerlangan. 2 keindahan, kebesaran.
magnificent	ks. bagus sekali (performance).
magnified	lih magnify.
magnifier	kb. suryakanta, kaca/lensa pembesar.
magnifies	lih magnify.
magnify	kkt. (magnified) 1 membesar-besarkan, memperbesar (of microscope, problems). 2 menambah (o's voice). magnifying glass kaca pembesar, suryakanta.
magnitude	kb. 1 besarnya (of a task). 2 jarak (of stars). of the firs m. paling serius/penting.
mahogany	kb. mahoni.
maid	kb. 1 babu, pelayan. 2 gadis. old m. perempuan tua, perawan tua. m. in waiting dayang-dayang.
maiden	kb. gadis, perawan. -ks. pertama. m. voyage pelayaran yang pertama. m. name nama kecil, nama semasa gadis.
mail	kb. 1 pos. 2 antaran pos. -mails j. surat-surat, pos. -kkt. memposkan. m. carrier pengantar pos. mail-order ks. pesanan melalui/dengan pos. -mailing kb. pengiriman pos. m. list daftar alamat.
mailbag	kb. kantong surat-pos.
mailbox	kb. kotak pos, bis surat.
mailchute	kb. tempat penyalur surat-surat.
mailman	kb. (j. -men) pengantar/upas pos.
maim	kkt. memuntungkan.
main	kb. pipa saluran air. -ks. 1 pokok. 2 utama. 3 besar. 4 penuh. 5 induk. -mainly kk. sebagian besar.
mainland	kb. tanah daratan.
mainspring	kb. 1 per besar. 2 dorongan utama.
mainstay	kb. aliran/arus utama.
maintain	kkt. 1 memelihara (under, health). 2 menegakkan (doscipline). 3 membiayai (o's family). 4 mengurus (an office). 5 mempertahankan (o's skill).
maintenance	kb. 1 ongkos/biaya hidup. 2 pemeliharaan (of car).
majestic	ks. 1 penuh keagungan. 2 megah sekali.
majesty	kb. (j. -ties) 1 keagungan. 2 kekuasaan tertinggi (of the law). his m. seri baginda.
major	kb. 1 mayor. 2 educ.: mata pelajaran pokok. -ks. 1 utama. 2 besar. 3 mus.: mayor. -kki. mengambil sebagai matapelajaran utama.
majority	kb. (j. -ties) 1 mayoritas. 2 dewasa. 3 kelebihan (of votes). 4 sebagian besar.
make	kb. merek. -kkt. (made) 1 membuat (a cake, will, mistake). 2 menjahit (a dress). 3 mendapat, mencapai (good, o's mark, a good grade). 4 membikin. 5 menjadi. 6 memperoleh, menerima. 7 menempuh. 8 menjalankan. 9 mengadakan. 10 mengeluarkan. 11 melemparkan
maker	kb. pembuat, pembina. m. tuhan, sang pencipta.
makeshift	kb. pengganti sementara. m. government pemerintah sementara. in a m. manner secara tambal sulam.
maladjusted	ks. yang tak dapat menyesuaikan diri.
maladjustment	kb. ketidakmampuan menyesuaikan diri.
malady	kb. (j. -dies) penyakit.
malaise	kb. rasa tidak enak (badan).
malapropism	kb. penggunaan kata yang tidak tepat.
malaria	kb. malaria.
malarkey	kb. sl.: omong kosong, kecap.
malay	kb. 1 orang melayu. 2 bahasa melayu. the m. archipelago kepulauan melayu.
malayan	kb. orang melayu. -ks. melayu.
malayo-polynesian	ks. melayu-polinesia.
malaysian	kb. orang warga malaysia. -ks. dari atau yang berhubungan dengan malaysia.
malcontent	kb. orang yang tak puas/senang.
maldistribution	kb. distribusi yang tak merata.
male	kb. 1 jantan. m. puppy anjing jantan. 2 pria, laki-laki. m. nurse perawat pria. m. child anak laki-laki.
malevolent	ks. yang berhati dengki.
malfeasance	kb. pelanggaran karena jabatan, kejahatan jabatan.
malformation	kb. cacad, bentuk yang cacad.
malfunction	kb. kegagalan pemakaian.
malice	kb. kedengkian, kebencian. to bear m. towards menaruh dendam terhadap, mendendami.
malicious	ks. dengki, jahat, dendam. m. gossip desas-desus yang jahat, omongan jahat.
malign	kkt. memfitnah.
malignancy	kb. (j. -cies) 1 dis.: penyakit yang berbahaya. 2 kejahatan, keburukan.
malignant	ks. 1 dis.: yang menular, yang membahayakan. 2 sangat jahat.
malinger	kki. pura-pura sakit.
malingerer	kb. orang yang pura-pura sakit.
malleable	ks. 1 lunak, dapat ditundukkan. 2 yang dapat ditempa (of metal).
mallet	kb. tukul kayu, palu, godam, martil, pemukul.
malnutrition	kb. salah makanan, kekurangan gizi, salah- gizi.
malpractice	kb. 1 med.: salah mengobati, cara mengobati pasien yang salah. 2 tindakan salah.
malt	kb. gandum/beras terendam air ditaruh diatas nyiru, sampai berkecambah kemudian dikeringkan. malted milk susu bubuk campur ragi.
maltreat	kkt. menganiaya.
maltreatment	kb. penganiayaan.
mamma	kb. ibu, mama.
mammal	kb. binatang menyusui.
mammary	ks. yang berkaitan dengan buah dada. m. gland kelenjar susu.
mammon	kb. dewa kekayaan. to serve m. beragama pada uang.
mammoth	ks. besar-besaran, hebat (undertaking).
man	kb. (j. men) 1 orang laki-laki. 2 laki-laki dewasa. 3 manusia. 4 suami. 5 (chess) biji catur.man-made ks. 1 buatan tangan. (of fiber). 2 buatan manusia (of a disaster). man-of-war kb. kapal perang. man-size(d) ks. yang berukuran orang dewasa.
manacle	kb. belenggu. -kkt. membelenggu.
manage	kkt. 1 mengurus, mengatur, melaksanakan, mengelola. 2 memperlakukan (seseorang). -kki. mengatur. -managing ks. pelaksana.
manageable	ks. dapat diatur/dikendalikan.
management	kb. 1 direksi, pimpinan. under new m. dibawah direksi/pimpinan baru. 2 ketatalaksanaan, tata pimpinan, pengelolaan.
manager	kb. pengelola/pimpinan usaha. sales m. pemimpin/direktur bagian penjualan.
managerial	ks. yang berhubungan dengan kepemimpinan/pengelolaan.
mandate	kb.1 perintah, amanat (of a court). 2 mandat, hak (over territory). 3 tugas. -kkt. mengamanatkan (to kepada).
mandatory	ks. bersifat perintah, yang diperintahkan.
mandible	kb. rahang (bawah).
mandolin	kb. mandolin.
mane	kb. bulu tengkuk (kuda, singa, dsb).
maneuver	kb.1 mil.: gerakan tentara. -maneuvers perang-perangan. 2 kelicikan, muslihat. -kkt. mengarahkan, mendesak. -kki. 1 mengatur siasat. 2 mengadakan gerakan.
maneuverability	kb. cara menggerakkan (of a vehicle).
manganese	kb. batu kawi, manggan.
mange	kb. semacam kudis pada anjing dsb.
manger	kb. palung, malaf.
mangle	kb. alat pelicin pakaian. -kkt. 1 merobek-robek, mengoyak-ngoyak. 2 merusak (o's language). 3 (iron) menyeterika.
mango	kb. mangga.
mangosteen	kb. manggis.
mangrove	kb. bakau.
mangy	ks. 1 berkudis. 2 kotor.
manhandle	kkt. menghajar, menganiaya.
manhole	kb. lubang got.
manhood	kb. 1 kejantanan. 2 keberanian. 3 kedewasaan.
manhunt	kb. pemburuan orang (terutama penjahat).
mania	kb. keranjingan. m. for sailing keranjingan berlayar.
maniac	kb. orang gila.
manicure	kb. perawatan tangan dan kuku. -kkt. merawat tangan dan kuku, merapikan dan mencat kuku, merias tangan.
manifest	kb. 1 daftar mengenai muatan. 2 konosemen, surat muatan. -ks. nyata, terang, jelas. -kkt. menunjukkan, menaruh (in kepada).
manifestation	kb. manifestasi, perwujudan, penjelmaan.
manifesto	kb. manifesto.
manifold	kb. pipa bermulut banyak, manipol. -ks. berjenis-jenis, bermacam-macam.
manila	kb. manila. m. hemp serabut dari pohon henep di filipina.
manipulate	kkt. 1 (to control) menggerakkan. 2 memainkan (characters in a novel). 3 menggunakan, menyelewengkan (accounts). 4 mendalangi.
manipulation	kb. 1 manipulasi, perbuatan curang. 2 penyalahgunaan, penyelewengan.
manipulator	kb. 1 penyeleweng. 2 manipulator, dalang.
mankind	kb. umat manusia.
manliness	kb. kejantanan.
manly	ks. 1 jantan. 2 berani, gagah.
manna	kb. makanan dari sorga.
mannequin	kb. peragawati, boneka pajangan.
manner	kb. 1 cara. m. of speaking cara berbicara. 2 gaya. 3 sikap. -manners j. kelakuan, tatakrama. good manners kelakuan baik. -mannered ks. dibuat-buat.
mannerism	kb. kelakuan, perangai, lagak.
mannish	ks. seperti seorang laki-laki.
manoeuvre	= maneuver.
manpower	kb. tenaga manusia/kerja.
manse	kb. rumah pendeta, pastori.
mansion	kb. rumah yang besar.
manslaughter	kb. pembunuhan (tidak direncanakan).
mantel	kb. papan/rak diatas tungku.
mantelpiece	= mantel.
mantle	1 mantel. 2 lapisan (of snow). 3 cloth.: mantol, mantel.
manual	kb. buku (pedoman). 2 papan tuts (orgel). -ks. kasar, tangan. m. labor pekerjaan kasar/tangan. m. training latihan kerajinan-tangan. -manually kk. dengan tangan.
manufacture	kkt. mempaberik/membuat/ menghasilkan dengan tangan/mesin. manufacturing town kota paberik.
manufacturer	kb. pabrikan, pengusaha pabrik.
manure	kb. pupuk, rabuk. -kkt. memupuk, merabuk.
manuscript	kb. naskah.
many	kb. banyak. m. of them banyak diantara mereka. -ks. banyak. m. books banyak buku. one too m. 1 terlalu banyak. 2 mabuk. many-faceted ks. bersegi banyak. many-sided 1 bersegi banyak (of a figure). 2 serbaguna.
map	kb. peta. road m. peta jalan. -kkt. (mapped) memetakan. to m. out merencanakan (a route). -mapping kb. pembuatan/membuat peta.
maple	kb. sejenis pohon. 2 kayu. m. syrup sirop maple.
mar	kkt. (marred) 1 merusak. 2 mengotori (a wall with crayon).
mar.	[march] bulan maret.
marathon	kb. maraton.
marauder	kb. perampok, perusak.
marble	kb. 1 marmer, pualam. 2 kelereng, keneker, gundu.
march	kb. 1 mus.: mars. 2 gerakan. 3 baris. -kkt. menyuruh pergi. -kki. berbaris, berdefile.
marcher	kb. orang yang berbaris.
mare	kb. kuda betina.
margarine	kb. margarina.
margin	kb. garis tepi, pinggiran (halaman) (on page). 2 kesempatan, kebebasan (for error). 3 batas (of profit). to operate on a narrow m. menjalankan perusahaan dengan keuntungan kecil.
marginal	ks. 1 tipis (of benefits, subsistence). 2 kecil (of income). m. land tanah tepian/pinggiran. m. man orang (yang) setengah-tengah. m. notes catatan-catatan di pinggir halaman.
marijuana	kb. mariuwana, ganja.
marina	kb. dok, pangkalan (untuk perahu-perahu).
marinate	kkt. mengasinkan. marinated herring haring yang diasinkan.
marine	kb. anggota kko. m. corps korps komando operasi al (kko). inf.: tell that to the marines ! omong kosong ! -ks. 1 laut. 2 kapal.
mariner	kb. pelaut.
marionette	kb. (wayang) golek.
marital	ks. yang berhubungan dengan perkawinan. m. status kedudukan perkawinan. m. difficulties kesulitan-kesulitan antara suami-istri.
maritim	ks. maritim, bahari. m. city kota bandar/maritim. m. law hukum laut. m. power negara samudera.
marjoram	kb. semacam tanaman yang mengandung zat permen.
mark	kb. 1 tanda sasaran. to hit m. mengenai tanda sasaran. 2 tanda (of a pencil, of a gentleman). 3 bekas, tanda (of a wound). 4 (grade) angka, nilai. 5 ciri-ciri. -marked ks. diputuskan (for promotion, execution)
markedly	kk. nyata/menyolok sekali.
marker	kb. 1 tukang cap. 2 penilai 9of grades).
market	kb. 1 pasar. 2 pasaran. 3 pasar bursa. -kkt. menjual, memperjual- belikan, memasarkan. m. basket keranjang belanja. -marketing kb. 1 pemasaran, perdagangan. 2 belanja. to go m. berbelanja.
marksman	kb. (j. -men). ahli menembak.
markup	kb. kenaikan harga.
marmalade	kb. semacam sele jeruk.
maroon	ks. merah tua, warna sawo matang. -kkt. terdampar.
marquee	kb. tempat berteduh seperti atap dimuka pintu masuk sebuah gedung.
marriage	kb. 1 perkawinan, pernikahan. m. certificate akte pernikahan, surat kawin. 2 penggabungan.
marriageable	ks. dewasa, boleh kawin. of m. age pantas untuk kawin, dewasa.
married	lih marry.
marries	lih marry.
marrow	kb. sumsum, sungsum.
marry	kkt. (married) 1 mengawini (s.o.). 2 mengawinkan (s.o.off). -kki. kawin. -married ks. yang sudah kawin.
mars	kb. marikh.
marsh	kb. rawa, paya.
marshal	kb. 1 marsekal (ad). 2 polisi (di a.s.). 3 pemimpin (of a parade). -kkt. menyusun. to m. (o's) facts menyusun fakta-fakta.
marshland	kb. tanah rawa.
marshmallow	kb. manisan yang putih dan empuk.
