reben	o.-way glass.
rebewes	(coll.) driver's license.
rebo	see rabu.
reboasasi	/reboisasi/ reforestation.
rebon	k.o. small shrimp.
rebu	see rabu.
rebung	bamboo shoot.
rebus	boiled.
rebut	1 snatch away, take away by force. 2 struggle to obtain a goal.
reca	see arca.
recak	1. light pockmarks. 2. (m) ride (a horse).
recall	/rikol/ (pol.) recall and force resignation of member of parliament for failure to agree with party policies.
receh	see uang.
recet	cry, protest.
recik	droplet.
recok	1 noise, uproar. 2 excitement.
recup	burgeon.
red.	1. [redaksi] editorial staff. 2. [redaktur] editor.
reda	abate, subside. /re`da/ see rela.
redah	1. (m) cut down (trees). 2. traverse s.t.
redaksi	1 editorial staff. 2 wording (of text).
redaksionil	pertaining to editing.
redaktris	female editor.
redaktur	editor.
redam	1 vague, dim, faint. 2 muffled, hushed.
redaman	attentuation.
redang	1. lukewarm, tepid. 2. bog.
redap	1. tambourine. 2. spread. 3 impenetrable.
redas	see redah 2.
redenasi	reasoning.
redha	/redho/ see rela.
redi	ready.
redistribusi	redistribution.
redla	/redlo/ see rela.
reduksi	1 reduction. 2 discount.
reduktor	(chem.) reductor.
redum	sound of thumping.
redundansi	redundancy.
redup	1 overcast, dull. 2 dull, dreary. 3 extinguished (of embers).
reduplikasi	reduplication.
reedukasi	reeducation.
reekspor	reexport.
reevaluasi	reevaluation.
referat	k.o. university level course relying on a single reference book.
referensi	reference (logical, bibliographical, etc.).
refleks	reflex. be-refleks show reflex.
refleksi	reflection.
reflektor	reflector.
reformasi	reformation.
reformir	reform.
reformis	reformer.
reformisme	reformism.
reformulasi	reformulation.
reformulir	reformulate.
refrain	(music) refrain, chorus.
refraksi	refraction.
refungsionalisasi	refunctionalization, i.e. reorganization of a staff such that the same personel hold new positions.
rega	(coll.) see harga.
regang	tense, tightly stretched.
regat	take a shortcut (by following a straight line). /re`gat/ regatta.
regel	1 ruler. 2 lath (for tracing).
regen	regent.
regenerasi	regeneration.
reges	(jakarta) defoliated.
regi	1. administration. 2. (film) director.
regiem	/regim/ see rezim.
regimentasi	regimentation.
regional	regional.
regionalisasi	regionalization (of power, etc.).
regisir	see regi 2.
registrasi	registration.
reglemen	regulation.
reglementasi	/reglementering/ imposition of regulation.
regol	1 (java) archway, entrance. 2 drainage pipes (under bridges, etc.).
regresi	regression.
regu	1 team, group. 2 shift.
reguk	a slug, a drink.
regular	/reguler/ regular.
regularisasi	regularization.
regulasi	regulation.
reh	(java) boss around.
rehabilitasi	rehabilitation.
rehabiliter	/rehabilitir/ rehabilitate.
rehal	(islam) k.o. folding book stand for the koran during recitations.
reindoktrinasi	reindoctrination.
reinkarnasi	reincarnation.
reja	remains, waste, leftover.
rejah	transgress s.t.
rejam	see rajam.
rejan	strained, forced (of coughs, etc.).
rejang	1. horoscope, almamac (for finding favorable days). 2. see rajang. 3. see lejang.
rejasa	tin.
rejeb	(java) see rajab.
rejeki	see rezeki.
rejeng	(jakarta) seize, catch (several people).
rejim	see rezim.
rejimentasi	see regimentasi.
rejuk	jump forward.
rek	1. row, line. 2. sound of rubbing. 3. see arek. 4 see rak 2.
reka	1 invention, creative action. 2 trick, ruse.
reka'at	see rakaat.
rekah	craked, split, broken.
rekalsitran	recalcitrant.
rekam	see rakam.
rekan	comrade, colleague.
rekanan	1 partner, friend. 2 partnership. 3 steady customer.
rekap	/rekapitulasi/ recapitulation.
rekat	glue s.t. together or to s.t. else.
rekayasa	engineer (changes, etc.).
reken	(coll.) count.
rekenan	calculation, mathematics.
rekening	1 bill. 2 ( fin.) bank account.
rekes	(leg.) petition, formal request for s.t.
rekisitor	/rekisitur/ see rekuisitoir.
reklamasi	reclamation.
reklame	advertisement.
reklasering	/reklasifikasi/ reclassification.
rekomendasi	recommendation.
rekomendir	recommend.
rekonsiliasi	reconciliation.
rekonstruksi	1 (ling.) reconstruction. 2 reconstructing the crime, events, etc.
rekonstruktif	reconstructive.
rekor	record (in sports, politics, etc.).
rekreasi	recreation.
rekrut	recruit.
rekrutir	recruit s.o.
reksa	(java) watch over, guard.
rekstok	exercise bars (esp. on walls).
rektifikasi	rectification.
rektor	(acad.) head of university.
rektorat	(acad.) office of university head.
rektorium	(acad.) 1 presidium governing university. 2 university president's office.
rekuiem	/rekuim/ requiem.
rekuisisi	requisition.
rekuisitoir	/rekuisitor, rekwisitoar, rekwisitor/ (leg.) sentence demanded by public prosecutor, prosecutor's summation.
rel	railway track.
rela	willing, acquiesce in.
relai	crumble, fall to pieces (of cakes, etc.).
relaks	see rilek, rileks.
relang	1. glitter, flash. 2. rattan hoop.
relap	shine, glisten.
relasi	1 customer, client. 2 relations.
relatif	relative.
relativis	relativist.
relativisme	relativism.
relativitas	(phys.) relativity.
relawan	volunteer.
relban	railroad tracks.
relevan	relevant.
relevansi	relevance.
relevir	relevant.
relief	relief on temple walls, etc.
religi	religion.
religiositas	religiosity.
religius	religious.
relikui	(rel.) relics.
reliwan	participant in a sports rally.
relung	niche, recess, hollow.
rem	brake.
remah	crumbs, food remnants.
remai	sharply painful.
remaja	adolescent.
remak	preferable, more valued.
remang	1. 1)cloudy, overcast. 2) obscure, vague. 2. stand on end (of hair). 3. 1) buzz, hum of insects. 2) stream, flow (of perspiration, tears).
remang-remang	1 blurred, barely visible. 2 dim, obscure.
remas	see ramas 1.
rematik	rheumatism.
remba	a pair.
rembah	drip.
rembang	midpoint of a certain period of time.
rembes	1 ooze out, leak. 2 permeate, seep in. /re`mbe`s/ (java) k.o. eye disease in which the eyes are watery.
rembet	1. hampered, obstructed. 2. 1) creep, climb up. 2) hang down. 3) spread.
rembih	see rembah.
rembong	(java) be frayed.
rembug,rembuk	discuss, confer.
rembulan	(java) moon, s.t. similar to the moon.
rembunai	average, normal.
remburs	1 (coll.) reimburse. 2 collect postage on delivery, postage due.
rembut	1. blink, flicker. 2. see rebut.
remeh	trifling, of no importance.
remen	be fond of. remen-an favorite person.
remeng	see remang 1.
remet	ramble on.
remi	rummy.
remiak	see riak 1.
remis	1. k.o. mussel. 2. /remise/ (sport) draw.
remisi	(leg.) remission.
rempah	spices (as a commercial, not culinary object). rempah-ratus medicine consisting of many different items. /re`mpah/ see rebah.
rempak	unison, all together. /re`mpak/ chipped.
rempela	(java) chicken gizzard.
rempelas	see remplas.
rempelo	see rempela.
rempeyek	k.o. crisp, thin chip made of flour and peanuts, shrimp or small fish.
remplas	1 fig tree. 2 sandpaper s.t. to scour with.
rempu	see remuk.
rempuh	see tempuh.
remujung	k.o. java tea.
remuk	crushed, shattered.
remukan	smashing, crushing.
remunai	see rembunai.
renai	see renyai.
renang	swim. renang-kodok breaststroke. renang-melentang backstroke.
rencah	1. 1) wade through, slough through. 2) face s.t. difficult. 2. mixed, various.
rencana	1 program, plan, schedule. 2 report, account, article. 3 draft.
rencang	sound of clanging.
renceh	see uang.
rencek	(jakarta) clean tree trunk of branches.
renceng	1 slender. 2 a string of s.t.
rencet	1. little by little. 2. see rentet.
rencik	see renik.
rencis	see renjis.
rencong	achenese dagger with curved handle.
renda	lace.
rendabel	economically sound.
rendah	low.
rendahan	subordinate, of lower rank.
rendam	1 submerged. 2 remain in o. place.
rendang	meat simmered in spices and coconut milk.
rendefu	rendezvous.
rendem	see rendam.
rendemen	sucrose content of sugar cane crop or sample.
rendeng	(java) rainy season.
rendengan	pertaining to the rainy season.
rendet	1 slow. 2 stall, get fouled up.
renegosiasi	renegotiation.
renek	vibrate.
reng	(java, sunda) laths used to support or press down roof tiles.
rengas	1. varnish. 2. dried up (of plants).
rengat	1. crack, split. rengat-hati furious. 2. k.o. insect that eats paper.
rengeh	a neigh, whinny.
rengek	mosquito. /re`nge`k/ whine, whimper.
rengekan	whimper, nagging.
rengeng-rengeng	soft singing voice, hum.
renggang	1 distantly spaced, wide apart. 2 loose (of knot).
renggat	ring, concentric grain (in horns, wood).
renggek	see rengek.
rengginang	k.o. crisp cracker made of glutinous rice.
renggut	1 tug at, yank out. 2 obtain s.t. with great endeavor.
renggutan	a jerk, tug.
rengit	(sunda) mosquito.
rengkah	see rekah.
rengkam	k.o. seaweed that grows on sea bottom.
rengkeh	bent (under burden).
rengket	very tightly spaced, cramped (of writting).
rengkiang	elevated rice barn.
rengkuh	(lit.) me-rengkuh tear, pull at.
rengkuhan	pulling.
rengrengan	(java) blueprint.
rengsa	beaten, apathetic.
rengsek	see ringsek.
rengus	sullen, unhappy.
rengut	see rungut.
renik	fine (of rain, rice, etc.).
renjam	see runjam.
renjana	1 emotion. 2 in love, longing.
renjis	spot, stain.
renjul	1 bumpy. 2 crazy, incoherent.
renovasi	renovation.
renta	1. speak in a loud voice, raise o.'s voice (in anger). 2. /re`nta/ worn-out.
rentabilitas	potential for producing a profit, remunerativeness.
rentak	1. 1) all at once, suddenly. 2) together, in a body. 2. stamp o.'s foot. 3. rhythm, beat.
rentan	susceptible (to illness, tantrums, etc.).
rentang	a distance, part of the way.
rentas	see retas.
rente	/renten/ (fin.) interest.
renteng	see renceng.
rentenir	creditor, usurer.
rentet	in line, o. after the other.
rentetan	series, sequence.
renung	1 muse, be wistful. 2 daydream.
renungan	1 meditation, reflection. 2 musing.
renyah	1. 1) concentration, careful attention. 2) requiring attention. 2. 1) melodious (of voice, etc.). 2 crispy (of food). 3. see ranyah.
renyai	springkle, drizzle.
renyak	crush, torture s.t. or s.o.
renyang	(m) 1 restless. 2 feel out of sorts.
renyeh	whimper.
renyek	(jakarta) crumpled, shrunk.
renyem	1 (sunda) itch. 2 desperate, not knowing what to do.
renyoh,renyok	see renyuk.
renyuk	(lit.) crumpled (up), crinkled.
renyut	see denyut.
reog,reok	1 cackle. 2 (java) k.o. masked dance. 3 (sunda) k.o. singing comedy group.
reol	see riol.
reorganisasi	reorganization.
reorganisir	reorganize.
reorientasi	reorientation.
reot	see reyot.
rep.	[republik] republic.
repak	crisp, fragile.
reparasi	repairs.
repas	dry and brittle, crumbly.
repatrian	repatriate.
repatriasi	repatriation.
repek	see repet.
repelita	[rencana pembangunan lima tahun] five-year development plan.
reperkusi	repercussion.
repertoar	/repertoir, repertorium/ repertory (of dance, drama, etc.).
repes	1 fidget. 2 waste time.
repet	1 chatter, blabber. 2 splatter (of an oar, etc.).
repetan	1. (math.) phase (of a decimal fraction). 2. 1) empty chatter, gossip. 2) splatter.
repetir	1 repeat (inoculations). 2 repeating (rifle).
repetisi	1 rehearsal. 2 quiz. 3 repetition.
repih	crumbly.
repis	see repih.
repliek	/replik/ (leg.) counterplea, rejoinder.
repolper	revolver.
repolusi	see revolusi.
repormir	see reformir.
reportase	1 way of reporting. 2 article.
repot	(coll.) report. /re`pot/ 1 busy, occupied. 2 troublesome, full of meticulous details.
reprep	(jakarta) torn.
representasi	delegation.
representatif	representative.
represi	repression.
represif	repressive.
reproduksi	reproduction.
reptil	reptile.
republik	republic.
republiken	republican.
repuh	see rapuh.
repuh-repuh	padlock.
reput	1 rotten, crumbling into decay. 2 loose, sandy. 3 (geol.) friable.
reputasi	reputation.
requisitoir	see rekuisitoir.
rerak	broken into pieces.
reramuan	all k.o. ingredients (in culinary or medicinal preparations.
rerangka	framework.
rerantingan	all manner of branches and twigs.
rerasan	(java) thinking and talking (about s.o.).
rerata	on the average.
rerep	subsided, calmed down.
reret	sound of squeaking.
reribu	thousands.
rerintih	moans, groans.
rerintik	drizzle, drops.
rerompok	see rorompok.
rerongkong	/rerongkongan/ 1 skeleton. 2 carcass, cadaver.
rerongsokan	wreckage.
rerot	see erot 2.
rerumput	/rerumputan/ grassy field.
reruntuh	/reruntuk/ wrekage, debris, ruins.
res.	1. [residen] resident. 2. [resimen] regiment.
resa	movements of baby about to be born.
resah	fidgety, restless.
resak	k.o. commercial timber tree.
resam	1. k.o. fern. 2. 1) organized, customary ways. 2) equal to.
resan	anxious, worried.
resap	1 penetrate, infiltrate. 2 ooze out, soak through and out. 3 become absorbed, dissipate.
resbang	bench, cot.
resek	cluttered. /re`se`k/ 1 look for s.t. by feeling with the hands. 2 investigate.
resen	recent.
resensi	book review
resensor	reviewer.
resep	1. (sunda) enjoyable. 2. see resap. /re`se`p/ 1 recipe. 2 prescription. 3 recommended program.
resepsi	reception.
resepsionis	receptionist.
reserse	/resersir/ detective.
reservat	land set aside for an ethnic group, reservation.
reserve	1. reserve supply. 2. reticence.
reservoir	/reservoar/ reservoir, reserves.
reses	recess of parliament.
resesi	(econ.) recession.
resi	1. 1) receipt (esp. for mailed or shipped items). 2) baggage check. 2. title for ascetics in wayang stories.
resia	see rahasia.
residen	resident, head of a residency (in colonial administration).
residivis	repeated offender, former convict.
residu	residue.
resik	(java) pure, clean.
resiko	see risiko.
resim	see rezim.
resimen	(mil.) regiment.
resiprokatif	reciprocal.
resiprositas	reciprocity.
resistensi	resistance.
resital	music recital.
resitasi	recitation.
reskrim	[reserse kriminil] criminal investigation bureau (of police).
resmi	1 official, legitimate. 2 formal.
resolusi	resolution.
resonansi	resonance.
resopim	[revolusi sosialisme pimpinan nasional] revolution, socialism, national leadership (sukarno-era slogan).
resort	1 police administrative unit at county level (the kabupaten level). 2 army administrative unit at level just below division.
resosialisasi	resocialization.
respek	respect, to respect.
respon	/respons/ response.
responden	respondent (esp. in surveys).
responsi	review session (at college).
responsibilitas	responsibility.
responsif	responsive, lively.
restan	1. remainder, remnant. 2. see pos.
restitusi	repayment of expenses incurred for medical care.
restoran	restaurant. restoran-kaki lima sidewalk food vending stalls.
restorasi	1. food service on a train. 2. restoration (of monument, etc.).
restriksi	restriction.
restrukturisasi	restructuring.
restu	blessing.
restung	k.o. boil on nose (us. caused by venereal disease).
resu	see resi 1.
resultan	/resultante/ resultant.
resume	summary.
ret	(bri.) diamonds.
reta	talk foolishly and endlessly.
retai	crack, fissure.
retak	1 crack, fissure. 2 cracked.
retakan	a crack.
retas	rip open, take apart.
reteh	see retih 1.
retensi	(ling.) retention.
retet	sound of rattling.
retetet-tetet	1 sound of bugle or trumpet. 2 sound of barrage of gunfire.
retih	1. crackling sound. 2. me-retih form beads (of sweat).
retir	see retur.
retna	see ratna.
retok	see recok.
retool	/ritul/ see ritul.
retorik,retorika	rhetoric.
retoris	rhetorical.
retorsi	retorsion.
retret	(rel.) retreat.
retribusi	1 toll or fee to use a public facility. 2 dues (for club).
retrospeksi	retrospection.
retrospektif	retrospective.
retul	see ritul.
retuling	see rituling.
retur	(coll.) round trip (of plane tickets).
reuni	reunion.
reunifikasi	reunification.
revaluasi	revaluation.
revans	revenge (esp. in sports, cards, etc.).
revisi	revision.
revisionis	revisionist.
revisionisme	revisionism.
revisir	revise.
revitalisasi	revitalization.
revolusi	revolution.
revolusioner	revolutionary.
revolusionerisme	an outlook based on revolutionary principles.
revolusionisasi	revolutionizing.
rewak	see rebak 2.
rewang	1. 1) swing. 2) (naut.) yaw. 2. (java) servant, assistant. 3. (m) grope about.
rewel	1 hard to please, fussy. 2 troublesome.
rewes	see ngrewes.
reyal	see rial.
reyog	k.o. e. java folk dance.
reyot	falling to pieces, decrepit (of houses, etc.).
rezeki	1 livelihood. 2 luck, fortune. 3 (islam) blessing (of god).prosperity.
rezim	regime.
rfj	[republik federal/federasi jerman] federal republic of germany.
rg.	[regu] team.
rheumatik	see rematik.
rhum	see rum 1.
ri	[republik indonesia] republic of indonesia.
ri-ri-ri	sound made to call ducks.
ria	1. cheerful. 2. 1) proud, jealously proud. 2) haughty.
riadat	(islam) practice of penance and mortification for spiritual enlightenment.
riah	1. see meriah. 2. see ria 2.
riak	1. 1) ripples. 2) indication, intention. 2. phlegm, mucus. 3. see ria 2.
rial	1 saudi arabian currency. 2 money.
riam	river rapids.
rian	measure of yarn or thread equivalent to o. skein or 1/16 of a tukal.
riang	1 cheerful, joyful. 2 dizzy.
riang-riang	cicada.
riap	protrude, swell out.
rias	make-up. meja-rias dressing table.
riasan	ornament, article of adornment.
riba	1. lap. 2. usury, excessive interest.
ribak	see rebak.
ribatat	family relationship.
ribon	(sport) rebound.
ribu	thousand.
ribuan	1 a currency note or coin with the value of 1,000. 2 in thousands, by the thousands.
ribut	1 storm, gale. 2 noisy, loud.
ricau	chatter, twitter.
rices	drinking straws.
ricih	1. see rincih. 2. /ricik/ make a rushing sound (such as water in terraced ditch).
ricis	(jakarta) slice, chop (ingredients for a dish).
ricuh	chaotic, quarrelsome.
rida	see rela.
ridah	/ridat, riddah, riddat/ see murtad.
ridha	/ridla, ridhlo, ridho/ see re
ridi	see redi.
riding	(lit.) noose trap.
ridip	(dorsal) fins.
ridla	/ridlo, ridhloh, rido/ see rela.
rifli	(sport) referee.
rigai	(m) skinny.
rigi	rigi-rigi cog, tooth.
rigu	see terigu.
rihal	see rehal.
rihat	see istirahat.
rihting	/rihting weser/ directional signals (on vehicles).
riil	/riyil/ real.
rijang	(geol.) flint, chert.
rik	sound of creaking.
rikoset	ricochet.
riksa	/riksya/ rickshaw.
rikuh	(java) feel awkward or ashamed in the presence of o.'s betters.
ril	see rel.
rila	/rilah/ see rela.
rileks	/rilek/ 1 relax. 2 carefree.
rilis	releas (of a tune, record).
rim	1. 1) ream, a measurement for paper. 2) a carton (of cigarettes). 2. (coll.) military style belt (for ammunition, etc.).
rima	rhyme.
rimas	1 anxious, worried. 2 discontented, irritated.
rimau	see harimau.
rimba	jungle, forest. rimba-belantara vast forest. rimba-sawang wilderness.
rimbas	small adz.
rimbit	see rembet 2.
rimbu	forest.
rimbun	thick, dense (of foliage, forest, etc.).
rimis	(m) half a cent.
rimpang	rhizome (ginger, tumeric, etc.).
rimpel	pleat, pleated.
rimpi	dried fruit slices.
rimpuh	tired, exhaused.
rimpung	bind the arms and legs.
rinai	1. (lit.) hum. 2. see renyai.
rinci	detail.
rincih	small parts, thin slices.
rincis	specify.
rincu	/rincuh/ see ricu(h).
rindang	1 leafy, luxuriant. 2 shady.
rinding	feel suddenly frightened, feel eerie.
rindu	1 longing, yearning. 2 feel homesick for, yearn for.
ring	1. (auto.) ring. 2. (sport) boxing ring. 3. sound of ringing.
ringan	1 light in weight. 2 minor in importance.
ringgik	see rengek.
ringgit	1. 1) two-and-a hall rupiah (note). 2) a gold coin (often used for pendants). 3) national currency of malaysia and brunei. 2. (lit.).
ringih	neigh, whinny.
ringik	see rengek.
ringis	grimace, grin.
ringkai	dry (of leaves), arid.
ringkas	brief, succinct, concise.
ringkasan	resume, precis, summary.
ringkih	frail.
ringkik	neigh, whinny.
ringking	yell.
ringkok	deep dish or shallow bowl to eat from.
ringkuk	1 bent over, stooped. 2 shut up, confined.
ringkus	1 catch by binding the limbs. 2 take into custody, catch.
ringsek	broken in pieces, totally damaged.
ringsekan	in bad shape, cheap.
ringsut	decline.
rintang	1. (lit.) entertain, distract. 2. 1) block (o.'s path). 2) interfere with, hamper.
rintangan	1 hindrance, obstacle, holdup. 2 barrier, restriction.
rintas	take a short-cut.
rintih	a moan, groan.
rintik	1 spot, fine spot. 2 droplet. rintik-rintik small spots, dots.
rintis	me-rintis 1 clear a way, path. 2 do pioneering work.
riol	sewer, drain.
riolering	sewers, drainage system.
ripot	see repot.
ripuh	1 misterable, sad. 2 in a mess.
ripuk	broken, damaged.
ris	[republik indonesia serikat] federal republic of indonesia (1949-1950).
risa	a callus.
risalah	/risalat/ 1 essay, composition, treatise. 2 circular, brochure. 3 minutes (of meeting), proceedings. 4 report (of assets).
risau	restless, nervous.
riset	research.
risih	feel uncomfortable about s.t. risque, taboo, etc.
risik	1. (lit.) confidential, inquiry. 2. 1) rustling (noise). 2) be noisy.
risiko	risk, peril.
riskan	/riskant/ risky.
riskir	risk s.t.
risoles	k.o. croquette, rissole.
ristek	[riset dan teknologi] research and technology.
risuh	embarrassed.
rit	1. trip made by a public vehicle. 2 sound of creaking. 3. see rices.
riting	see rihting.
ritme	rhythm.
ritmis	rhythmic.
rits,ritsleting	zipper.
ritual	ritual.
ritul	1 (coll.) reorganize. 2 purge (sukarno era).
rituling	1 (coll.) reorganization. 2 purge (sukarno era).
ritus	rite.
riuh	noisy, vociferaous.
riung	1. range of mountains. 2. conduct or gather for a ceremonial meal.
riut	1. sound of s.t. creaking.be bent or folded.
rival	(lit.) rival.
rivalitas	(lit.) rivalry, competition.
riwan	(sunda) dream of no significance.
riwayat	1 story, narrative, tale. 2 history.
riyep	(jakarta) dim (lights).
rizeki	/rizki/ see rezeki.
rk	1. [rum katolik] roman catholic. 2. [rukun warga] 1) village association. 2) a unit of political organization just below the village level.
rkz	[rooms katholieke ziekenhuis] a hospital run by the roman catholic church.
rms	[republik maluku selatan] s. moluccan republic (secession attempt from central gvt. in 1950s and 1960s).
robah	see ubah.
robak-rabik	torn in shreds, in rags.
robbi	(islam) god.
robek	torn.
rober	(bri.) rubber.
roboh	collapse.
robohan	debris, rubble.
robot	1. (jakarta) sound of explosion. 2. 1) robot. 2 unimaginative person.
rocet	(sunda) disorderly. in a mess.
rocok	1 flow (forcefully). 2 (jakarta) leak.
roda	wheel.
rodan	(lit.) painful, tender.
rodat	arabian song accompanied by the tambourine.
rodentisida	rat poison.
rodi	forced labor, corvee (of colonial period). be-, me-rodi 1 do forced labor. 2 (coll.) work extra hard.
rodok	me-rodok 1 stab with upward thrust. 2 dash, in a hurry.
rodong	1. ( lit.) run into, meet by chance. 2. wander about.
rofel	(coll.) do more than o. thing at once.
rogoh	1 grope, search (in pocket, bag, etc.). 2 grope after s.t.
rogol	rogol rape s.o.
roh	spirit, soul.
rohani	spiritual. rohani- dan jasmani spiritual and physical.
rohaniah	spiritual.
rohaniawan	/rohaniwan/ churchman.
rohaniawati	/rohaniwati/ churchwoman.
rohmat	see rahmat.
rohu'l-kudus	(rel.) the holy spirit.
roi,roilen	(coll.) building alignment.
rojok	see rocok.
rojol	protrude, jut out, emerge.
rok	skirt.
rokaat	se rakaat.
roker	rock musician.
roket	rocket.
rokh	see roh.
rokhani	see rohani.
rokhaniah	see rohaniah.
roki	clothes, frock.
roko-roko	k.o. bird.
rokok	cigarette.
rokrak	piece of wood.
rol	1. (thea.) role. 2. 1) roll, roller. 2 a numerical classifier for rolled things. 3. k.o. small bread.
rolade	k.o. meat loaf.
rolet	roulette.
roltar	/roltar(t) / k.o. cylinder-shaped cake served in slices.
rom	cream.
roma	see bulu.
romadhon	/romadlon, romadon/ see ramadan.
roman	1. figure, looks. 2. novel. 3. (coll.) be in passionate love with e.o.
romansa	romance.
romantik	romantic.
romantika	romance.
romantikus	romantic thinker.
romantis	romantic.
romantisir	romanticize.
romantisme	romanticism.
romawi	see rumawi.
rombak	1 tear down s.t. 2 change the appearance of s.t., remodel. 3 reorganize.
rombang-rambing	/rombang-rombeng/ tattered and torn.
rombe	see rumbai.
rombeng	tattered, torn.
rombengan	1 junk. 2 of a cheap kind.
romboida	(math.) rhomboid.
rombong	1. 1) k.o. large rice basket with cover. 2) pushcart (often used by venders). 2. come in large groups.
rombongan	1 group, party. 2 gang.
romboter	butter.
romel	/romel-romel/ (coll.) junk.
romeo	handsome, romantic youth.
romet	work at odd jobs.
romhorn	k.o. cone-shaped pastry with sweet filling.
romo	term of address or reference to roman catholic priest.
romok	(lit.) be uneasy, be upset.
romong	(jakarta) torn, in tatters.
rompak	commit piracy.
rompal	(java, jakarta) knocked loose, fall apart.
rompang	see rumpang.
rompang-ramping	tattered and torn, in shreds.
rompeng	/rompes/ damaged on the edge.
rompi	waistcoat, vest.
rompok	hut.
rompong	1 cut off, mutilated. 2 mutilation.
rompyok	layer (of a gown).
romusa	/romusha, romusya/ 1 program of involuntary labor during japanese occupation. 2 (coll.) brutally exploited labor.
rona	color.
ronce	tassel, appendage.
roncet	small bits.
ronda	1 rounds, patrol, beat. ronda-an patrol, night watch.
rondah-randih	be in disorder.
ronde	(sport) a round. /ronde`s/ k.o. ginger drink with peanuts and rice flour balls.
rondes	(sport) rounders.
rondo-royal	(java) fried fritters of fermented cassava.
rondok	hide o.s.
roneo	mimeograph.
rongak	discontinous, with gaps (of teeth, fences, etc.).
rongga	hollow space, cavity, hole. rongga-dada thoracic cavity. rongga-hidung nasal cavity.
ronggang	see renggang.
ronggeng	(java) paid dancing or singing girl sometimes also available for sex.
ronggoh	see rungguh 2.
rongkoh	/rongkok/ walk stooped over.
rongkongan	1. (java, jakarta) skeleton. 2. see kerongkongan.
rongong	sound of buzzing.
rongos	see mrongos.
rongrong	1 gnaw at s.t. 2 undermine s.t., damage s.t.
rongseng	sullen, upset, grumbling.
rongsok	damaged, worn-out.
rongsokan	worn-out articles, wreckage.
ronsel	crimp.
ronsen	x-ray.
ronta	struggle to get loose.
rontak	see berontak.
rontal	see lontar 1.
rontgen	see ronsen.
rontok	/rontog/ drop off, fall off, shed.
ronyeh	grumble.
ronyok	crumpled up.
room	see rom.
roos	see ros 1.
ropak-rapik	in disorder, chaotic.
ropel	see rofel.
rorod	remove husk by shaking.
rorompok	(sunda) house, in polite, self-deprecating reference to o.'s own house.
ros	1. rose. 2. bull's-eye (in a target). 3. see ruas.
rosario	(rel.) rosary.
rosbang	see resbang.
rosela	k.o. fiber used to make sacks and ropes.
roseng	see rongseng.
roset	1. roselike ornament. 2. see kayu1.
roskam	k.o. brush (for horses).
rosok	see rongsok.
rosot	1 slip off. 2 decline, sink.
roster	1. schedule of classes. 2. opening for ventilation.
rosul	see rasul.
rotan	rattan.
rotasi	(tech.) rotation.
roti	1 bread. 2 bun.
rotok	sound of repeated explosion.
rotor	(auto.) rotor.
rotsoi	lousy, rotten.
royak	1 spread. 2 worsen.
royal	extravagant, profligate.
royalis	royalist.
royalti	royalty.
royan	cramps.
royokan	(coll.) fight e.o. to obtain s.t.
royong	see gotong-royong.
rp.	[rupiah] rupiah.
rpa	[republik persatuan arab] united arab republic.
rph	[rumah potong hewan] slaughterhouse.
rpkad	[resimen pasukan komando angkatan darat] crack troops, strom troops.
rrc	/rr cina/ [republik rakyat cina] people's republic of china.
rri	[radio republik indonesia] indonesian broadcasting system.
rrt	[republik rakyat tiongkok] people's republic of china.
rs	[rumah sakit] hospital.
rsi	[rumah sakit islam] islamic-run hospital.
rsu	[rumah sakit umum] public hospital.
rsud	[rumah sakit umum daerah] regional public hospital.
rsup	[rumah sakit umum pusat] central hospital.
rsv	[republik sosialis vietnam] socialist republic of vietnam.
rt	[rukun tetangga] neighborhood association, the lowest adminitrative unit.
ru	1. 14.49 square meters. 2. see eru.
ru'yat	see rukyat.
rua	see ruak.
ruadat	ceremony, sign of respect.
ruah	(islam., coll.) eighth month of the year.
ruak	extensive.
ruam	skin eruption.
ruang	1 space. 2 (naut.) ship's well or water that gathers there. 3 column (in a paper, magazine). 4 room, hall.
ruap	scum, foam.
ruas	1 space between joints, internode. 2 (math.) parts of an equation.
ruat	1. shaky, undecided. 2. (java, sunda) exorcism ritual.
rubah	1. fox. 2. see ubah.
rubai	/rubayat/ (lit.) quatrain.
rubel	ruble, russian currency.
rubiah	(rel.) nun.
rubrik	1 heading. 2 column.
rubu	see raba.
rubuh	see roboh.
rubung	flow together in large quantities.
rucut	escape, glide loose.
rudal	[peluru kendali] guided missile.
rudin	impoverished.
rudu	1 stooping, bowed with age. 2 drooping, hanging down.
rudus	cutlass, machete.
ruet	see ruwet.
rugi	1 suffer a financial loss. 2 lose out.
rugos	lettering sheet (rubbed with pencil).
ruh	see roh.
ruhak	embers.
ruhani	see rohani.
ruhban	(rel.) monk, hermit.
ruhbanat	(rel.) nun.
ruit	1. bent, hook-shaped barb. 2. /ret, roit/ (crd.) diamond (suit).
rujah	me-rujah stab, poke at a fire.
rujak	k.o. fruit salad with pungent dressing. rujak-cingur vegetables or fruit salad with slices of beef snout.
ruji	1. trelliswork, grill. 2. radius. ruji-ligat (phys.) radius of gyration.
rujuk	1. 1) reconciliation. 2) be reconciled with o.'s separated wife before divorce is final. 2. reference.
rukaat	see rakaat.
rukah	turn over.
rukhani	see rohani.
rukhsah	(islam) dispensation (for elderly, ill, etc.) from observing fast : such a person must donate a day's food to poor.
rukiat	1. magic. 2 see rukyat.
ruku	1. sound of cooing. 2. see rukuk.
ruku-ruku	k.o. basil.
rukuh	(islam) prayer robe for women.
rukuk	(islam) deep bow from the waist during prayer ritual.
rukun	1. harmonious. 2. (islam) pillar, essential principle.
rukyat	(islam) determining date by sighting of moon (not by system of hisab), esp. to fix beginning and end of fasting period.
rulet	see rolet.
rum	1. rum. 2. sound of humming (like that of engine). 3. see rom.
rum-rum	see rungrum.
rumah	1 house, dwelling. 2 (coll.) public building. 3 housing (for machinery, etc.).
rumawi	roman.
rumba	the rumba.
rumbah	leaves or salad eaten with rice.
rumbai	tuft, tassel.
rumbang	see rombang-rambing.
rumbia	sago palm.
rumbing	somewhat damaged.
rumet,rumit	1 hard, difficult. 2 complex, intricate, knotty.
rumi	see rumawi.
rumpang	1 have gaps. 2 discontinuous (of time).
rumpik	1 wicked, having bad intentions. 2 (sl.) shit ! (interjection used in jest or admiration).
rumpun	clump (of herbaceous plants). rumpun-bambu bamboo cluster. rumpun-bahasa (ling.) language family.
rumput	1 grass. 2 weeds.
rumuhun	(sunda) ancestor.
rumun	see kerumun.
rumus	1 (chem., etc.) formula. 2 abbreviation.
runcing	pointed (of pencil, arrowhead, etc.).
runcit	see roncet.
runding	confer, discuss.
rundu-randa	(jakarta) come and go (whit a burden).
runduk	stoop, bend, bow.
rundung	afflict.
runggas	pull out.
rungguh	1. squat. 2. pledge, guarantee, security.
runggut	see renggut.
rungkai	see ungkai.
rungkau	hang down like hair over the face or like willow branches.
rungkuh	worn-out, decrepit, aged.
rungkup	1 cover up. 2 spread over.
rungrum	fondle, pet.
rungsing	see rongseng.
rungus	(m) grumble.
rungut	grumble, gripe.
runjak	see lonjak.
runjam	/runjang/ thrust, stab.
runjung	cone-shaped. hantu-runjung k.o. ghost that grows bigger bit by bit.
runtai	me-runtai dangle, hang loosely. se-runtai bunch, cluster.
runtuh	1 collapse. 2 fall out.
runtuk	see rontog.
runtun	1. o. after the other, in a row. 2. pull out.
runtunan	series (of inoculations, regulations, etc.).
runtut	1. in harmony, harmonious. 2. see runtun 1.
runut	trace, groove, furrow.
runyam	(coll.) be in difficulties.
rupa	1 form, shape, appearance. 2 sort, kind.
rupa-rupa	various, diverse, all sorts.
rupa-rupanya	probably, seemingly.
rupawan	good-looking person.
rupek	closed in, stuffy.
rupiah	indonesian monetary unit.
rurubai	hurried.
rurut	1 fall down. 2 slip off.
rus	/ruslan, rusland/ russia.
rusa	deer.
rusak	1 damaged, broken, out of order. 2 depraved.
rusbang	see resbang.
rusia	see rahasia.
rusuh	restless, disturbed.
rusuk	1 side, flank. tulang-iga (anat.) rib. 2 margin, side.
rutan	[rumah tahanan] detention center.
rute	route (of bus line, parade, etc.).
rutin	routine.
rutuk	grumble, cuss.
rutukan	curse, grumbling.
rutup	sound of bubbling.
ruu	(rencana undang-undang] (pol.) draft of a law.
ruwah	see ruah.
ruwat	see ruat 2.
ruwet	complicated, complex, knotty.
ruyak	see royak.
ruyung	1. hard exterior of a palm trunk. 2. k.o. clublike weapon.
ruyup	1 heavy-eyed, sleepy. 2 setting.
rw	1. (rukun warga] administrative unit at the next-to-lowest level in city, consisting of several rts. 2. a euphemism for cooked dog meat (from tombulu minahassan rintek wuuk "fine hair" because dog meat is a specialty of the area).
s	the 19th letter of the alphabet.
s'baya.	[surabaya] surabaya.
s'pura	[singapura] singapore.
s-0	[stratrum nol] nonuniversity degree or program.
s-1	[stratum satu] undergraduate program.
s-2	[stratum dua] master's program.
s-3	[stratum tiga] doctorate program.
s.	1. [sungai] river. 2. [santa, santo] st.
s.psi.	[sarjana psikologi] bachelor's degree in psychology.
s.th.	[sarjana theologi] master of theology.
s/d.s.d.	[sampai dengan] up to and including.
sa	(china) tree, used in bidding and commercial transactions. sa-ban 30,000. sa-ban go 35,000. sa-cap 30. sa-cap go 35. sa-ceng 3,000. sa-ceng-go 3,500. sa-pek 300. sa-pek ceng 300,000. sa-pek go 350. sa-pek go ceng 350,000. sa-tiau 3,000,000.
saadah	/saadat/ bliss.
saal	/sal/ see sal 1.
saat	/sa'at/ 1 moment. 2 instant. 3 at the moment that, when.
saba	(java) frequent a place.
sabak	1. 1) sulking, pouting. 2) dull. 2. (java) slate for school.
saban	1. each, every. saban-saban 1) time and time again, frequently. 2) at some time or another. 3) whenever. 4) (med.) k.o. disease involving incontinence or dribbling of urine. 2. see sya'ban.
sabana	savannah.
sabang	(geog.) the name of the port on the northernmost island off sumatra.
sabar	patient, calm.
sabat	see sabet.
sabda	utterance (of god, muh., jesus, or exalted personage).
sabdaillah	(islam) divine words.
sabel	sabre.
saben	see saban 1.
sabet	1 whip. 2 snatch, grab.
sabetan	1a strike (with a whip), a slash with a whipping motion, action of striking. 2 what is gotten by grabbing.
sabil	(islam) the way.
sabilillah	/sabilullah/ (islam) the way of god.
sabit	1. sickle. bulan-sabit crescent moon (symbol of islam).
sableng	(jakarta) slightly crazy, silly.
sablon	silk-screening.
sabot	sabotage.
sabotage	sabotage.
sabotir	sabotage.
sabrang	see seberang.
sabtu	saturday.
sabuk	belt, sash. sabuk-pengaman/penyelamat seatbelt, safety belt.
sabun	1. soap. 2. white, pale, albino.
sabung	1. (sport) competitive fight between two animals (us. with gambling). 2. flash.
sabur	1 dim, vague. 2 confused.
sabut	husk, fibrous shell. sabut-kelapa coconut fiber.
sadah	betel lime.
sadai	lay on o.'s back with legs extended.
sadak	1. betel lime. 2. slanting.
sadap	1. 1) make incisions in a tree to obtain sap. 2) sample blood. 3) tap, bug (telephone, information, room, etc.). 2. see sedap.
sadaqah	see sedekah.
sadar	1 aware. 2 conscious.
sadarulkalam	(lit.) opening words.
sadel	bicycle or motorcycle seat.
saderek	(java) relation, relative.
sadik	honest, straightforward.
sadir	ammonium chloride.
sadis	1 sadist, sadistic. 2 (coll.) terrific, great.
sadisme	sadism.
