tripe	kb. 1 food : babat. 2 inf.: omong kosong. to publish t. menerbitkan barang rosokan/terbitan yang tak ada mutunya.
triphammer	kb. palu penempa. to deal s.t. or s.o. a t. blow memberikan pukulan yang hebat pada seseorang atau sesuatu.
triple	kb. rangkap tiga. -ks. lipat tiga. -kkt. melipat-tigakan (o's income). -kki. berkembang tiga kali lipat.
triplet	kb. anak-kembar-tiga.
triplicate	kb., ks. rangkap tiga. in t. dalam rangkap tiga.
tripod	kb. (standar) kaki tiga, tumpuan kaki-tiga.
trisect	kkt. membagi tiga.
trisyllabic	ks. tiga suku-kata.
trite	ks. basi, (h) ambar, boyak, biasa, usang.
triumph	kb. 1 kemenangan. to return in t. kembali dengan kemenangan. 2 hasil, keberhasilan. -kki. menang (over atas).
triumphal	ks. yang berkaitan dengan kemenangan. t. procession arak-arakan kemenangan. t. return pulang dengan kemenangan.
triumphant	ks. dengan jaya. to return t. kembali dengan jaya. -triumphantly kk. dengan jaya.
triumvirate	kb. tritunggal, tiga serangkai.
trivet	kb. tatakan kaki-tiga.
trivia	kb. hal-hal yang sepele.
trivial	ks. sepele, remeh-temeh.
triviality	kb. (j. -ties) keremehan, kesepelean.
triweekly	kb. (j. -lies) majalah yang terbit sekali tiga minggu. -ks. sekali tiga minggu.
trod(den)	lih tread.
troll	kb. kumparan tali pancing. -kki. memancing dengan tali.
trolley	kb. trem listrik. t. bus bis listrik. t. car trem listrik. sl.: to be off o's t. gila, otak tidak waras.
trollop	kb. wanita jalang, pelacur, w.t.s.
trombone	kb. trombon.
tromp	kki. inf.: berjalan dengan langkah-langkah berat. to be tromped to death diinjak-injak sampai mati.
troop	kb. pasukan. -troops j. (pasukan-pasukan) tentara. -kki. to t. after beramai-ramai mengikuti (s.o.).
trooper	kb. polisi negara. state t. polisi peronda naik mobil, polisi patroli.
troopship	kb. kapal pengangkut tentara.
trop.	1 [tropic] daerah tropis. 2 [tropical] yang berkaitan dengan daerah khatulistiwa.
trophy	kb. (j. -phies) 1 (award) piala. 2 tanda kenang-kenangan.
tropic	kb. garis balik. -tropics j. daerah tropis, (daerah) tropika. to live in the tropics hidup di daerah iklim panas.
tropical	ks. tropis. t. diseases penyakit-penyakit dari daerah tropis. t. flowers bunga-bunga tropis.
trot	kb. 1 lari derap. to break into a t. merobah formasi dengan berlari langkah kecil. 2 sl.: terjemahan. -kki. (trotted) 1 menderap, berderap. 2 pergi.
troth	kb. kesetiaan. to plight o's t. mengucapkan janji (setia), berjanji untuk kawin.
trouble	kb. 1 kesusahan. 2 kesukaran. 3 kesukaran, kekacauan. 4 persoalan. 5 panyakit. -kkt. 1 mengganggu. 2 menyusahkan. 3 meminta. -kki. bersusah-susah.
trouble-shooter	kb. orang yang pandai menemukan dan mengatasi sebab-sebab kerusakan/kesulitan.
trouble-shooting	kb. mencari dan memecahkan kesulitan. t. spot daerah pusat kekacauan. -troubled ks. penuh kesukaran. t. period zaman penuh/berisi kesukaran-kesukaran.
troublemaker	kb. pengacau, perusuh
troublesome	ks. 1 menyusahkan. his broken arm is t. lengannya yang patah menyusahkan. 2 yang suka mengganggu (of a person or group).
troublous	ks. yang menyusahkan (times).
trough	kb. 1 palung, bak (for feeding or watering animals). 2 lembang diantara gelombang-gelombang
trounce	kkt. 1 memukul, keras, menghantam (s.o.). 2 mengalahkan (an opponent). -trouncing kb. dera, pukulan sebagai hukuman.
troupe	kb. rombongan. t. of acrobats rombongan akrobat.
trouper	kb. pemain kawakan.
trousers	kb., j. pantalon, celana panjang. a pair of t. satu celana.
trousseau	kb. pakaian pengantin wanita.
trout	kb. semacam ikan air tawar.
trove	kb. lih treasure.
trowel	kb. 1 kulir (for masons). to lay it on with a t. berlebih-lebihan dalam memuji, minta maaf, dsb. 2 tajak, sekop (for gardeners).
troy	kb. t. weight ukuran berat bagi emas, perak dan perhiasan-perhiasan.
truancy	kb. (j. -cies) pembolosan/kemangkiran dari sekolah.
truant	kb. pembolos (dari sekolah). to play t. membolos. t. officer pegawai pengawas pelajar-pelajar yang membolos.
truce	kb. gencatan senjata.
truck	kb. 1 (mobil) truk, prahoto, oto gerobak. t. driver sopir truk. 2 kereta pengankut barang-barang penumpang (for baggage). -kkt. mengangkut dengan truk (goods). -trucking kb. perusahaan truck.
truckload	kb. muatan truk.
truculence	kb. kegalakan, kegarangan, keganasan.
truculent	ks. 1 keras dankejam, kasar dan kejam (of temperament). 2 tajam (of satire).
trudge	kb. perjalanan dengan susah-payah. -kki. berjalan dengan susah-payah.
true	ks. 1 benar, betul. 2 sejati. 3 sebenarnya. 4 setia. 5 sah (heir). 6 pas/cocok (of an angle). true-blue ks. setia, tulus. true-to-life ks. yang sesuai dengan kenyataan, realistis.
truism	kb. kebenaran yang tak dapat disangkal lagi.
truly	kk. sungguh-sungguh, betul-betul.
trump	kb. (kartu) terup/truf. to play trumps bermain kartu truf. -kkt. menterup.
trumpet	kb. terompet. t. player pemain terompet.
trumpeter	kb. pemain terompet.
truncate	kkt. memotong. truncated cone kerucut yang dipotong bagian atasnya.
trundle	kkt. menggelindingkan, mendorong (a cart or wheelbarrow).
trunk	kb. 1 peti, kopor. 2 batang pohon. 3 (batang) tubuh. 4 tempat barang (pada mobil). 5 belalai (of elephant).
trunkful	kb. sekopor penuh.
trunkload	kb. sekopor penuh.
trunks	j. celana pendek/renang.
truss	kb. tiang penopang/penunjang. -kkt. to t. up mengikat, mengebat (a person or fowl).
trust	kb. kepercayaan. 2 bus.: perserikatan. -kkt. 1 mempercayai, percaya kepada. 2 mempercayakan kepada. -trusted ks. dipercayai. t. friend teman yang dapat dipercayai. -trusting ks. penuh kepercayaan.
trustee	kb. 1 wali, wakil. 2 komisaris (of a bank). 3 pengawas (of a university). board of trustees dewan pengawas.
trusteeship	kb. perwalian.
trustworthiness	kb. sifat dapat/layak dipercaya.
trustworthy	ks. terpercaya, dapat dipercaya.
trusty	kb. (j. -ties) tukang kunci. -ks. setia.
truth	kb. kebenaran. the t. will out kebenarannya akan terbukti.
truthful	ks. 1 yang selalu mengatakan yang sebenarnya (child). 2 jujur, menurut kenyataan (report, account). -truthfully kk. yang sesungguhnya.
truthfulness	kb. keadaan/sifat yang sebenarnya.
try	kb. usaha, percobaan. -kkt. (tried) 1 mencoba (o's strength, a rope). 2 berusaha. 3 law : mengadili (s.o., a case). 4 mencicipi (food). 5 menguji (s.o.'s patience). -kki. berusaha, mencoba. tried-and-true ks. yang telah terbukti kebenarannya (remedy).
tryng	ks. berat. t. experience pengalaman yang berat.
tryout	kb. percobaan.
tryst	kb. janji untuk bertemu.
tsar	kb. kaisar, raja.
tu.	[tuesday] hari selasa.
tub	kb. bak mandi. i prefer a t. to a shower saya lebih suka mandi (berendam) daripada mandi bersiram.
tuba	kb. semacam alat musik tiup.
tubby	ks. gendut, pendek dan gemuk.
tube	kb. 1 pipa, pembuluh. 2 (radio, tv) lampu. 3 cepuk (of toothpaste). 4 terowongan (under a river).
tubeless	ks. tanpa memakai ban dalam t. tire ban mobil tanpa memakai ban dalam.
tuber	kb. akar umbi.
tubercular	kb. penderita penyakit tebese. -ks. yang berkaitan dengan penyakit tbc. t. symptoms gejala-gejala tbc.
tuberculin	kb. zat vaksin t.b.c. t. test percobaan dengan zat vaksin t.b.c.
tuberculosis	kb. t.b.c., tebese, tebece.
tubing	kb. tabung, pipa, pembuluh. rubber t. pipa karet.
tubular	ks. berbentuk pipa. t. steel pipa baja.
tuck	kb. lipatan, kedut, kerutan. -kkt. 1 memasukkan. 2 menyelitkan, menyelempitkan (bed clothes). 3 menyimpan. 4 memasukkan, menyelipkan (money into o's pocket).
tucker	kkt. inf.: melelahkan. to be all tuckered out kecapekan, keletihan, kepayahan.
tues.	[tuesday] hari selasa.
tuesday	kb. hari selasa.
tuft	kb. 1 berkas (of hair, feathers). 2 tumpuk, lempeng (of grass).
tufted	ks. berumbai(-rumbai).
tug	kb. 1 sentakan. 2 ship.: kapal penyeret. 3 tarikan. -kkt. (tugged) menarik (a vehicle out of the mud). -kki. to t. at menarik, menyentakkan (at a window, at s.o's coat).
tugboat	kb. kapal penyeret/penarik.
tuition	kb. uang kuliah, biaya perkuliahan.
tulip	kb. bunga tulip, sejenis bunga (ber)umbi.
tulle	kb. kain tule.
tumble	kb. jatuh terguling-guling. -kki. 1 terguling, jatuh jungkir-balik (down the stairs). 2 berguling-guling, jungkir-balik (on a trampoline). 3 jatuh ( of the stock market). tumble-down ks. mau roboh (of building).
tumbler	kb. 1 gelas minum. a t. of water air segelas. 2 akrobat. 3 pasak (in a lock).
tumblerful	kb. segelas (penuh).
tummy	kb. (j. -mies) inf.: perut.
tumor	kb. bengkak, tumor. malignant t. tumor jahat, bengkak kanker.
tumult	kb. kegemparan, keributan, huruhara.
tuna	kb. ikan tongkol, cakalan.
tune	kb. lagu. play us a t. mainkanlah kami sebuah lagu. -kkt. menyetem, menala (a music instrument). tune-up kb. auto.: penyetelan, perbaikan. tuning fork garpu setem/tala, penala.
tuneful	ks. merdu.
tuner	kb. penyetelan, tukang setem.
tunic	kb. (baju) jubah.
tunnel	kb. terowongan, tembusan. -kkt., kki. menggali terowongan.
turban	kb. serban, ubel-ubel, ikat kepala.
turbid	ks. keruh (of water).
turbidity	kb. kekeruhan.
turbine	kb. turbin.
turbojet	kb. av.: (mesin, motor) turbojet.
turboprop	kb. (motor, mesin) turboprop.
turbulence	kb. 1 pergolakan, kerusuhan, kekacauan. 2 av.: gerakan putaran.
turbulent	ks. bergolak. t. times masa pergolakan. t. weather cuaca membadai.
tureen	kb. basi yang dalam,. mangkuk besar (untuk sup).
turf	kb. 1 tanah berumput, lempeng (tanah berumput). 2 kelempeng kering (for fuel).
turgid	ks. 1 bengkak. 2 bombastis (in speech).
turk	kb. orang turki.
turk.	1 [turkey] negeri turki. 2 [turkish] bahasa turki.
turkey	kb. 1 poul.: kalkun, ayam belanda. 2 sl.: kegagalan. the play was a t. sandiwara itu gagal sama sekali. inf.: to talk t. berbicara blak-blakan, berbicara secara tegas dan jujur.
turkish	kb. 1 orang turki. 2 bahasa turki. -ks. yang berkaitan dengan turki.
turmeric	kb. kunir, kunyit.
turmoir	kb. kerusuhan, kekacauan, huru-hara.
turn	kb. 1 giliran. 2 belok(an). 3 putaran (of wheel). 4 bakat. 5 perubahan. 6 jasa, kebaikan. 7 berjalan. 8 lingkaran. 9 pertukaran (of the side). 10 peralihan. to t. into berubah menjadi. to t. round = to t. around.
turnabout	kb. pembalikan haluan to do a t. berbalik haluan. t. is fair play saling berbalasan adalah layak.
turnaround	kb. perubahan haluan.
turncoat	kb. (pem)belot, pengkhianat.
turndown	kb. penolakan. -ks. terlipat (kebawah). t. collar kerah yang berlipat kebawah.
turning	kb. pembentukan, penyusunan (of a phrase). ks. yang menentukan, penting.
turnip	kb. semacam lobak cina.
turnoff	kb. belokan, simpangan.
turnout	kb. kedatangan, kehadiran. a large t. is expected diharapkan orang akan banyak datang.
turnover	kb. pergantian.
turnpike	kb. jalan-raya yang menarik bayaran, jalan raya kilat/ekspres.
turnstile	kb. pagar putar, pintu pagar.
turntable	kb. 1 piring putar (pada gramopon). 2 rr.: putaran langsir.
turorial	kb. pengajaran tambahan, pelajaran pribadi.
turpentine	kb. terpentin, minyak tusam.
turpitude	kb. kejahatan, kekejian.
turquoise	kb. (batu) pirus. -ks. warna biru-hijau.
turret	kb. menara kecil. nau.: rotating t. menara meriam yang berputar.
turtle	turtle
turtledove	kb. perkutut.
tusk	kb. 1 gading (of elephant). 2 taring (of walrus.).
tussle	kb. pergumulan, perkelahian. -kki. bergumul.
tut	kseru, kok, ah masa.
tutelage	kb. 1 perwalian. 2 pengawasan. to be under the t. of dibawah pengawasan. 3 pelajaran.
tutor	kb. guru pribadi. -kkt. mengajar di rumah, mengajar ekstra, memberi les/pelajaran.
tux	inf.: = tuxedo.
tuxedo	kb. pakaian malam pria (jas putih dan celana hitam).
tv	kb. televisi, tivi. please turn on the tv tolong pasangkan televisi. t. antena antena televisi.
tva, t.v.a.	[tennessee valley authority] instansi pengurus lembah sungai tennessee.
twaddle	kb. ocehan, omong kosong.
twang	kb. bunyi sengau. 2 desing (of a bow). 3 dentingan, bunyi petikan (of guitar). -kkt. memetik berdenting-denting (a guitar).
tweak	kkt. menjewer (an ear).
tweed	kb. tweed, wol. t. jacket jas wol.
tweedledum and tweedledee	kb. setali tiga uang, seperti pinang dibelah dua.
tweet	kb. cicit. -kkt. bercicit, mencicit.
tweezers	kb., j. penyepit, jepitan.
twelfth	kb. duabelas. the t. of march tanggal duabelas maret. -ks. yang keduabelas.
twelve	kb. duabelas. the clock struck t. jam memukul/membunyikan duabelas. it's t. o'clock jam duabelas.
twentieth	kb. tanggal duapuluh. -ks. yang keduapuluh.
twerp	kb. sl.; (hina-dina) orang kecil yang picik.
twice	kk. dua kali. t. five is ten dua kali lima sama dengan sepuluh.
twiddle	kkt. memutar-mutarkan (o's thumbs).
twig	kb. ranting.
twilight	kb. aram-temaram, senjakala. to be in the t. of life berada dalam masa tua.
twill	kb. kain kepar.
twin	kb. kembar. they are identical twins mereka kembar sempurna. -ks. kembar. t. beds tempat tidur kembar. twin-engine(d) ks. ber-motor dua. twin-screw ks. berkitiran dua. -twinning kb. kelahiran kembar.
twine	kb. benang ikat. ball of t. gumpalan benang ikat. -kkt. merangkul. to t. o's arms about s.o. merangkul/memeluk seseorang dengan kedua tangannya. to t. arround (menjalar) melingkari.
twinge	kb. 1 tusukan. t. arthritis tusukan radang selaput sendi. 2 denyutan (of sadness, regret). -kki. merasa sakit, sakit menusuk.
twinkle	kb. kelip. she has a kindly t. in her eye matanya bersinar ramah. -kki. 1 berkelip-kelip, berkelap-kelip (of stars). 2 bersinar-sinar (of eyes).
twirl	kb. putaran (of a baton). -kki. memutar-mutar.
twist	kb. 1 tikungan (in a road). 2 keseleo/salah urat (in o's wrist). 3 pelintir, gulungan (of tobacco). 4 simpul (in a rope, rubber hose). 5 (dance) twist, musik (dengan) lutut megal-megol. 6 corak nada. 7 putaran. -twisted ks. 1 yang membelit 2 sinting.
twister	kb. inf.: angin puyuh.
twisting	ks. berliku-liku, berbelok-belok (road).
twit	kkt. (twitted) mengejek, menggoda.
twitchy	ks. gugup.
twitter	kb. cicit-cicit, kicau (of birds). to be in a t. gelisah. -kki. bercicit-cicit, berkicau.
two	kb. dua. the t. of you kamu berdua. -ks. dua. t. boxes dua kotak. two-bit ks. murahan, tidak bermutu. two-edged ks. bermata-dua. (blade, sword). two-faced ks. bermuka-dua, munafik. two-legged ks. berkaki dua. two-piece ks. yang terdiri dari dua potong.
twofold	ks., kk. dua kali lipat, dua ganda. t. increase kenaikan/tambahan dua-kali lipat. to increase t. naik/bertambah duakali lipat.
twoscore	kb., ks. empatpuluh.
twosome	kb. dua orang pemain.
twp	[township] kotapraja.
ty.	[territory] wilayah.
tycoon	kb. 1 hartawan. 2 raja. oil t. raja minyak. 3 gembong. political t. gembong politik.
tying	lih tie.
tyke	kb. inf.: anak kecil.
tympani	kb., j. genderang.
tympanic	ks. t. membrane selaput anak-telinga.
type	kb. 1 macam, jenis. 2 golongan. 3 contoh, tipe. 4 huruf cetak. -kkt. 1 mengetik (a letter). 2 mencap sebagai perlambang tipe tertentu (of an actor). -kki. mengetik. -typing kb. mengetik.
typecast	kkt. menetapkan sebagai pemain peranan dari tipe tertentu.
typescript	kb. naskah yang diketik.
typesetter	kb. tukang set, seter, penyusun huruf.
typesetting	kb. penyusunan/pemasangan huruf.
typewrite	kkt., kki. (typewrote, type-written) mengetik. -typewritten ks. yang diketik. a t. copy sebuah naskah yang diketik. -typewriting kb. mengetik, ketikan.
typewriter	kb. mesin (ke)tik/tulis. electric t. mesin tik listrik.
typewritten	lih typewrite.
typewrote	lih typewrite.
typhoid	kb. penyakit tipus. t. fever demam tipus.
typhoon	kb. topan, taifun, angin puyuh.
typhus	kb. penyakit tipus.
typical	ks. khas. he's a t. boy dia seorang anak laki-laki yang khas. -typically kk. khas, khusus, tipis. t. american khas amerika.
typify	kkt. (typified) melambangkan. merupakan perlambang bagi.
typist	kb. juru (ke) tik, pengetik.
typo	kb. sl.: kesalahan cetak.
typographical	ks. yang berkaitan dengan percetakan. t. error kesalahan cetak.
typography	kb. (j.-phies) tipografi, seni cetak, tatahuruf.
tyrannical	ks. lalim, zalim, kejam.
tyrannize	kkt. bersimaharaja. -kki. to t. over bersimaharajalela terhadap atas.
tyrannous	ks. lalim, zalim, kejam.
tyranny	kb. (j. -nies) kelaliman, kezaliman, kekejaman.
tyrant	kb. 1 raja lalim. 2 orang yang kejam.
tyro	kb. orang baru, orang yang masih hijau.
u,u	kb. huruf yang keduapuluh satu dari abjad inggris. u-boat kapal selam (jerman). u-turn pemutaran balik (berbentuk u). no u-turn tak boleh putar-balik.
u.	[university] universitas.
uar	[united arab republic] kb. r.p.a., republik persatuan arab.
ubiquitous	ks. ada dimana-mana. the u. mosquito nyamuk dimana-mana.
udder	kb. ambing.
ugh	kseru. wah ! waduh !
ugliness	kb. 1 kejelekan/keburukan rupa (in appearance). 2 (offensiveness) kekurangajaran, kenakalan.
ugly	ks. 1 jelek, buruk. u. face muka yang jelek. 2 berbahaya, parah (wound). 3 inf.: tak pantas, kurang ajar, kasar (of a statement or action). u. duckling seorang gadis yang buruk rupanya sewaktu kecil tapi setelah dewasa menjadi molek.
uhf	[ultra high frekwency] frekwensi sangat tinggi.
ukulele	kb. gitar kecil, ukulele.
ulcer	kb. borok, bisul, puru.
ulcerate	kkt., kki. memborok, membisul.
ulceration	kb. pemborokan, keadaan bernanah, koreng.
ulcerous	ks. berborok, berbisul, bengkak bernanah.
ulna	kb. tulang hasta.
ult.	[ultimate(ly)] yang penghabisan, terakhir ; akhirnya, kesudahannya. 2 [ultimo] dalam bulan yang lalu.
ulterior	ks. tersembunyi, yang disembunyikan. u. motive maksud tersembunyi.
ultimate	kb. yang paling mewah. that is the u. in cars itulah yang paling mewah diantara semua mobil. -ks. 1 penghabisan, terakhir. the u. purpose tujuan terakhir. 2 pokok, asal. -ultimately kk. (pada) akhirnya.
ultimatum	kb. (j. -tum, -ta) ultimatum.
ultimo	kk. dalam bulan yang lalu.
ultra	ks. yang teramat sangat. u. high frequency frekwensi sangat tinggi.
ultraconservative	kb. seorang yang sangat konserpatip. -ks. paling konserpatip.
ultraliberal	ks. sangat liberal.
ultramarine	ks. biru laut/tua/langit.
ultramodern	ks. sangat modern.
ultrasmooth	ks. sangat licin/lihai.
ultraviolet	ks. ultra-ungu, lembayung ultra. u. rays sinar-sinar ultra-ungu.
umbilical	ks. yang berkaitan dengan pusat. u. cord tali pusat/pusar.
umbrage	kb. rasa tersinggung. to take u. at merasa tersinggung/terhina karena.
umbrella	kb. payung. an u. of fighter planes lindungan (yang terdiri dari) pesawat pemburu.
umlaut	kb. 1 ling.: umlaut. 2 detik-dua diatas huruf hidup (dalam bahasa jerman).
umpire	kb. wasit. -kkt. mewasiti. -kki. bertindak sebagai wasit.
umpteen	ks. inf.: beberapa, sekian.
umpteenth	ks. inf.: yang kesekian. for the u. time, "no !" untuk kesekian kalinya, "tidak !"
un,u.n.	[united nations] kb. perserikatan bangsa-bangsa.
un-american	ks. tidak bersifat amerika, bertentangan dengan watak amerika.
unabashed	ks. tak merasa malu. -unabashedly kk. tak tahu malu.
unable	ks. tak dapat/sanggup. u. to talk tak dapat berbicara.
unabridged	ks. lengkap, tak dipersingkat. u. dictionary kamus lengkap.
unaccented	ks. tanpa tekanan. u. vowel huruf hidup yang tak diberi tekanan.
unacceptable	ks. tak dapat diterima. u. proposal usul yang tak dapat diterima.
unaccompanied	ks. 1 tak disertai. to come u. by s.o datang tanpa disertai sewseorang. 2 yang tidak dibawa sendiri (baggage). 3 sendiri.
unaccountable	ks. 1 tak (dapat) diketahui sebabnya. 2 tak dapat diminta pertanggung-jawab (for o's actions).
unaccounted-for	ks. yang tak ada penjelasannya.
unaccredited	ks. belum diterima dengan resmi.
unaccustomed	ks. tidak biasa/dikenal.
unacquainted	ks. tidak kenal. i'm u. with him saya tidak kenal dia.
unadaptable	ks. tak dapat diterima/disesuaikan.
unadorned	ks. tanpa perhiasan.
unadulterated	ks. tidak dipalsukan/dicampur (of food). u. lie bohong besar.
unaffected	ks. 1 tak dibuat-buat (manner). 2 tak dipengaruhi (by publicity).
unaffiliated	unaffiliated
unafraid	ks. tak takut/gentar.
unaided	ks. tanpa bantuan. legible to the u. eye dapat dibaca dengan mata biasa.
unalienable	ks. tak dapat diambil (orang lain).
unalterable	ks. tak dapat diubah.
unambiguous	ks. sudah jelas, terang, tidak samar-samar.
unanimity	kb. kebulatan suara.
unanimous	ks. dengan suara bulat/bersepakat. u. decision keputusan yang diambil dengan suara bulat. -unanimously kk. dengan suara bulat.
unannounced	ks. tanpa pemberiantahu.
unanswerable	ks. tak dapat disangkal.
unappeased	ks. tak habis-habisnya/puas-puasnya.
unappetizing	ks. tak menimbulkan selera (food, meal).
unappreciated	ks. tak dihargai.
unappreciative	ks. tak menghargai.
unapproachable	ks. tak dapat didekati, tak terdekati.
unappropriated	ks. tak dialokasikan (funds).
unarmed	ks. tak bersenjata.
unascertainable	ks. tak dapat diketahui benar.
unashamedly	kk. dengan tidak merasa malu.
unaspirated	ks. phon.: tak disertai hembusan napas (sound).
unassailable	ks. tidak dapat disangkal/dibantah.
unassimilated	ks. 1 yang belum diasimilasikan (food). 2 yang belum meresap (ideas). 3 yang belum diolah (of plants).
unassisted	ks. tanpa bantuan.
unassuming	ks. tak berlagak, sederhana (manner).
unattached	ks. 1 tidak terikat. 2 belum kawin. 3 lepas.
unattainable	ks. tak dapat dicapai.
unattended	ks. tanpa perawatan, tak diawasi.
unattractive	ks. kurang menarik.
unauthorized	ks. yang tak diberi kuasa, tidak sah.
unavailable	ks. tak bersedia, tak ada persediaan.
unavailing	ks. sia-sia, tak berhasil.
unavoidable	ks. tak dapat dihindarkan/dielakkan. -unavoidably kk. tak dapat dielakkan. to be u. detained terhalang dengan tak dapat menghindar.
unaware	ks. tak sadar, menyadari (of akan).
unawares	kk. tak disangka-sangka/ diduga-duga. to take s.o. u. tidak diduga-duga oleh seseorang.
unbalanced	ks. 1 tak sehat pikiran, terganggu jiwa. 2 tak cocok (of an account).
unbearable	ks. tak dapat ditahan, tiada terderita, tak tertahankan. -unbearably kk. tak tertahan. u. hot panas yang tak tertahan.
unbeatable	ks. tak dapat dikalahkan, tak terkalahkan.
unbeaten	ks. 1 yang tak pernah kalah (team). 2 yang tak pernah dilewati (paths).
unbecoming	ks. 1 tak pantas (of manner). 2 tak menarik (of dress).
unbeknown	ks. tanpa diketahui. u. to anyone, she... tanpa diketahui seorangpun, ia ...
unbelievable	ks. bukan main, luar biasa. -unbelievably kk. bukan main, luarbiasa. he is u. stingy ia bukan main kikirnya.
unbeliever	kb. seorang yang tak beriman, kafir.
unbelieving	ks. seakan-akan tak percaya.
unbend	kkt. (unbent) meluruskan ( a wire). -kki. menjadi rmah. -unbending ks. keras hati/kepala.
unbias(s)ed	ks. sama tengah, tidak memihak, tanpa prasangka.
unbleached	ks. tak dikelantang/diputihkan.
unbolt	kkt. membuka, melepaskan.
unborn	ks. belum lahir (child, generations).
unbosom	kkt. membuka rahasianya sendiri.
unbound	ks. tidak dijilid (book).
unbounded	ks. tak terbatas/ terhingga (strength, confidence).
unbreakable	ks. tak dapat dipecahkan, tahan pecah.
unbridled	ks. tak terkendalikan/terkekang (horse, wrath).
unbroken	ks. 1 tak putus-putus (string of victories). 2 tak putus-putus (dish). 3 terus-menerus (of sleep).
unbuckle	kkt. melepaskan, membuka.
unburden	kkt. mencurahkan. to u. o's troubles to s.o. mencurahkan kesusahan-kesusahannya kepada seseorang.
unbusinesslike	ks. tidak praktis.
unbutton	kkt. membuka kancing.
uncalled-for	ks. tidak beralasan/senonoh (remark).
uncanceled	ks. belum dicap/dipakai (of a stamp).
uncanny	ks. 1 aneh, gaib (atmosphere, appearance). 2 luar biasa (ability).
uncatalogued	ks. belum dimasukkan kedalam katalogus.
unceasing	ks. 1 tak henti-hentinya (of efforts). 2 terus-menerus (of rain).
uncertain	ks. 1 ragu-ragu, bimbang. he is u. wheather he... ia masih ragu-ragu apakah ia.... 3 tak menentu, berubah-ubah (of weather). 4 tak jelas, samar-samar (shape).
uncertainty	kb. (j. -ties) ketidaktentuan.
unchain	kkt. melepaskan (a dog, o's passions).
unchallenged	ks. tak terlawan, tak dapat dibandingi. to let s.o. pass u. membicarakan seseorang lalu tanpa diperiksa.
unchanged	ks. tak berubah, tanpa perubahan.
unchanging	ks. tak berubah-ubah.
unchaperoned	ks. tanpa pengantar.
uncharitable	ks. tak mengenal belas kasihan.
uncharted	ks. belum dipetakan (sea, island).
unchecked	ks. tidak di cegah/dikendalikan.
unchristian	ks. tidak menurut ajaran kristen.
uncivilized	ks. tak beradab, biadab.
unclad	ks. 1 tak berpakaian. 2 dalam keadaan telanjang.
unclaimed	ks. tak diminta/ditunutt (mail, baggage).
unclasp	kkt. melepaskan.
unclassified	ks. tak bersifat rahasia (of a document).
uncle	kb. paman. inf.: to cry u. mengaku/menyerah kalah. u. sam pemerintahan as. u. tom seorang negro yang tunduk kepada bangsa kulit putih.
unclean	ks. kotor, tak bersih, najis.
unclear	ks. tidak terang, belum jelas.
unclog	kkt. (unclogged) menghilangkan/membuang penyumbat (a drain).
unclothed	ks. tak berpakaian, telanjang (body).
uncluttered	ks. rapi, teratur, bersih.
uncock	kkt. menurunkan pelatuk.
uncoil	kkt. menguraikan (a rope). -kki. mengorak, mengurai (of a snake).
uncollected	ks. 1 belum ditarik/ditagih (of taxes). 2 belum diambil/dikumpulkan (of mail).
uncombed	ks. tidak disisir, kusut (of hair).
uncomfortable	ks. merasa tak enak. to have an u. feeling berperasaan gelisah/tidak tenang. this chair is u. kursi ini tak enak diduduki. -uncomfortably kk. terasa tidak enak. to be u. dressed memakai pakaian yang tidak menyenangkan.
uncommitted	ks. tak terikat, netral.
uncommon	ks. luar biasa. -uncomonly kk. luarbiasa. u. skillful yang luar biasa kecakapannya.
uncommunicative	ks. pendiam, tidak suka berbicara.
uncomplaining	ks. tak (suka) mengeluh.
uncomplimentary	ks. yang bersifat mencela/mengecam.
uncompromising	ks. keras kepala, tak suka berkompromi.
unconcealed	ks. tak disembunyikan (dislike).
unconcerned	ks. tak perduli, tak ambil pusing, lega dada.
unconditional	ks. tak bersyarat, mutlak. u. surrender penyerahan tanpa syarat. -unconditionally kk. tanpa syarat.
unconfirmed	ks. belum pasti kebenarannya (of a rumor).
unconguerable	ks. tak tertundukkan, tak kunjung padam (spirit).
unconnected	ks. tak bertalian, terlepas satu sama lain (of a problem).
unconscionable	ks. 1 rendah budi (of a liar). 2 banyak sekali. an u. amount of snow salju yang banyak sekali.
unconscious	kb. bawah sadar. -ks. 1 tak sadar. 2 tak sadarkan, pingsan (after an accident). -unconsciously kk. dengan tak sadar, tanpa disadari.
unconsciousness	kb. ketidaksadaran, keadaan pingsan.
unconstitutional	ks. tak konstitusionil, in konstitusionil.
uncontaminated	ks. bersih, tidak kotor, murni, tidak terjangkit.
uncontested	ks. tak ditentang/dilawan (election). an u. fact suatu kenyataan yang tak dapat dibantah.
uncontrollable	ks. tak dapat dikendalikan (temper).
uncontrolled	ks. tak terkendalikan (joy).
unconventional	ks. tidak konvensionil, diluar peraturan atau kebiasaan.
unconvinced	ks. tidak percaya/yakin.
unconvincing	ks. tak meyakinkan.
uncooked	ks. tak dimasak, mentah (food).
uncooperative	ks. tak mau bekerja sama. enggan membantu.
uncoordinated	ks. 1 tak teratur (in o's movements). 2 tak dikoordinir, tanpa koordinasi (of plans).
uncork	kkt. membuka sumbat (a bottle).
uncorrected	ks. belum dikoreksi (of gallery proof). u. error kesalahan yang tidak diperbaiki.
uncorroborated	ks. belum passti kebenaranya (report).
uncounted	ks. tak terhitung jumlahnya. u. dead korban-korban yang tewas yang tak terhitung jumlahnya.
uncouple	kkt. melepaskan (dari sambungan).
uncouth	ks. kasar, tak tahu adat.
uncouthness	kb. kekasaran, sikap yang kasar/tanpa adat.
uncover	kkt. 1 menemukan (irregulaities). 2 membuka kedok, membongkar (a plot). 3 membuka (a pan).
uncritical	ks. tanpa kritik, tidak biasa mengeluarkan kritik/kupasan.
uncrowned	ks. tanpa tiara/mahkota, berkuasa tanpa dinobat menjadi raja (king).
unction	kb. pemberian minyak suci. to administer extreme u. mengadakan upacara sembahyang dengan memakai minyak-minyakan oleh pendeta katolik untuk orang yang sedang sekarat.
unctuous	ks. bermanis-manis, pura-pura manis, pandai mengambil hati orang.
uncultivated	ks. 1 tak dikerjakan (farm). 2 tak terdidik (mind).
uncultured	ks. tak beradab/berkebudayaan.
uncurbed	ks. tak terkendalikan.
uncurl	kkt. meluruskan, membuka (a ribbon).
uncut	ks. 1 belum dipangkas/dipotong (lawn, book). 2 yang belum diasah (of a diamond).
undamaged	ks. tidak rusak, utuh.
undated	ks. tak bertanggal
undaunted	ks. tak takut/gentar, berani.
undecided	ks. ragu-ragu, bimbang. iam u. whether to go or stay aku masih bimbang apakah akan pergi atau tidak.
undefeated	ks. tak terkalahkan, tak pernah kalah (team).
undefiled	ks. bersih, murni, tidak kotor, tanpa cela.
undefined	ks. 1 tak diterangkan artinya (of a word). 2 tak ditentukan batas-batasnya (of premises).
undeliverable	ks. tidak dapat disampaikan (of mail).
undelivered	ks. tidak disampaikan/dipasrahkan/dileper (of a letter).
undemanding	ks. tak berat, enteng, ringan (work).
undemocratic	ks. tidak demokratis.
undemonstrative	ks. tak (suka) memperlihatkan perasaan memendam rasa.
undeniable	ks. tak dapat disangkal. -undeniably kk. tak dapat disangkal
under	ks. bawah. -kd. 1 dibawah. 2 kebawah, kedalam. 3 menurut. 4 kurang dari. 5 dengan. 6 pada. 7 dalam.
underage	ks. masih dibawah umur.
underarm	kb. ketiak, kelek. u. deodorant minyak wangi untuk ketiak. u. perspiration keringat ketiak.
underbelly	kb. (j. -lies) 1 perut (bagian bawah). 2 bagian lemah.
underbid	kkt. (underbid) menawarkan harga yang lebih rendah daripada. -kki. membuat tawaran yang terlalu rendah.
underbrush	kb. belukar, semak-semak.
undercarriage	kb. bagian bawah (of plane).
undercharge	kkt. meminta membayar kurang daripada harga.
underclassman	kb. (j. -men) mahasiswa tingkat prasarjana.
underclothes	kb., j. pakaian dalam.
underclothing	kb. pakaian dalam.
undercoat	kb. lapisan bawah/dasar (of paint).
undercover	ks. rahasia, menyamar. u. agent polisi/agen rahasia.
undercurrent	kb. 1 aliran dalam (of a stream). 2 arus yang terpendam. u. of despair arus rasa putus asa yang terpendam.
undercut	kkt. (undercut) menjual dengan harga yang lebih rendah.
underdeveloped	ks. kurang maju, belum berkembang. u. country negara yang masih terbelakang.
underdog	kb. seorang atau mereka yang tertindas, orang sial. to roat for the u. membantu pihak yang lemah.
underdone	ks. kurang masak/matang.
underemployed	kb. tenaga kerja yang setengah menganggur.
underemployment	kb. kekuranganan pekerjaan.
underestimate	kkt. menaksir terlalu rendah, meremehkan.
underfed	lih underfeed.
underfeed	kkt. (underfed) kurang memberi makanan. to look underfed nampaknya kurang diberi makanan.
underfoot	kk. menjadi penghalang.
undergarment	kb. pekaian dalam.
undergo	kkt. (underwent, undergone) 1 menjalani (an operation, repairs). 2 menjalani, melalui, mengalami (hardship).
undergone	lih undergo.
undergraduate	kb. mahasiswa yang belum mendapat gelar. u. education pendidikan tingkat prasarjana.
underground	kb. bawah tanah. u. movement gerakan dibawah tanah. -kk. dibawah tanah. to work u. bekerja dibawah tanah. to go u. menyembunyikan diri.
undergrowth	kb. belukar, semak-semak.
underhand	kk. 1 dengan ayunan rendah. to throw u. melempar dengan ayunan rendah. 2 dengan curang/licik.
underhanded	ks. licik, curang.
underlain	lih underlie.
underlay	lih. underlie.
underlie	kkt. (underlay, underlain) mendasari. -underlying ks. pokok, yang mendasari. u. reason alasan yang pokok, pokok yang mendasari.
underline	kkt. 1 menggaris-bawahi (a word). 2 menekankan (an objection). -underlining kb. lapisan dalam.
underling	kb. (orang) bawahan.
underlying	lih underlie.
undermine	kkt. 1 menggangsir, menggali (a foundation). 2 merusak, meruntuhkan (the good work of s.o.). 3 mengurangi (o's health).
underneath	kd. dibawah. u. a book dibawah sebuah buku. from u. a bush dari bawah semak. -kk. disebelah bawah/dalam.
undernourished	ks. kurang (diberi) makan.
underpaid	ks. dibayar kurang. he is woefully u. gajinya sedikit sekali.
underpants	kb., j. celana dalam/kolor.
underpass	kb. jalan melintang dibawah jalan lain.
underpinning	kb. tiang pondasi/penyokong.
underpopulated	ks. berpenduduk jarang. u. area daerah yang kurang penduduknya.
underprivileged	ks. serba kekurangan, kurang mampu.
underrate	kkt. memandang rendah, meremehkan.
underscore	kkt. 1 menggaris-bawahi. 2 (to stress) menekankan , menegaskan.
undersea	ks. dibawah (permukaan) laut. u. exploration penyelidikan dibawah laut. -underseas kk. menyelam kedalam laut.
undersecretary	kb. (j. -ries) wakil menteri, mentri muda. u. of commerce menteri muda perdagangan.
undersell	kkt. (undersold) menjual lebih murah dari.
undershirt	kb. baju kaos/dalam.
undershoot	kkt. (undershot) menembak terlalu rendah dari (a target). av.: to u. the runway terbang terlalu rendah mengenai landasan.
undershot	lih undershoot.
underside	kb. bagian/permukaan bawah.
undersigned	kb. yang bertanda tangan (dibawah).
undersize(d)	ks. berukuran terlalu kecil.
underslung	ks. menggantung (dibawah sumbu) (of a car).
undersold	lih undersell.
understaffed	ks. kekurangan tenaga.
understand	kkt. (understood) 1 mengerti, paham. 2 memaksud(kan). 3 mengenal (children). -kki. 1 mengerti. 2 mengetahui. 3 mengetahui, menangkap. 4 mendengar. -understanding kb. pengertian.
understandable	ks. dapat dimengerti. -understandably kk. dapat dimengerti. he was u. angry at her dapat dimengerti bahwa ia marah kepadanya.
understate	kkt. 1 mengecilkan, menganggap (a matter, the case). 2 mengatakan kurang dari sebenarnya. to u. o's age mengatakan kurang dari umur yang sebenarnya.
understatement	kb. keterangan yang mengecilkan sesuatu persoalan.
understood	lih understand.
understudy	kb. (j. -dies) pengganti pelaku, pemain pengganti.
undertake	kkt. (undertook, undertaken) 1 menjalankan, melakukan (a job). 2 mengerjakan. 3 berusaha. -undertaking kb. 1 perbuatan, usaha. 2 pengusahaan. 3 perusahaan pemakaman.
undertaken	lih undertake.
undertaker	kb. seorang yang mengurus pemakaman.
underthings	kb., j. pakaian dalam.
undertone	kb. suara rendah/lunak. to talk in an u. bicara dengan suara lunak.
undertook	lih undertake.
undertow	kb. arus bawah (yang bertentangan arahnya dengan arus permukaan).
underwater	ks. di dalam air. u. demolition team regu perusak di dalam air.
underway	kk. 1 sedang berlangsung (of construction). 2 berlayar (of a ship).
underwear	kb. pakaian dalam.
underweight	ks. 1 berat terlalu rendah, terlalu ringan. 2 hangat (of merchandise).
underwent	lih undergo.
underworld	kb. 1 neraka. 2 dunia penjahat.
underwrite	kkt. (underwrote, underwritten) 1 mempertanggungkan, mengasuransikan. 2 menanggung (s.o's education).
underwriter	kb. penanggung (asuransi).
underwritten	lih underwrite.
underwrote	lih underwrite.
undeserved	ks. tidak semestinya diberikan (of punishment).
undeserving	ks. tak pantas mendapat.
undesirable	ks. 1 tak menyenangkan, jahat (of person). 2 tak diingini (of effect).
undetected	ks. tanpa diketahui. to pass by u. lewat tanpa diketahui.
undetermined	ks. tak dapat ditentukan. fire of u. origin kebakaran yang tak dapat dipastikan darimana asalnya.
undeveloped	ks. belum maju/berkembang. u. industry industri yang belum maju. u. land tanah yang belum dikerjakan.
undid	lih undo.
undies	kb., j. inf.: pakaian dalam wanita.
undigested	ks. belum dicernakan.
undignified	ks. kurang sopan, tidak pantas. in an u. manner dengan cara yang kurang terhormat.
undiplomatic	ks. tidak diplomatik, kurang bijaksana.
undisciplined	ks. tak disiplin/tertib (child, behavior).
undisguised	ks. tanpa tedeng aling-aling, tanpa disembunyikan, terang-terangan. to exhibit u. pleasure memperlihatkan kegembiraan tanpa disembunyikan.
undismayed	ks. tidak takut.
undisputed	ks. tak perlu dipersoalkan lagi (champion).
undisturbed	ks. tak terganggu.
undivided	ks. penuh, sepenuhnya. give me u. attention berikanlah perhatianmu yang sepenuhnya kepadaku.
undo	kkt. (undid, undone) 1 melepaskan, membuka (a knot). 2 membuka (o's jacket, a package). 3 merusak. -undone ks. terlepas. -undoing kb. keruntuhan, kehancuran.
undock	kkt. melepaskan dari galangan.
undone	lih undo.
undoubtedly	kk. niscaya. he's u. right pastilah ia benar.
undraped	ks. tak berpakaian, telanjang.
undreamed-of	ks. tak dimimpi-mimpikan (riches).
undress	kb. keadaan telanjang. -kkt. menanggalkan (s.o.). -kki. membuka / menanggalkan pakaian. -undressed ks. dilepaskan bajunya.
undue	ks. tak pantas, tak semestinya. (pressure, optimism).
undulate	kki. berombak-ombak. -undulating ks. berombak-ombak.
undulation	kb. gerak mengombak/menggelombang.
unduly	kk. terlalu. we were not u. alarmed at kami tidaklah terlalu terkejut oleh.
undying	ks. abadi, kekal (love).
uneaconomical	ks. tidak ekonomis, membuang-buang.
unearned	unearned
unearth	kkt. menggali, menemukan dengan panggalian.
unearthly	ks. 1 aneh, yang menakutkan (of appearance). 2 tak wajar. 5 a.m. is an u. hour to get up jam 5 pagi adalah waktu yang tak wajar untuk bangun.
uneasiness	kb. rasa gelisah/khawatir, kegelisahan.
uneasy	ks. gelisah, kuatir. i'm u. about their safety aku merasa gelisah akan keselamatan mereka. 2 tak tenang (of sleep, peace).
uneaten	ks. belum dimakan (food).
unedited	ks. belum diperiksa (manuscript, speech).
uneducated	ks. tak berpendidikan.
unemotional	ks. tak berperasaan.
unemployable	ks. tidak dipekerjakan.
unemployed	kb. the u. para penganggur. -ks. yang menganggur, tunakarya. he is u. ia mengganggur.
unemployment	kb. pengangguran, ketunakaryaan. u. insurance pertanggungan terhadap pengangguran.
unencumbered	ks. tak dibebani. u. by debts tak dibebani hutang-hutang.
unending	ks. tidak ada hentinya. u. stream of customers arus pembeli yang tak ada hentinya.
unenforceable	ks. tak dapat dilaksanakan/dijalankan (of law, ordinance).
unenterprising	ks. tak suka berusaha (of a person).
unenthusiastic	ks. tak tertarik (about kepada).
unenviable	ks. yang tak menimbulkan iri hati. to have an u. record of failures mengalami serentetan kegagalan yang tak menimbulkan iri hati.
unequal	ks. 1 tak sama. 2 tak seimbang. 3 tidak memadai/mencukupi.
unequaled	ks. tiada bandingnya/taranya. man of u. skill orang yang trampil tiada bandingnya.
unequivocal	ks. tegas, tak ragu-ragu. -unequivocal kk. dengan terang/tegas, tanpa ragu-ragu.
unerring	ks. 1 tepat (of aim). 2 tak pernah salah, selalu tepat (of instinct). 3 tak pernah menyimpang (of precision).
unesco, unesco, u.n.e.s.c.o.	[united nations educational, scientific and cultural organization] kb. unesco.
unessential	ks. tidak perlu begitu.
unethical	ks. tak pantas, tercela.
uneven	ks. 1 tak rata (of a surface). 2 tak seimbang (of a contest). 3 tak genap, ganjil (of a number). unevenly kk. tidak samarata.
unevenness	kb. 1 keadaan tidak rata (of a surface). 2 keadaan rtidak samarata (of contest).
uneventful	ks. tak banyak peristiwanya
unexcelled	ks. tak terkalahkan, tak pernah dikalahkan.
unexciting	ks. tanpa kegirangan/semangat, tanpa kegairahan hidup. to lead an u. life hidup tanpa kegembiraan.
unexpected	ks. tak diduga-duga/disangka-sangka (visit). -unexpectedly kk. dengan tak diduga-duga.
unexpired	ks. belum habis waktunya (term, lease).
unexplained	ks. tak diterangkan. for some u. reason karena sesuatu alasan yang tak dijelaskan.
unexploded	ks. belum meledak (shell).
unexplored	ks. belum diselidiki (cave).
unexpurgated	ks. yang belum dibersihkan, yang sempurna (edition).
unfailing	ks. 1 tak habis-habisnya/putus-putus (help). 2 tak kunjung padam (hope). 3 yang terus-terusan, tak pernah terhenti (of water supply). 4 pasti (of proof).
unfair	ks. 1 secara tak wajar. to take u. advantage of menarik keuntungan secara tak wajar dari. 2 curang. u. trick muslihat curang. -unfairly kk. tanpa keadilan.
unfaithful	ks. tak setia, serong (of a spouse) to be u. to o's wife tidak setia terhadap istrinya.
unfaithfulness	kb. ketidaksetiaan, keserongan.
unfamiliar	ks. 1 tak biasa/lazim (of a sight). 2 tidak kenal (of a face). to be u. with latin tak pandai/mengetahui bahasa latin.
unfashionable	ks. tidak menurut mode.
unfasten	kkt. membuka.
unfathomable	ks. tak dapat diduga.
unfavorable	ks. tak baik/menguntungkan.
unfettered	ks. tak terkekang.
unfinished	ks. 1 belum dipolitur (of furniture). 2 belum selesai. u. business pekerjaan yang belum selesai.
unfit	ks. tak cakap (for a task). 2 tak pantas/layak. u. for human use tidak layak untuk dipakai manusia.
unfitted	ks. tidak pantas/cocok (for untuk).
unflagging	ks. tak kunjung padam, tak putus-putus. u. encouragement dorongan semangat yang tak kunjung padam.
unflappable	ks. inf.: tak dapat diganggu/terganggu.
unflattering	ks. 1 tak enak (didengar) (of a statement). 2 tak menyenangkan.
unflinching	ks. tetap tabah, pantang mundur.
unfold	kkt. 1 membuka (a napkin). 2 membuka, membantangkan (a blanket). -kki. 1 terhampar, terbentang (of a view). 2 berkembang (of a bud).
unforeseen	ks. tak terduga, yang tak dapat diduga. (of circumstances, expenditures).
unforgettable	ks. tak dapat dilupakan.
unforgivable	ks. tak dapat diampuni, tak berampun.
unforgiving	ks. tak mau/bersedia mengampuni.
unfortunate	kb. orang yang nasibnya sial. -ks. 1 sungguh sial (of an accident). 2 yang patut disayangkan (statement). -unfortunately kk. sayang, sial sekali/benar.
unfounded	ks. tak berdasar (of a rumor).
unfriendliness	kb. kemasaman, sifat tidak ramah, sifat permusuhan/seteru.
unfriendly	ks. tak (pe)ramah.
unfrock	kkt. memecat dari jabatan pendeta.
unfulfilled	ks. tak dipenuhi/ditepati (of a promise).
unfurl	kkt. membabarkan, membentangkan (a flag).
unfurnished	ks. tak berperabot, tak ada perkakas rumah tangga (of an apartment).
ungainly	ks. kaku, canggung.
ungodly	ks. tak beriman. 2 inf.: yang amat mengganggu, yang amat menjengkelkan (noise). 3 inf.: tak keruan. 4 inf.: keterlaluan, luar biasa, gila-gilaan (of price).
ungovernable	ks. tak terkendalikan, tak dapat dicegah (rage).
ungraceful	ks. tak lincah/gemulai/luwes, kaku.
ungracious	ks. tak sopan/halus, kasar (of a remark).
ungrammatical	ks. tak menurut ilmu tatabahasa.
ungrateful	ks. tak berterima kasih (for atas).
ungrudging	ks. ramah, sukarela, spontan (of praise). -ungrudgingly kk. dengan ramah/sukarela/spontan.
unguarded	ks. tak dijaga (of a railway crossing). 2 lengah. in an u. moment pada saat lengah.
unguent	kb. salep, obat luaran untuk luka-luka dsb.
unguote	lih quote.
unhampered	ks. tak dirintangi.
unhappiness	kb. ketidakbahagiaan.
unhappy	ks. 1 tak bahagia. 2 tak tepat. u. choice pilihan yang disayangkan. -unhappily kk. 1 tak bahagia. 2 sayangnya, sialnya.
unharmed	ks. tanpa (menderita) luka-luka.
unharness	kkt. melepaskan (a horse, energy).
unhealthy	ks. 1 tak sehat (person, climate, area). 2 yang tidak sehat (complexion).
unheard-of	ks. 1 belum dikenal. 2 tak pernah kejadian. such a thing is u. hal demikian belum pernah terjadi. 3 keterlaluan (of price).
unheated	ks. tak dipanasi, tanpa pemanasan.
unhesitatingly	kk. dengan tak ragu-ragu, tanpa ragu-ragu.
unhindered	ks. dengan tak dirintangi.
unhinge	kkt. 1 melepaskan dari engsel (a door). 2 menggusarkan (o's mind).
unhitch	kkt. melepaskan dari pasangan.
unholy	ks. inf.: keterlaluan (of price).
unhook	kkt. melepas kaitan.
unhoped-for	ks. tak diharap-harap.
unhurried	ks. tidak keburu/tergesa-gesa, pelan-pelan.
unhurt	ks. tanpa cedera/luka, selamat. to escape u. terhindar/lolos tanpa cedera.
unicameral	ks. (berbentuk) tunggal. u. legislative body badan tunggal pembentuk undang-undang.
unidentified	ks. tak dikenal.
unification	kb. penyatuan, penggabungan.
unifier	kb. pemersatu.
uniform	kb. pakaian seragam. to be in u. berpakaian seragam. -ks. 1 seragam (of regulations, measurements). 2 sama. -kkt. menyeragamkan. -uniformed ks. 1 berseragam. 2 yang berpakaian seragam (of a guard). -uniformly kk. u. polite secara keseluruhan ramah-tamah.
uniformed	ks. 1 tak diberi tahu. 2 tak mengetahui.
uniformity	(j. -ties) kb. keseragaman. to strive for u. berusaha supaya tercapai keseragaman.
unify	kkt. (unified) mempersatukan, menyatukan.
unilateral	unilateral
unimaginative	ks. tanpa fantasi.
unimpaired	ks. tak terhalang/tercatat (of senses). u. health kesehatan yang baik. u. strength kekuatan yang tak berkurang.
unimpeachable	ks. 1 yang tak tercela, yang tak ada cacatnya (of reputation). 2 tak dapat disangsikan (of source).
unimpeded	ks. tidak dirintangi, tanpa rintangan.
unimportant	ks. tak penting, remeh.
uninhabitable	ks. tak dapat didiami.
uninhabited	ks. tak didiami/berpenghuni.
uninitiated	ks. orang yang belum tahu/kenal.
uninjured	ks. tanpa (menderita) luka.
uninspired	ks. tak bersemangat/bergairah.
uninspiring	ks. tak membangkitkan semangat.
unintelligible	ks. tak dapat dipahami.
unintentional	ks. tak disengaja. -unintentionally kk. tanpa (di)sengaja.
uninterested	ks. tak tertarik (in pada).
uninteresting	ks. tak menarik (perhatian).
uninterruptedly	kk. tak henti-hentinya/putus-putus.
uninviting	ks. tak menarik.
union	kb. penyatuan, perpaduan. u. of hydrogen and oxygen perpaduan hidrogen dan oksigen. 2 serikat sekerja. 3 koperasi. 4 (wedlock) perkawinan.
unionize	kkt. membentuk serikat sekerja.
unique	ks. unik, khas, khusus. u. specimen unikum.
uniqueness	kb. keunikan.
unison	kb. persesuaian. in u. berbareng, serentak. to act in u. with s.o. bertindak serempak dengan seseorang.
unit	kb. 1 kesatuan. military u. kesatuan militer. to work as a u. bekerja sebagai kesatuan. 2 satuan (of measure).
unite	kkt. mempersatukan. -kki. bersatu. -united ks. bersatu.
unity	kb. (j. -ties) persatuan, kesatuan.
univ.	[university] universitas.
universal	kb. universil. -ks. 1 universil. 2 sedunia. 3 semesta, dunia. 4 bersama. -universally kk. he is u. liked ia disukai diseluruh dunia.
universe	kb. alam semesta. 2 seluruh bidang. the u. of discourse seluruh bidang diskusi.
university	kb. (j. -ties) universitas. u. extension penyuluhan universitas.
unjust	ks. tak adil. -unjustly kk. dengan tidak adil.
unjustifiable	ks. tak dapat dibenarkan. -unjustifiably kk. dengan tak dapat dibenarkan.
unjustified	ks. tidak tepat, tidak pada tempatnya.
unkempt	ks. tak disisr (of hair). 2 tak dipelihara/rapi (of clothes, appearance).
unkind	ks. tidak enak, kasar, kejam. that's very u. of him sikapnya itu sangat bengis.
unknowingly	kk. tanpa mengetahui.
unknown	kb. 1 math.: hal yang tak diketahui, anu. 2 hal yang tak dikenal. -ks. yang tak dikenal.
unlace	kkt. melepas/membuka tali.
unladylike	ks. tidak wajar bagi seorang wanita terhormat.
unlatch	kkt. membuka pasak/kancing.
unlawful	ks. tak syah. u. assembly berkumpul yang tidak syah.
unlearn	kkt. belajar meninggalkan (old habits).
unleash	kkt. melepaskan tali.
unless	ksam. 1 kecuali kalau. i can't go u. i.... aku tak dapat pergi kecuali kalau aku..... 2 kalau. we'll go u. it rains kita akan pergi kalau tidak hujan.
unlicensed	ks. tanpa rebewes. u. driver pengendara mobil tanpa rebewes/sim.
unlighted	ks. tak berlampu (street).
unlike	ks. tak sama, tak serupa. the figures are u. angka-angka itu tak sama.
unlikelihood	kb. ketidakmungkinan.
unlikely	ks. tak mungkin. in the u. event that... dalam keadaan yang tak mungkin akan terjadi... 2 tak dapat dipercaya. an u. story cerita yang tak dapat dipercaya.
unlimber	kkt., kki. mempersiapkan diri, bersiap-siap.
unlimited	ks. tak terbatas, tak ada batasnya.
unlisted	ks.tak terdaftar (of telephone number).
unload	kkt. 1 membongkar (muatan) (cargo). 2 mencurahkan, melimpahkan. -kki. membongkar muatan. -unloaded ks. yang tidak diisi (gun).
unlock	kkt. membuka kunci. to u. a door membuka kunci pintu. -unlocked ks. tidak dikunci (door).
unloosen	kkt. melepaskan (tie, belt).
unlucky	ks. malang, sial, celaka. to be u. tidak mujur.
unmade	ks. belum dirapikan (bed).
unman	kkt. (unmanned) menghilangkan keberanian, mematahkan semangat. -unmanned ks. tak berawak. u. space vehicle pesawat ruang angkasa yang tak berawak.
unmanageable	ks. 1 tak dapat dikendalikan/diatur (of a child). 2 terkendalikan/tak dapat dikuasai (of a ship).
unmanly	ks. tidak jantan, pengecut.
unmarked	ks. tak ditandai, tak dibubuhi tanda (car, money).
unmarried	ks. belum kawin. she's u. ia tak bersuami. he's u. ia tak beristri.
unmask	kkt. membuka kedok.
unmatched	ks. tak ada taranya, tiada bandingan, tak dapat dibandingi.
unmentionable	kb. unmentionables j. pakaian dalam wanita. -ks. tak dapat disebut, tak pantas disebut-sebut.
unmercifully	kk. dengan tak kenal ampun.
unmindful	ks. u. of tak menghiraukan/memusingkan.
unmistakable	ks. terang, jelas, tak dapat diragukan. the resemblance is u. kemiripan itu jelas sekali.
unmitigated	ks. 1 sejati, sempurna, penuh. u. pleasure kegembiraan yang sejati. 2 tak tanggung-tanggung, tak kepalang tanggung (harshness).
unmolested	ks. tanpa gangguan.
unmounted	ks. tak berbingkai, lepas (of photo).
unmoved	ks. 1 teguh, tak berubah. 2 tidak terharu.
unnamed	ks. tak dikenal, tak berubah. 2 tidak terharu.
unnatural	ks. tak wajar (act). it's u. to... adalah tak wajar untuk...
unnecessary	ks. tak perlu, tak ada gunanya. -unnecessarily kk. tanpa guna, dengan tak ada guna, tidak seharusnya/semestinya, tak perlu/usah.
unnerve	ks. mengerikan, membuat bingung. -unnerved ks. terkesima. -unnerving ks. melemahkan, melemaskan.
unnoticed	ks. tak ketahuan, tak menarik perhatian. to go u. tidak diperhatikan.
unnumbered	ks. 1 tak terhitung jumlahnya. 2 tidak bernomor, tidak diberi/memakai nomor (or pages).
unobstructed	ks. tak terhalang, tanpa halangan (of a view).
unobtainable	ks. tak dapat diperoleh.
unobtrusive	ks. rendah hati.
unoccupied	ks. 1 tak didiami (of a room, house) . 2 terima kosong (in advertiements).
unopened	ks. tak dibuka (of a letter).
unopposed	ks. tak ada lawan/penentang/rintangan.
unorganized	ks. tak tersusun/teratur/diatur.
unorthodox	ks. tak lazim, menyimpang dari kebiasaan.
unostentatious	ks. sederhana, bersahaja.
unpack	kkt. membongkar, membuka, menggosongkan (a trunk).
unpaid	ks. belum/tak dibayar (bill).
unpalatable	ks. tidak enak/menyenangkan.
unparalleled	ks. tak terpadai, tak ada bandingannya (opportunity).
unpardonable	ks. tak dapat diampuni.
unpatriotic	ks. tidak patriotik.
unpaved	ks. tak beraspal (road).
unperturbed	ks. tidak gentar/gelisah.
unpin	kkt. (unpinned) membuka peniti.
unpleasant	ks. tak enak/menyenangkan. -unpleasantly kk. tidak menyenangkan.
unpleasantness	kb. 1 keadaan yang tak menyenangkan. 2 persengketaan.
