fluorescent	ks. berpendar, berpijar. f. lamp/light lampu berpendar, lampu neon/tl, lampu pijar.
fluoridation	kb. hal pemberian/pembubuhan fluor kepada air minum.
fluoroscope	kb. fluoroskop.
flurry	kb. (j. -ries) 1 kesibukan/keributan yang tiba-tiba, kebingungan. 2 hujan/salju yang tiba-tiba. -kkt. (flurried) membingungkan. she became flurried dia menjadi bingung.
flush	kb. 1 gejolak, gelora. 2 semangat, kesegaran. 3 cahaya kemerah-merahan. -ks. 1 pemurah, royal. 2 sama rata/tinggi. -kk. tepat. -kkt. 1 mendirus, menyiram, membilas. 2 menyiram. -flushing kb. pembilasan (of drain, toilet).
fluster	kkt. membingungkan. to became flustered menjadi bingung.
flute	kb. 1 mus.: suling, seruling (logam). 2 arch.: galur.
fluted	ks. yang bergalur. f. coloumn tiang yang bergalur.
flutist	kb. pemain suling logam.
flutter	kb. 1 kibaran (of a flag). 2 kegugupan, kebingungan. 3 kegemparan. 4 debar, denyut. -kkt. 1 mengedip-ngedipkan. 2 mengipas- ngipaskan.-kki 1 berkibar. 2 berjela-jela (of a kite).
flux	kb. perubahan yang terus-menerus. 2 pengaliran darah atau air dalam tubuh.
fly	kb. 1 lalat. 2 golbi, tutup luar (of trousers). 3 fish.: mata pancing yang berumpan seperti serangga terbang. -kkt. (flew, flown) 1 menerbangkan 2mengemudikan. 3 mengibarkan. -flying kb. naik kapal terbang. ks. terbang.
flycatcher	kb. burung penangkap serangga.
flyer	kb. 1 pilot, penerbang. 2 inf.: percobaan. i once took a f. at insurence saya pernah mencoba bekerja dalam bidang asuransi. 3 inf.: pamflet.
flyleaf	kb. halaman buku paling depan yang tak tercetak.
flypaper	kb. kertas pelekat/perekat untuk menangkap lalat.
flyspeck	kb. tahi lalat.
flyswatter	kb. pemukul lalat.
flyweight	kb. box.: kelas terbang.
flywheel	kb. rodagaya, rodaberat, rodagendeng.
fm, f.m.	[frequency modulation] modulasi frekwensi.
fn.	[footnote] catatan dibawah halaman buku.
foal	kb. anak kuda. -kki. beranak (kuda).
foam	kb. 1 busa (from the mouth). 2 buih, busa. (of beer). -kki. 1 berbusa. 2 berbuih. f. rubber karet busa. -foamy ks. berbuih, berbusa (seperti bir, sabun dsb).
focus	kb. 1 titik api. 2 pusat. 3 med.: sarang (of infection). -kkt. 1 memusatkan. 2 menyetel lensa. -kki melihat dengan jelas.
fodder	kb. makanan hewan/ternak.
foe	kb. musuh, lawan.
foetal	= fetal.
foetus	= fetus.
fog	kb. kabut. f. bank dinding kabut. -kkt. (fogged) mengaburkan. to f. over/up menutup dengan kabut. f. light lampu (kuning) untuk menembus kabut.
fogbound	ks. terhalang oleh kabut.
fogey	kb. = fogy.
foggy	ks. berkabut. it's f. outside diluar kabut tebal.
foghorn	kb. peluit kabut.
fogy	kb. (j. -gies) orang yang sangat kolot.
foible	kb. kelemahan, kekurangan.
foil	kb. 1 kertas perak/timah. 2 sport : pedang untuk main anggar. -kkt. menggagalkan. to f. an attempt menggagalkan usaha.
foist	kkt. 1 menyelinapkan, menyisipkan tanpa diketahui. 2 menipu, mengibuli.
fold	kb. lipatan. -kkt. 1 melipat. 2 membungkus. -kki, tutup, gulung tikar. to f. back membalik. to f.in mengaduk. fold-away ks. lipatan, yang dapat dilipat. -folding ks. lipat(an), yang dapat dilipat.
folder	kb. 1 map, berkas. 2 brosur. travel f. brosur pariwisata.
foliage	kb. daun-daunan.
folio	kb. folio.
folk	kb. rakyat, bangsa. inf.: folks j. 1 sanak saudara, pamili. 2 orang - orang. f. song lagu rakyat. f. tales dongeng-dongeng rakyat.
folklore	kb. dongeng-dongeng, cerita-cerita, cerita rakyat.
folksy	ks. inf.: ramah-tamah, sederhana.
follicle	kb. kantung (rambut).
follow	kkt. 1 mengikuti. 2 menuruti. -kki. 1 terjadi, terdapat. 2 menyusul. 3 mengikuti. 4 menyusul. as follows sebagai berikut. follow-up kb. tindakan lanjutan, penyelenggaraan berikutnya. -following kb. pengikut - pengikut.
follower	kb. pengikut, penyokong.
folly	kb. (j. -lies) kebodohan, ketololan, kegoblokan.
foment	kkt. menimbulkan, menggerakkan. to f. trouble menimbulkan kekacauan.
fond	ks. sangat cinta. a f. father ayah yang sangat mencintai. to be f. of gemar. -fondly kk. sayang, kasih. to feel f. towards sayang kepada.
fondle	kkt. memanjakan, menimang.
fondness	kb. kesukaan, kemesraan, kegandrungan, kegemaran. a f. for kegandrungan kepada.
font	kb. 1 bak. 2 print.: fon, satu stel lengkap huruf cetakan yang sama jenis dan ukurannya.
food	kb. 1 makanan. f. and drink makanan dan minuman. 2 masakan. f. and clothing sandang pangan. f. for thought bahan untuk dipikirkan.
foodstuff	kb. bahan makanan.
fool	kb. 1 goblok, tolol. 2 orang gila. -kkt. mengelabui. -kki. berolok-olok. to f. around bermain-main. to f. away bermain-main dengan, mempermain - mainkan.
foolhardy	ks. gila-gilaan, membabi-buta.
foolish	ks. 1 bodoh, tolol. 2 nekad. -foolishly kk. dengan tolol. i f. agreed... bodoh benar saya menyetujui...
foolishness	kb. ketololan, kedunguan, kegoblokan.
foolproof	ks. sangat mudah dan aman sehingga seorang tololpun dapat menjalankannya/memakainya.
foolscap	kb. kertas folio.
foot	kb. (j. -feet) 1 kaki. 2 suku. -feet j. kaki. -kkt. berjalan kaki. foot-ang- mouth disease penyakit kuku dan mulut. -footing kb. pijakan, tempat berpijak.
footage	kb. panjangnya, ukuran panjang.
football	kb. football.
footbridge	kb. titian.
footgear	kb. alas kaki.
foothill	kb. bukit di kaki gunung.
foothold	kb. tumpuan, tempat berpijak, kedudukan. to get a f. in business mendapat kedudukan dalam dunia usaha.
footlights	kb., j. lampu yang menyoroti para pemain.
footlocker	kb. kopor besi.
footloose	kb. bebas untuk pergi kemana-mana atau mengerjakan apapun.
footman	kb.( j.-men) pelayan laki-laki, bujang.
footnote	kb. catatan dibawah halaman buku/majalah.
footpath	kb. jalan kecil/setapak.
footprint	kb. bekas jejak kaki.
footrest	kb. ganjal/penunjang kaki.
footsie	kb. sl.: 1 bercumbu-cumbuan secara diam-diam. to play f. beneath the table bercumbu-cumbuan dibawah meja. 2 sl.: bekerjasama (secara rahasia diam-diam).
footsore	ks. sakit kaki.
footstep	kb. langkah (kaki).
footstool	kb. ganjal/penunjang kaki.
footwear	kb. alas kaki.
footwork	kb. cara mengatur kaki.
fop	kb. pesolek.
foppish	ks. yang berhubungan dengan pesolek. he has f. manners dia bergaya pesolek.
for	kd. 1 untuk. 2 bagi. 3 selama. 4 atas. 5 karena. 6 ke. 7 terhadap. 8 supaya, agar. 9 jika. 10 demi. f. a long time lama, dalam waktu yang lama, dalam jangka waktu yang panjang. -ksamb. karena. f. sale akan dijual.
for.	[foreign] asing, luar negeri.
forage	kb. makanan hewan/ternak. f. crops tanaman makanan ternak. -kki. pergi kesana-kemari mencari makanan.
foray	kb. penggerebekan untuk perampasan, perampokan, penggarongan.
forbad(e)	lih forbid.
forbear	kki. (forbore, forborne) menahan diri, mengelak, bersabar hati. -forbearing ks. sabar, suka menahan hati/nafsu.
forbearance	kb. kesabaran, penahanan (nafsu).
forbid	kkt. (forbad(e), forbid(den) ) melarang. -forbidden ks. yang terlarang. f. fruit buah yang terlarang. -forbidding ks. yang menakutkan. he has a f. look wajahnya menakutkan.
forbore	lih forbear.
forborne	lih forbear.
force	kb. 1 kekuatan. 2 tenaga. 3 angkatan 4 gaya. -kkt. memaksa. f. force-feed memaksa menelan, mencekoki, memberi makan dengan paksa. -forced ks. 1 terpaksa. 2 dibuat-buat, dibikin-bikin.
forceful	ks. kuat. f. leader pemimpin yang kuat.
forceps	kb. gunting tang (dipakai di kedokteran).
forcible	ks. dengan memakai kekerasan secara paksa.
ford	kb. arungan. -kki. mengarungi/menyebrangi (a river).
fore	kb. bagian depan. to the f. kedepan. -ks. depan, muka. in the part of the building di bagian depan gedung itu.
forearm	kb. lengan bawah. forewarned is forearmed diberitahu sebelumnya berarti siap.
forebear	kb. nenek moyang.
forebode	kkt. meramalkan, memberi pertanda. -foreboding kb. ramalan, persangkaan, firasat. i had a f. that... saya mempunyai firasat bahwa...
forecast	kb. ramalan. weather f. ramalan cuaca. -kkt. meramalkan. to f. a victory for meramalkan kemenangan bagi. -forecasting kb. (pe)ramalan.
forecaster	kb. peramal cuaca, tukang ramal.
forecastle	kb. bangunan atas yang dimuka (pada kapal).
foreclose	kki. menyita, menutup, mencabut hak untuk menebus hutang.
foreclosure	kb. penutupan, penyitaan. f. on the property penutupan menebus harta, pencabutan hak menebus harta.
foredoom	kkt. mentakdirkan sebelumnya.
forefather	kb. nenek moyang.
forefinger	kb. (jari) telunjuk.
forefont	kb. front/garis terdepan.
forego	(forewent, foregone).= forgo -foregone ks. yg dulu-dulu, yg terdahulu.-foregoing ks. yg terlebih dahulu.
foregone	lih forego.
foreground	kb. bagian (ter)depan, latar depan. the man in the f. is my father laki-laki di bagian depan itu ayahku.
forehand	kb. tenn.: pukulan forhen.
forehead	kb. dahi.
foreign	ks. 1 luar negeri. f. affair urusan-urusan luar negeri. 2 asing, yang datang dari luar. foreign-born ks. keturunan asing. foreign-made ks. bikinan luar negeri.
foreigner	kb. orang asing.
foreleg	kb. kaki-depan.
forelock	kb. gombak. to take time by the f. merencanakan/bersiap-siap sebelumnya, mengerjakan dalam waktu yang cukup.
foreman	kb. (j. -men) mandor, kepala tukang, werekbas.
foremost	ks. terkemuka, terutama, terpenting. the country's f. stateman negarawan yang paling terkemuka di negeri itu.
forenoon	kb. pagihari, sebelum tengah hari.
forensic	ks. yang berhubungan dengan kehakiman dan peradilan. f. medicine jurisprudensi kedokteran.
forerunner	kb. 1 pelopor. 2 pratanda. a dark cloud may be the f. of the storm awan hitam mungkin pertanda hujan.
foresaw	lih foresee.
foresee	kkt. (foresaw, foreseen) meramalkan (the difficulties).
foreseeable	ks. yang dapat diduga, yang dapat diketahui dari sekarang. i expect to go in the f. future saya tidak mengharapkan akan pergi dalam waktu mendatang yang dapat diduga.
foreseen	lih foresee.
foreshadow	kkt. memberi pertanda, membayangkan.
foresight	kb. tinjauan ke masa depan.
foreskin	kb. kulup, kulit khatan.
forest	kb. hutan, rimba. f. fire kebakaran hutan. f. ranger polisi kehutanan.
forestall	kkt. mencegah.
forester	kb. rimbawan.
forestry	kb. ilmu kehutanan.
foretaste	kb. rasa pendahuluan.
foretell	kkt. (foretold) meramalkan.
forethought	kb. 1 pemikiran sebelumnya. 2 pemikiran ke masa depan.
foretold	lih foretell.
forever	kk. selalu, selama-lamanya, senantiasa. f. and ever untuk selama-lamanya.
forevermore	kk. untuk selama-lamanya.
forewarn	kkt. memperingati terlebih dahulu.
forewent	lih forego.
foreword	kb. prakata, prawacana, kata pendahuluan.
forfeit	kb. 1 denda, penebusan. 2 kehilangan. to f. a friendship kehilangan persahabatan. 2 mengorbankan. to f. o's life in a rebellion mengorbankan nyawanya dalam pemberontakan.
forgave	lih forgive.
forge	kb. tempat bekerja pandai besi. -kkt. 1 menempa. to f. on iron bar menempa sebatang besi. 2 memalsukan. to f. o's name on a check memalsukan namanya pada cek. to f. a head maju sedikit demi sedikit. -forging kb. tempaan, benda tempa, hasil tempaan.
forgene	lih forgo.
forger	kb. 1 pemalsu. 2 pandai besi.
forgery	kb. (j. -ries) pemalsuan (tanda tangan lukisan, naskah).
forget	kkt. (forgot, forgotten). lupa, melupakan. to f. o.s. mengabaikan kepentingan pribadi. forget-me-not. kb. semacam tanaman.
forgetful	ks. pelupa.
forgetfulness	kb. kelalaian.
forgive	kkt. (forgave, forgiven) memaafkan, mengampuni. f. me for being late maafkan atas kelambatanku. -forgiving ks. mudah memberi maaf. she's very f. dia mudah sekali memberi maaf.
forgiven	lih forgive.
forgiveness	kb. keampunan, tindakan memaafkan, kemauan mengampuni.
forgo	kkt. (forwent, forgone) tidak jadi melakukan sesuatu. she decided to f. the movies and study dia memutuskan untuk tidak (lagi) menonton film, melainkan belajar. = forego.
forgot	lih forget.
forgotten	lih forget.
forhcoming	ks. 1 yang datang. no compliment was f. tak ada pujian yang datang. 2 yang akan datang. f. election pemilihan yang akan datang.
fork	kb. 1 garpu. 2 percabangan menjadi dua, cabang, pertigaan. 3 anak sungai. -kki. bercabang menjadi dua. -forked ks. yang bercabang dua.
forkful	kb. segarpu penuh. sepenuh garpu.
forlorn	ks. sedih. f. hope harapan yang sangat tipis akan berhasil.
form	kb. 1 bentuk. 2 formulir, surat isisan. 3 kondisi. -kkt. 1 membentuk. 2 merupakan. 3 memperoleh. -kki. terbentuk. f. letter surat selebaran/edaran. f. of address tutursapa, bentuk/cara berbicara/menegur pada orang lain.
formal	kb. rok wanita untuk malam, gaun malam. -ks. 1 resmi, formil. 2 kaku. 3 mengenai bentuknya. -formally kk. dengan resmi. to receive f. menerima dengan/secara resmi.
formaldehyde	kb. formaldehida
formalism	kb. formalisme
formality	kb. (j. -ties) 1 formalita(s), sikap yang kaku. 2 upacara, acara resmi.
formalize	kkt. menyusun, membentuk, merumuskan. to f. o's thoughts menyusun pikirannya.
format	kb. 1 format, ukuran. a book's f. format buku. 2 pola, susunan, bentuk. what is the f. of the tv show ? bagaimana pola pertunjukan tv itu?
formation	kb. 1 pembentukan f. of a new group membentuk kelompok baru. 2 mil.: formasi. 3 bentukan, formasi.
formative	ks. yang berhubungan dengan pertumbuhan atau perkembangan. the f. years tahun-tahun pertumbuhan.
former	ks. 1 yang terlebih dahulu, yang tadi. 2 bekas, eks-, ex- my f. employer bekas majikanku. -formely kk. tadinya, dahulu.
formic	ks. f. acid asam-semut/formiat.
formidable	ks. hebat, berat. he's a f. opponent dia lawan yang hebat.
formula	formula
formulate	kkt. merumuskan.
formulation	kb. perumusan.
fornicate	kki. bersetubuh diluar nikah, berzina.
fornication	kb. perbuatan zina, persetubuhan diluar nikah.
forsake	kkt. (forsook, forsaken) meninggalkan, mengabaikan. to f. home and family meninggalkan rumah dan keluarga.
forsaken	lih forsake.
forseeable	= foreseeable.
forsook	lih forsake.
forswear	kkt. (forswore, forsworn) bersumpah untuk menghentikan. to f. o.s. makan sumpah, bersumpah palsu.
forswore	lih forswear.
forsworn	lih forswear.
forsythia	kb. semacam bunga.
fort	kb. benteng, kubu pertahanan. to hold the f. 1 bertahan. 2 meneruskan.
forte	kb. keahlian. cooking is his f. memasak adalah keahliannya.
forth	kk. seterusnya. from that day f. dari hari itu seterusnya, mulai dari hari itu. to come f. maju, tampil kedepan. to go f. keluar, pergi. and so f. dan sebagainya.
forthright	ks. jujur, terus-terang, blak-blakan.
fortieth	ks. yang keempat puluh. f. anniversary ulang tahun keempat puluh.
fortification	kb. kubu (pertahanan).
fortified	lih fortify.
fortifies	lih fortify.
fortify	kkt. (fortified) membangun benteng. to f. a city membangun benteng sekeliling kota. -fortified ks. yang diperkuat pertahanannya, dibentengi. f. area daerah yang dibentengi.
fortitude	kb. ketabahan, keuletan.
fortnight	kb. dua minggu. -fortnightly kb., ks., kk. dua-mingguan, sekali dua minggu.
fortress	kb. benteng.
fortuitious	ks. secara kebetulan saja. f. encounter perjumpaan yang kebetulan saja.
fortunate	ks. untung. f. break kejadian yang menguntungkan.
fortune	kb. 1 untung, nasib baik. i had the good f. saya beruntung. 2 kekayaan. he made his f. in oil dia menjadi kaya karena minyak.
fortuneteller	kb. ahli nujum, tukang tebak/tenung /tilik/ramal.
fortwith	kk. dengan segera.
forty	kb. (j. -ties) empat puluh. inf.: f. winks tidur sebentar. forty-five kb. 1 empet puluh lima. 2 repolper kaliber 45. 3. mus.: piringan hitam putaran 45.
fortyish	ks. sekitar 40-an tahun.
forum	kb. 1 musyawarah, majelis. 2 mimbar. 3 para pendengar.
forward	kb. soc.: pemain depan. -ks. 1 muka depan. f. section bagian muka. 2 progresip. 3 lancang. -kk. to come/go/step f. maju/tampil kedepan. -kkt. menyampaikan, meneruskan, mengirimkan terus (a letter, suggestion) forward-looking ks. memandang kedepan.
forwent	lih forgo.
fossil	kb. fosil. he's an old f. ia berpaham kolot.
foster	kkt. membantu perkembangan. the church fosters a youth group gereja itu membantu perkembangan perkumpulan pemuda.
fought	lih fight.
foul	kb. 1 kecurangan, pelanggaran.2 sport: penalti, hukuman.-ks.1 kotor 2 buruk.3 busuk.4 curang.-kk. to run f. of the law melanggar hukum.-kkt.1 mengotori.2 mencemarkan3 menyangkutkan.inf. : to f. up1 mengacau-balaukan.foul-minded ks.berpikiran keji
found	kkt. mendirikan.
foundation	kb. yayasan 2 pondasi, fondamen 3 dasar.
founder	kb. pendiri. 2 (metals) tukang cor.-kkt.1 tenggelam 2 terperosok.
foundling	kb.bayi terlantar, bayi yg diketemukan.
foundry	kb. (j.-ries) penuangan, pengecoran logam.
fount	kb. sumber.
fountain	kb. air mancur.2 kran.3 sumber.he's a f of information dia sumber informasi. soda f. tempat penjualan minuman dan eskrim.
fountainhead	kb. 1 asal, sumber asli. 2 sumber atau mata-air sebuah sungai.
four	empat. four-engined ks. bermotor empat. four-flusher kb. pembual. four-footed ks. berkaki empat. four-star ks. berbintang-empat. four- wheel ks. berempat roda.
fourfold	ks. rangkap empat. f. path jalan yang rangkap empat. -kk. empat kali lipat/ganda. production has been increased f. produksi telah ditingkatkan empat kali lipat.
fourscore	kb. delapan puluh. f. and ten sembilan puluh.
foursome	kb. sekelompok yang terdiri dari empat orang (in golf, bridge).
foursquare	ks. empat persegi. -kk. tegap, kokoh. to stand f. against menghadapi keadaan dengan tabah.
fourteen	kb., ks. empat belas.
fourteenth	ks. yang keempat belas.
fourth	ks. yang keempat. on the f. of july pada tanggal empat juli. fourth-class matter barang kelas 4 (of mail). the f. estate golongan wartawan.
fowl	kb. unggas.
fox	kb. rubah. he's sly as a f. dia secerdik kancil. -kkt. inf.: menipu secara licik. f. terrier sejenis anjing. f. trot dansa fox trot.
foxhole	kb. lubang perlindungan.
foxy	ks. licik, lihay.
foyer	kb. serambi, tempat menunggu.
fr.	[franc] 1 mata uang perancis, belgia dan swiss. 2 [from] dari.
fracas	kb. perkelahian, pertengkaran.
fraction	kb. 1 pecahan. his fraction are wrong hitungan pecahannya salah. 2 sedikit. i need a f. more dirt saya perlukan tanah sedikit lagi.
fractional	ks. kecil. a f. part sebagian kecil.
fractious	ks. rongseng, cengeng, suka mengomel. f. child anak yang cengeng.
fracture	kb. patah, retak. f. of the arm patah tulang lengan. -kkt. mematahkan.
fragile	ks. gampang/mudah pecah. f., handle with care barang pecah - belah, hati-hati. awas gelas, hati-hati.
fragility	kb. kerapuhan, kelemahan.
fragment	kb. 1 fragmen. 2 pecahan, penggalan. 3 sedikit-sedikit -kkt. memotong-motong, membagi menjadi kepingan-kepingan.
fragmentary	ks. tidak lengkap, terpisah-pisah. the evidence is f. bukti itu tidak lengkap.
fragmentation	kb. pemecahan menjadi kepingan.
fragrance	kb. bau wangi, keharuman.
fragrant	ks. harum, wangi, semerbak.
frail	ks. lemah.
frailty	kb. (j.-ties) kelemahan (moril).
framb(o)esia	kb. patek.
frame	kb. 1 bingkai. 2 bingkai, lis. (of a picture). 3 kerangka (of a house). 4 kosen (of a window). 5 badan. -kkt. 1 memasang lis pada (a picture). 2 menyusun. 3 sl.: menjebak. frame-up kb.tuduhan palsu. -framing kb. 1 pemasangan (lis). 2 penyusunan, susunan
framer	kb. 1 pembuat, penyusun. f. of the constitution pembuat uud. 2 tukang lis/bingkai.
framework	kb. 1 rangka. 2 kerangka.
france	kb. negeri perancis.
franchise	kb. 1 (voting) hak suara. 2 hak, monopoli.
frangipani	kb. 1 kemboja. 2 minyak wangi.
frank	ks. jujur, terus-terang. i'm f. to say dengan terus terang saya katakan. -kkt. mencap dengan cap pengiriman bebas. -frangkly kk. 1 sebetulnya, sesungguhnya. 2 terus terang saja.
frankfurter	kb. semacam sosis dibuat dari daging sapi dan daging babi.
frankness	kb. keterusterangan.
frantic	ks. dalam keadaan takut/kalut, bingung, kegila-gilaan. that music drives him f. musik itu membuat dia kegila-gilaan. -frantic(al)ly kk. dengan penuh ketakutan / kekalutan.
fraternal	ks. yang berhubungan dengan rasa /sifat persaudaraan. f. feeling perasaan persaudaraan. f. order perkumpulan persaudaraan.
fraternity	kb. (j. -ties) 1 kelompok persaudaraan. 2 persaudaraan. f. house asrama untuk sekumpulan mahasiswa yang tergabung dalam satu kelompok.
fraternization	kb. pergaulan bersahabat.
fraternize	kki. bergaul secara bersahabat. to f. with the enemy bergaul dengan musuh.
fraticide	kb. pembunuhan saudara.
fraud	kb. 1 penipuan. to win an election by f. memenangkan pemilihan dengan jalan menipu. 2 inf.: seorang penipu/gadungan. 3 kecurangan. f. in the negotiations kecurangan dalam perundingan. 4 penggelapan.
fraudulent	ks. yang curang. f. dealings perbuatan-perbuatan /transaksi - transaksi yang curang. -fraudulently kk. dengan curang.
fraught	ks. penuh dengan. such an attack is f. with danger serangan demikian itu penuh dengan bahaya.
fray	kb. keributan, kehebohan, percekcokan.-kkt. menjadi tenang. -kki. berjumbai. the material will f. bahan ini akan berjerumbai. -frayed ks. yang berjumbai. f. suit pakaian yang berjumbai.
frazzle	kb. worn to a f. amat letih. -kkt., kki. merobek-robek. tempers were frazzled perasaan mudah goncang.
frcassee	kb. daging yang diiris halus, disetup lalu diberi saus.
freak	kb. 1 orang sinting. 2 keajaiban. f. of nature keajaiban alam. -ks. aneh, ganjil. f. accident kecelakaan yang aneh.
freakish	ks. aneh, ganjil. f. clothes pakaian yang aneh sekali.
freckle	kb. bintik-bintik. -kki. mendapat bintik-bintik di muka. freckle-faced ks. mempunyai muka yang berbintik-bintik.
free	ks. 1 bebas, merdeka. 2 cuma-cuma, gratis. 3 kosong, prei. 4 lancang. f. and easy boros. f. of bebas dari. - kk. dengan cuma-cuma. -kkt. (freed) membebaskan, memerdekakan (slave, prisoner). -freely kk. dengan bebas.
freed	lih free.
freedom	kb. kemerdekaan, kebebasan. f. from want kebebasan dari kemiskinan. f. of action kebebasan untuk bertindak.
freehand	kb. dibuat dengan tangan saja. f. drawing gambar yang dibuat dengan tangan saja, lukisan tangan.
freehanded	ks. royal, murah hati, pemurah.
freeloader	kb. orang yang hadir untuk makan dan minum dengan cuma-cuma, tukang bonceng.
freemason	kb. vrijmetselar.
freemasonry	kb. vrijmetselarij.
freestone	ks. biji yang mengelotok/terkelopak. f. peach buah persik yang mengelotok bijinya.
freethinker	kb. orang yang tidak mengakui ajaran agama.
freeway	kb. jalan-raya-lintas.
freewheeling	kb. keadaan bebas dan tak terhambat. f. discussion of the current political scene pembahasan bebas tentang suasana politik dewasa ini.
freeze	kb. 1 udara yang sangat dingin. 2 pembekuan. 3 penyetopan. -kkt. (froze, frozen) pembekukan. -kki. 1 membeku. 2 menjadi tak berdaya, ketakutan. -frozen ks. yang dibekukan. -freezing kb. pembekuan ks. sangat dingin. f. point titik beku.
freezer	kb. 1 pesawat pembeku. ice cream f. pesawat pembeku untuk membuat eskrim. 2 lemari es.
freight	kb. muatan. 2 pengangkutan. f. costs ongkos pengangkutan. to ship by f. mengirim dengan kereta-api. f. car gerbong barang.
freighter	kb. kapal barang/pengangkutan.
french	kb. 1 orang perancis. 2 bahasa perancis. f. dressing semacam bumbu selada (yang cair sekali). french-fry (french-fried) menggoreng dengan minyak yang banyak. f. horn terompet dari kuningan. to take f. leave minggat, bolos.
frenchman	kb. (j. -men). orang perancis.
frenetic	frenetic.ks .hingar-bingar
frenzied	ks. hiruk-pikuk, hingar bingar. f. activity hiruk-pikuk.
frenzy	kb. (j. -zies) 1 hiruk-pikuk. 2 kegila-gilaan.
frequency	kb. (j. -cies) frekwensi, kekerapan, jarang-kerapnya, keseringan. f. modulation modulasi frekwensi.
frequent	ks. sering, berkali-kali, acap(kali). to pay f. visits to our home sering mengunjungi rumah kami. -kkt. sering mengunjungi, sering-sering pergi ke. -frequently kk. sering - sering, seringkali.
frequenter	kb. pengunjung yang sering datang.
fresco	kb. lukisan dinding.
fresh	ks. 1 segar. 2 hangat. 3 inf.: kasar, kurang ajar. 4 baru. -kk. inf.: f. out baru habis. fresh-air ks. di lapangan terbuka. f. fish ikan basah. fresh-water air tawar. -freshly kk. baru saja. f. printed baru saja dicat.
freshen	kkt. menyegarkan. to f. up before dinner merapikan diri sebelum makan.
freshman	kb. (j. -men) prama, pelonco. bayat, mahasiswa tingkat/tahun pertama. f. girl prami, pelonci, mahasiswi tingkat/tahun pertama.
freshness	kb. 1 kesegaran. 2 (impudence) kekurangajaran, kekasaran.
fret	kb. resah, cerewet. -kki. (fretted) rewel. f. saw gergaji pengukir (kayu).
fretful	ks. rewel, cerewet, bertingkah.
fretfulness	kb. kerewelan, kebrengsekan, keresahan.
friar	kb. rahib, biarawan.
friary	kb. (j. -ries) frateran.
fricative	kb. bunyi desah.
friction	kb. 1 pergeseran, pergesekan. f. tape isolasi ban. 2 (quarrel) perselisihan, percekcokan.
friday	kb. (hari) jum'at.
fridge	kb. inf.: peti es.
fried	lih fry.
friend	kb. 1 teman, kawan, sahabat, sobat. he's a good f. of mine dia teman baik saya. 2 f. = quaker. to be friends bersahabat, berteman. to make friends mendapat teman, berteman.
friendless	ks. tak berteman.
friendliness	kb. keramah-tamahan.
friendly	ks. ramah (tamah). he's a f. person dia peramah. f. greeting salam yang ramah.
friendship	kb. persahabatan. i did it out of f. saya melakukannya karena persahabatan.
frier	= fryer.
fries	lih fry.
frieze	kb. dekorasi atau hiasan yang melintang pada dinding didalam atau diluar rumah/gedung.
frigate	kb. pergat(a).
fright	kb. ketakutan. to be seized with f. ketakutan. ihad a real f. when i heard that noise saya betul-betul takut ketika mendengar bunyi itu.
frighten	kkt. menakuti. you don't f. me ! kau jangan takut-takuti saya ! -kki. menderita/menjadi takut. -frightening ks. yang menakutkan/menakuti.
frightful	ks. 1 mengejutkan. f. racket suara (bunyi) yang mengejutkan. 2 buruk sekali, menakutkan. conditions there are f. keadaan disana buruk sekali.
frigid	ks. 1 dingin sekali. 2 berhati dingin (of a woman). f. zone daerah yang sangat dingin.
frigidity	kb. hati dingin, ketiadaan nafsu birahi, ketidak acuhan seksuil.
frill	kb. 1 jumbai-jumbai. 2 embel-embel, hiasan tambahan.
frilly	ks. berjumbai-jumbai. f. dress rok yang berjumbai-jumbai.
fringe	kb. 1 pinggir (of town, of society). 2 golongan pinggir. 3 lingkaran pinggir. -kkt. menyusur. grassy slopes f. the stream lereng berumput menyusur sungai itu.
frisk	kkt. menggeledah. the policeman frisked the suspect polisi menggeledeh orang yang dicurigai itu.
frisky	ks. lincah, cekatan.
fritter	kb. kue. corn f. kue jagung goreng. -kkt. membuang-buang. to f. o's time away membuang-buang waktunya.
frivolity	kb. (j. -ties) kelakuan sembrono, tingkah laku tidak keruan.
frivolous	ks. sembrono, tidak keruan. f. books buku-buku yang tidak keruan.
frizzle	kkt. 1 menggoreng. to f. ham menggoreng daging babi sampai kering. 2 mengeringkan (o's hair)
fro	lih to.
frock	kb. baju rok.
frog	kb. 1 katak,, kodok. to have a f. in o's throat parau, serak. f. kick gaya katak (dalam berenang). 2 rr : sambungan pada simpangan / cabang rel kereta api.
frogman	kb. (j. -men) manusia katak.
frolic	kb. pesiar, bersenang-senang. he took the children out for a f. dia membawa anak-anak pergi bersenang-senang. -kki. (frolicked) bermain-main.
from	kd. 1 dari.2 mulai. 3 sejak. 4 jauh dari. 5 karena.
frond	kb. daun pakis/palem.
front	kb. 1 front. 2 bidang, sektor. 3 gelombang udara. 4 muka. 5 inf.: kedok. -ks. depan, muka. -kki. berhadapan, menghadapi. front-line ks. garis depan. front-page ks. halaman muka/depan. front-row ks. baris-depan.
front.	[frontispiece] gambar muka.
frontage	kb. bagian depan, tanah yang menghadap ke jalan.
frontal	ks. dari, pada atau di garis depan. f. attack serangan dari depan.
frontier	kb. 1 batas, perbatasan. 2 garis perbatasan. f. area daerah perbatasan.
frontispiece	kb. gambar muka.
frosh	sl.: = freshman.
frost	kb. embun beku, cuaca penuh es. -kkt. 1 membekukan, menutupi dengan embun beku. 2 melapisi. -frosted ks. yang mempunyai permukaan seperti es. f. glass 1 kaca baur. 2 kaca es. -frosting kb. lapisan (kue) terbuat dari gula dan putih telur yang dikocok.
frostbite	kb. radang dingin.
frostbitten	ks. membeku, luka karena dingin yang luar biasa.
frosty	ks. sangat dingin. f. morning pagi yang sangat dingin. f. reception sambutan yang amat dingin.
froth	kb. 1 buih, busa. 2 omong kosong. -kki berbuih. to f. at the mouth berbuih pada mulut.
frothy	ks. berbusa. f. suds air sabun yang berbusa.
frown	kb. kerut (dahi). -kki. mengerutkan dahi. to f. at memberengut. to f. on tidak setuju/menyukai.
froze	lih freeze.
frozen	lih freeze.
frugal	ks. 1 hermat, cermat, ugahari. he is quite f. ia amat hemat. 2 sederhana. f. supper of bread and milk makan malam yang sangat sederhana dengan roti dan susu.
frugality	kb. (j. -ties) 1 kehematan, kecermatan, keugaharian. 2 kesederhanaan.
fruit	kb. 1 buah (buahan). 2 hasil. to bear f. 1 berbuah. 2 membawa hasil. f. stand warung buah-buahan. f. tree pohon buah-buahan.
fruitful	ks. 1 berhasil. f. meeting pertemuan yang berhasil baik. 2 bermanfaat. 3 subur.
fruition	kb. hasil yang diperoleh. to come to f. berhasil/terlaksana dengan baik.
fruitless	ks. tidak berhasil. his efforts were f. usahanya tidak berhasil. f. search penggeledahan yang sia-sia.
fruity	ks. berasa/berbau seperti buah-buahan. that wine has a f. flavor anggur itu ada rasa buahnya.
frustrate	kkt. 1 menggagalkan. to f. o's plans menggagalkan rencananya. 2 menghalangi, mencegah. to be frustrated over amat bingung karena, merasa kecewa karena.
frustration	kb. kegagalan, frustrasi, halangan, kekecewaan.
fry	kb. 1 pesta atau piknik dengan memakan makanan gorengan di lapangan terbuka. 2 anak-anak ikan. -kkt. (fried) menggoreng. -fried ks. yang digoreng. frying pan wajan, kuali, penggorengan.
fryer	kb. ayam muda untuk digoreng.
frypan	kb. wajan, kuali.
ft.	[fort] benteng.
ftc	[federal trade commission] komisi dagang federal (di a.s.).
fuddyduddy	kb. (j. -dies) inf.: orang (berpaham) kolot, ketinggalan zaman.
fudge	kb. gula-gula bonbon yang lunak. -kkt. membuat curang, memalsukan. -kki. berbuat curang. to f. on an agreement berbuat curang dalam perjanjian.
fuel	kb. 1 bahan bakar. f. oil minyak bakar. f. pump pompa minyak/bensin. -kkt., kki. mengisi sesuatu dengan bahan bakar.
fugitive	kb. (orang) buronan, (orang) pelarian. f. from justice buronan polisi, pelarian dari hukuman. -ks. lekas hilang. f. pamphlet surat selebaran yang isinya bersifat sementara.
fugue	kb. fuga.
fulcrum	kb. titik pikul/tupang/tumpu/galang/penunjang.
fulfil(l)	kkt. (fulfilled) 1 memenuhi (a condition). 2 menyelesaikan (a contract). 3 mengabulkan (a request).
fulfil(l)ment	kb. 1 pemenuhan. 2 pengabulan. 3 penyelesaian.
full	kb. to pay in f. membayar penuh, melunasi. paid in f. lunas. -ks. 1 penuh. 2 lengkap. 3 kenyang. 4 lebar. kk. penuh-penuh. -fully kk. 1 secara lengkap. 2 sepenuhnya. 3 samasekali.4 benar-benar. 5 sedalam-dalamnya.
fullback	kb. gelandang belakang.
fullness	kb. kesempurnaan.
fulminate	kki. mengecam dengan keras.
fulsome	ks. berlebih-lebihan sehingga menjengkelkan. f. praise anjung-anjungan yang berlebih - lebihan.
fumble	kb. kegagalan menangkap bola. -kkt. meleset. to f. a ball meleset menangkap bola. -kki. meraba-raba.
fume	kb. uap, asap. fumes from the bus asap bis itu. -kki. menggerutu, mengomel.
fumigate	kkt. mengasapi (untuk desinfeksi).
fumigation	kb. pengasapan.
fun	kb. kesenangan, kegembiraan. we had f. at the beach kami bersenang- senang di pantai. for f. hanya untuk iseng-iseng, hanya untuk senang - senang. to make f. of s.o. memperolok-olokkan/menertawakan seseorang.
function	kb. 1 fungsi, kegunaan. f. of the heart fungsi jantung. 2 pekerjaan. f. of a club pekerjaan perkumpulan. 3 upacara. 4 (social) pesta. -kki. 1 berjalan, berfungsi. 2 berfungsi.
functional	ks. fungsionil.
functionary	kb. (j. -ries) pejabat, petugas, pegawai.
fund	kb. 1 (uang) dana. to misappropriate funds menyalahgunakan dana. 2 simpanan. -kkt. membiayai. fund-raising kb. pengumpulan uang. -funding kb. pembiayaan.
fundamental	kb. pokok, asas, fundamentil. fundamentals of algebra pokok-pokok aljabar. -ks. yang (menjadi) pokok atau asas. f. objections keberatan-keberatan pokok. -fundamentally kk. pada pokoknya/dasarnya/azasnya.
funeral	kb. pemakaman, penguburan. f. director pemimpin pemakaman. f. home/parlor perusahaan pemakaman.
funereal	ks. 1 mengenai/yang berhubungan dengan penguburan/pemakaman. 2 menimbulkan rasa sedih, belas kasihan, takut, seram.
fungi	lih fungus.
fungicide	kb. obat pembunuh/pembasmi jamur fungisida.
fungous	ks. bersifat jamur.
fungus	kb. (j. -gi) jamur, cendawan.
funicular	ks. yang digerakkan oleh tali/kabel. f. railway trem yang digerakkan dengan kabel.
funk	kb. inf.: keadaan takut. he was in a blue f. ia sangat ketakutan.
funnel	kb. corong. ship's f. cerobong kapal, semp(e)rong. -kkt. 1 menyalurkan. 2 menyiarkan, menyalurkan. funnel - shaped ks. berbentuk corong. f.-shaped cloud awan berbentuk corong.
funny	kb. funnies j. cerita-cerita jenaka, cerita-cerita komik. -ks. 1 lucu, komik. 2 inf.: aneh, ganjil. inf.: f. bone ujung siku. f. paper = funnies.
funnyman	kb. (j. -men) pelawak tukang lawak.
fur	kb. 1 bulu binatang. -firs j. pakaian (yang terbuat dari) bulu binatang. fur-bearing ks. yang mempunyai kulit yang berbulu. f. bearing animal binatang yang kulitnya berbulu (halus).
furbish	kkt. menggosok (sampai berkilat).
furious	ks. 1 sangat marah, geram. i was f. over... saya sangat marah tentang... 2 hebat. f. storm angin badai yang hebat. -furiously kk. mati-matian. to work f. bekerja mati-matian.
furl	kkt. menggulung (sails, flag).
furlong	kb. 201 meter.
furlough	kb. cuti, perlop. to go in f. pergi cuti.
furnace	kb. tungku perapian/pembakaran.
furnish	kkt. 1 melengkapi dengan perkakas. 2 menyediakan, memberi. -furnished ks. diperlengkapi dengan perabot rumah. -furnishings kb., j. perlengkapan alat-alat, perabot.
furniture	kb. mebel, perkakas/perabot rumah, meja kursi. suite of f. stel perabotan. f. polish bahan untuk mengkilapkan perabotan, politur untuk mebel.
furor	kb. 1 kehebohan. 2 kemarahan.
furred	ks. berbulu.
furrier	kb. 1 pedagang pakaian bulu. 2 pembuat pakaian bulu.
furrow	kb. 1 galur, alur (in the ground). 2 kerut (in the face). -furrowed ks. berkerenyut, beralur.
furry	ks. berbulu lembut.
further	ks. lebih lanjut. -kk. 1 lebih jauh. 2 lagi. 3 selanjutnya, lagi. -kkt. memajukan.
furtherance	kb. pemajuan, pendorongan.
furthermore	kk. selanjutnya, lagi pula.
furthermost	ks. terjauh. that idea was f. from my mind gagasan itu paling jauh dari pikiran saya.
furthest	ks. yang paling jauh. that's the f. point from here itu titik yang terjauh dari sini.
furtive	ks. secara sembunyi. he stole a f. glance at her dia melirik padanya secara sembunyi.
fury	kb. (j. -ries) 1 kemarahan, kegeraman. the f. of a woman kemarahan seorang wanita. 2 amuk, kedahsyatan. f. of a storm amuk topan. inf.: to work like f. bekerja giat sekali.
fuse	kb. 1 elec.: sekering. f. box kotak sekering. 2 sumbu, murang (of a bomb). -kkt. 1 memadu, melebur, mencor (metals). 2 menyatukan, menggabungkan, melebur (parties). -fusing kb. perfusian, penggabungan, penyatuan.
fuselage	kb. badan pesawat terbang.
fusillade	kb. berondongan (of buckshot, questions).
fusion	kb. 1 peleburan (of political parties and metals). 2 nucl.: penyatuan. 3 perpaduan (of metals).
fuss	kb. pertengkaran, percekcokan. -kki. banyak cincong, membuat repot. to f. arround bersibuk diri dengan hal-hal remeh. to f. at s.o. mengoceh/cerewet kepada seseorang. inf.: fuss-budget kb. seorang yang cerewet.
fussy	ks. rewel, cerewet. that baby is f. bayi itu rewel. f. eater orang yang rewel dalam soal makanan.
futile	ks. sia-sia. to make a f. effort gagal dalam usaha.
futility	kb. (j. -ties) kesia-siaan, kegagalan.
future	kb. 1 masa depan. 2 keakanan. in the f. lain kali, seterusnya. -ks. 1 yang akan datang. 2 bakal.
futurity	kb. (j. -ties) keakanan.
fuze	= fuse..
fuzz	kb. 1 bulu halus (on peaches, etc.). 2 rambut halus.
fuzziness	kb. 1 phot.: kekaburan, ketidakjelasan. 2 keadaan berbulu halus.
fuzzy	ks. 1 kabur, tidak jelas. 2 berbulu halus (of a chick).
fy	[fiscal year] tahun buku / pembukuan.
g,g.	kb.1 huruf ketujuh dari abjad inggris.2 nada musik.3 sl. : seribu dolar.g. string1 cawat.2 mus. : senar bernada g.
g.(gulf)	teluk.
g.b.	[great britain] britania/inggris raya.
g.i.	kb. prajurit as. g.i. insurence asuransi tentara.
g.o.p.	[grand old party] partai republiken di a.s.
g.p.,  g.p.	[general practitioner] dokter umum.
ga.(georgia)	negara bagian as.
gab	kb. inf. : banyak cakap/bual.-kki. (gabbed) mengobrol, beromong-omong.
gabardine	kb. kain gabardin.
gabby	ks. inf. : temberang.
gabfest	kb. sl. : berkumpul untuk ngomong-ngomong.
gable	kb. dinding (muka) yg berbentuk segitiga terletak diantara ujung atap, ujung (nok) atap rumah (yg menonjol).
gad	kki. (gadded) to g. about berkeluyuran.
gadabout	kb. inf.: seorang yg gemar pergi kesana-kemari, pengembara, petualang.
gadfly	kb. (j.-lies) penggangu, penggoda, perongrong.
gadget	kb. alat atau perkakas. handy g. alat yg praktis.
gaelic	kb. bahasa gael.-ks. gael.
gaff	kb. 1 tombak ikan.2 (spur) taji.
gaffe	kb. kejanggalan, kesalahan.
gag	kb. sl.: 1 lelucon.2 sumbat. -kkt.(gagged) menyumbat.-kki.1 tercekik. 2 muntah
gaga	ks. sl.: lucu pandir.
gage	gauge.
gaiety	kb. (j.-ties) keriangan,kegembiraan, kegirangan.
gaily	lih. gay
gain	kb.1 keuntungan.2 tambahan.3 perolehan.-kkt.1 memperoleh.2 menambah.3 mendapat, dapat 4 mencapai. -kki. memperoleh keuntungan.to g. on mendekati
gainer	kb. pemenang, yg memperoleh keuntungan.
gainful	ks. yg menguntungkan.-gainfully kk. menguntungkan.
gainsay	kkt. (gainsaid) menyangkal there's no gainsaying the fact that..... tak dpt disangkal kenyataan bhw......
gait	kb. gaya berjalan. to stride along at rapid g. berjalan dgn langkah cepat.
gal	galon, hampir empat liter
gala	'geila,'gaele, 'gala/ kb. pesta besar. -ks. meriah. g. occasion peristiwa yg meriah. g. costume pakaian pesta.
galangal (e)	kb. laos.
galaxy	kb.(j. xies) bimasakti. g. of stars pawai bintang-bintang pilem.
gale	kb. angin kencang/ribut, badai. to break out in gales of laughter tertawa terbahak-bahak.
galingale	galangal.(e).
gall	kb. empedu.-kkt. menyakitkan hati.
gallant	ks. berani, gagah (berani).2 sopan (terutama thd wanita). -gallantly kk. dgn gagahnya/perkasanya/megahnya.
gallantry	kb. (j.-ries) 1 keberanian.2 kekesatriaan (sikap sopan dan hormat thd wanita).
gallery	kb. (j.-ries) 1 serambi.2 theat.: balkon.3 art : balai atau gedung kesenian.
galley	kb 1 (ship's) dapur.2 sejenis perahu zaman dahulu. g. proof pruf lepas/kotor.
gallon	kb. galon.
gallop	kb. congk(e) lang.to break into a g. memulai/beralih berlari cepat/ menderap/congklang.-kki mencongklang. to g. away pergi dgn menderapkan kudanya. galloping consumption penyakit tbc/paru yg ganas.galloping inflation inflasi terbang.
gallows	kb., j. tiang gantungan. to cheat the g. menghindarkan diri dari hukuman gantung.
gallstone	kb. batu empedu.
galore	kk. yg berlimpah-limpah. to receive compliments g. menerima pujian-pujian yg berlimpah-limpah.
galosh	kb. sepatu luar (dari karet).
gals.	[gallons] galon-galon.
galvanic	ks. galvanis. g. battery batere listrik.
galvanization	kb. galvanisasi.
galvanize	kkt. 1 elect.: menggalvanisasikan. 2 menggembleng. the group was galvanized into action regu itu digembleng untuk mengadakan aksi. -galvanized ks. berlapis seng. g. iron besi berlapis seng.
gambit	kb. 1 cara memulai permainan catur dengan mengorbankan bidak (pion) unutk mendapatkan keuntungan. 2 tiap permulaan gerakan terutama yang dimaksud untuk mendapatkan keuntungan.
gamble	kb. 1 spekulasi. 2 judi. -kkt. to g. away memboros-boroskan dengan berjudi. -kki. berjudi. -gambling kb. berjudi, perjudian. sl.: g. joint/den rumah judi, tempat perjudian.
gambler	kb. permainan judi, penjudi.
game	kb. 1 permainan. 2 pertandingan. 3 binatang buruan. 4 inf.: pekerjaan. 5 maksud. to play a waiting g. menantikan saat yang baik. g. license izin perburuan. -gaming ks. berjudi. -gamely kk. dengan gagah berani.
gamecock	kb. ayam sabungan.
gamekeeper	kb. pengawas binatang perburuan/liar.
gamey	= gamy.
gamma	kb. gamma. g. ray sinar gamma.
gamut	kb. 1 tangga nada. 2 keseluruhan (nya).
gamy	ks. berbau daging yang hampir busuk.
gander	kb. 1 angsa jantan. 2 sl.: pandangan sebentar. take a g. at that new car coba pandang oto baru itu sebentar.
gang	kb. 1 gerombolan. 2 regu. -kki. inf.: to g. together berkumpul dalam gerombolan. to g. up on mengeroyok. to g. up with bersekongkol/berkomplot dengan.
gangling	ks. kurus/ceking dan canggung. a g. youth seorang pemuda/pemudi yang ceking dan canggung.
ganglion	kb. simpul/pusat saraf.
gangplank	kb. tangga untuk naik ke kapal.
gangrene	kb. kelemayuh, ganggren.
gangrenous	ks. berkelemayuh, kena penyakit ganggren.
gangster	kb. penjahat, bandit.
gangway	kb. gang, jalan sempit. -kseru. g.! kasi jalan.
gantlemanly	ks. sopan. g. conduct kelakuan yang sopan.
gantlet	kb. cara menghukum orang pada zaman dulu. to run the g. diserang dengan pukulan dari kanan-kiri. = gauntlet.
gantry	kb. (j. -ries) tempat kerangka peluncuran. g. crane kendaraan kerekan/beroda.
gao	[general accounting office] badan pemeriksa keuangan.
gap	kb. 1 celah (between boards). 2 jurang pemisah. 3 renggang (between teeth). 4 kekosongan. 5 lembah, jurang in mountain). 6 lowongan.
gape	kki. membuka dengan lebar, menganga. to g. at s.o. memandang seseorang dengan mulut ternganga. -gaping ks. yang terbuka. g. cut luka yang terbuka.
gar(r)otte	kkt. mencekik, menghukum mati/ mematikan dengan cekikan.
garage	kb. 1 garasi. 2 bengkel (for repairs).
garbage	kb. sampah. g. can/pail tong/bak sampah. g. dump pelimbahan, tempat/daerah pembuangan sampah. g. truck truk sampah.
garble	kkt. memutarbalikkan perkataan, merusak isi keterangan. the telegram was garbled isi telegram rusak.
garden	garden
gardener	kb. tukang kebun.
gardenia	kb. bunga kacapiring.
gargantuan	ks. raksasa, besar sekali.
gargle	kb. obat kumur. -kki. berkumur. -gargling kb. berkumur.
garish	ks. yang berkilat-kilat. g. coat baju yang berkilat-kilat.
garland	kb. kalung/karangan bunga.
garlic	kb. dasun, bawang putih.
garment	kb. pakaian, penutup badan. jas. g. bag gantungan baju yang berselubung (supaya tidak kotor).
garner	kkt. menyimpan, mengumpulkan.
garnet	kb. batu akik yang berwarna merah tua.
garnish	kb. hiasan (for food). -kkt. menghias.
garnishee	kkt. menyita, merampas, memotong, mengurangi. to g. a part of a salary memotong sebagian dari gaji.
garp	kb. pakaian.
garret	kb. loteng (dibawah atap).
garrison	kb. 1 garnisun. 2 pasukan yang ditempatkan didalam suatu kota. -kkt. mengasramakan.
garrulous	ks. gatal/banyak mulut, suka ngomel, temberang.
garter	kb. ikat kaos kaki. g. snake ular kecil yang tak berbisa.
gas	kb. 1 gas. 2 inf.: bensin, minyak gas. 3 med.: obat bius. -kkt. 1 membubuhkan gas. 2 mil.: menyerang dengan gas beracun. to g. up mengisi bensin sampai penuh. g. burner kompor gas.
gaseous	ks. seperti gas, dalam bentuk gas.
gash	kb. luka tetak. -kkt. melukai (parah), menetakkan. the machete gashed him badly dia luka parah kena parang itu.
gasket	kb. paking. sl.: to blow a g. menjadi marah sekali.
gaslight	kb. (cahaya) lampu gas. to study by g. belajar (dengan) memakai lampu gas.
gasman	kb. (j. -men) pegawai/tukang/pemeriksa gas.
gasoline	kb. bensin, minyak gas. g. gauge pelampung bensin, alat pengukur bensin. g. station pompa bensin.
gasp	kb. hembusan nafas. she talked in gasps bicaranya terengah-engah. -kki. to g. for breath megap-megap.
gastric	ks. yang berhubungan dengan lambung perut. g. juice getah perut. g. ulcer bisul perut.
gastritis	kb. radang (lambung) perut.
gastronomic	ks. yang berhubungan dengan keahlian memasak dan makanan enak.
gasworks	kb. pabrik gas.
gate	kb. 1 lawang. 2 pintu gerbang/pagar. 3 pintu masuk. 4 inf.: penghasilan karcis. gate-leg table sebuah meja yang daunnya dapat dilipat. g. receipts hasil pendapatan karcis masuk.
gatekeeper	kb. penjaga pintu.
gatepost	kb. tonggak pintu pagar. between you and me and the g. antara kita-kita saja.
gateway	kb. pintu gerbang.
gather	gather
gauche	ks. canggung, kaku.
gaudy	ks. terlalu menyolok.
gauge	ks. meteran/ukuran. gasoline g. meteran bensin. standard g. ukuran pokok/baku. -kkt. 1 mengukur (distance). 2 menaksir/mengukur.
gaunt	ks. kurus-kering dan cekung.
gauntlet	kb. sarung tangan (biasanya sebagian dari kulit sebagian dari besi). to fling/throw down the g. menantang, mengajukan tantangan.
gauze	kb. kabut tipis. wire g. ayakan dawai.
gave	lih give.
gavel	kb. palu, martil (dipergunakan oleh hakim, ketua rapat atau tukang lelang).
gawk	kki. inf.: menganga, melongo.
gawky	ks. janggal, kekok.
gay	ks. 1 periang, gembira. she's such a g. person ia seorang yang sangat periang. 2 meriah. g. party pesta yang meriah. 3 berwarna ria. 4 sl.: homoseksuil. -gaily kk. dengan riang, dengan gembira.
gaze	kb. pandangan, tatapan. -kki. memandang. to g. at/upon memandang kepada, menatap. to g. into menatap. he gazed into her eyes dia menatap matanya.
gazelle	kb. semacam rusa.
gazette	kb. surat kabar. government g. lembaran negara.
gazetteer	kb. kamus ilmu bumi.
gear	kb. 1 roda gigi. 2 persneling. -gears j. 1 perlengkapan roda gigi. 2 gigi persneling. -kkt. menyanggupkan, mencocokkan. -gearing kb. di perlengkapi dengan gigi-gigi (persneling dsb).
gearshift	kb. alat untuk memasukkan atau memindahkan persneling atau gir.
gearwheel	kb. roda gigi.
gecko	kb. toke (k).
gee	kb. huruf g. -kseru. astaga. -kkt., kki. memerintahkan kuda membelok kekanan. inf.: gee-string cawat.
geese	lih goose.
geewhilikins	kseru. astaganaga, celaka duabelas.
geg.	1 [geographer] ahli ilmu bumi. 2 [geographic (a)] yang berhubungan dengan ilmu bumi. 3 [geography] ilmu bumi.
geiger	g. counter alat pangukur banyaknya radiasi.
gelatin	kb. agar-agar.
geld	kkt. mengebiri.
gelding	kb. kuda atau binatang lainnya yang dikebiri.
gem	kb. 1 permata tulen. 2 mutiara. gem-studded ks. bertatahkan permata. g.-studded watch arloji bertatahkan permata.
geminate	ks. rangkap. -kkt. merangkapkan.
gemination	kb. kembar, rangkap, dobel.
gemini	kb. zod.: mintuna.
gen.	1 [general] jenderal. 2 [genesisi] kejadian.
gender	kb. jenis kelamin.
gene	kb. plasma pembawa sifat (didalam keturunan).
genealogical	ks. yang berhubungan dengan silsilah. g. tree silsilah susur galur.
genealogy	kb. (j. -gies) silsilah (keturunan), genes.
genera	kb., j. dari genus.
general	kb. 1 jend(e)ral. 2 hal yang umum. -ks. umum. the g. public khalayak ramai. -generally biasanya.
generality	kb. (j. -ties) keadaan yang umum. he tends to speak in generalities dia suka berbicara secara umum.
generalization	kb. perumuman, penyamarataan.
generalize	kkt. menyamaratakan.
generate	kkt. 1 membangkitkan, menghasilkan. to g. electricity membangkitkan tenaga listrik. 2 menyebabkan. to g. opposition menyebabkan timbulnya perlawanan. generating plant/ station sentral listrik.
generation	kb. 1 angkatan, generasi. 2 pembangkitan (of electricity). 3 keturunan. from g. to g. turun-temurun. g. gap jurang (perbedaan) antara generasi.
generator	kb. generator, alat pembangkit tenaga listrik, desel, disel.
generic	ks. umum g. term istilah umum.
generosity	kb. (j. -ties) kemurahan hati, kedermawanan.
generous	ks. 1 bermurah hati, dermawan (of people). 2 banyak sekali. g. serving of ice cream sajian eskrim yang banyak sekali.
genesisi	kb. asal, kejadian. bible.: g. kejadian.
genetic	ks. yang berhubungan dengan azas-azas keturunan. g. variation variasi/kelainan keturunan.
geneticist	kb. ahli (ilmu) genetika.
genetics	kb. (ilmu) genetika, ilmu keturunan.
genial	ks. peramah, periang, ramah-tamah.
geniality	kb. keramah-tamahan.
genie	genie.kb.jin.
genital	kb. genitals j. aurat, kemaluan, alat kelamin. -ks. yang berhubungan dengan kemaluan.
genitalia	kb. aurat, kemaluan, alat kelamin.
genitive	kb., ks. (kasus) genitif.
genius	kb. 1 kecerdasan pikiran. 2 kesanggupan. 3 seorang yang kepandaiannya luar biasa. 4 bakat.
genocide	kb. pemusnahan secara teratur terhadap suatu golongan bangsa.
genotype	kb. genotip.
genre	kb. 1 gaya, aliran. literary g. aliran/gaya sastera. 2 macam.
gent	kb. sl.: = gentleman. -gents (w. c.) pria.
gent.	[gentlemen] tuan-tuan.
genteel	genteel.ks. sopan,halus,beradab g.manner tingkah laku yang sopan.
gentile	kb. 1 seorang bukan yahudi. 2 kafir (menurut orang islam).
gentility	kb. (j. -ties) keturunan bangsawan/ningrat, tingkah-laku yang sopan, budibahasa yang halus.
gentle	ks. 1 lemah-lembut. 2 sepoi-sepoi. 3 jinak. the gentle(r) sex kaum wanita / hawa. -ks. berperasaan baik, ramah. -gently kk. 1 dengan hati-hati. 2 dengan lemah-lembut.
gentleman	kb. (j. -men). 1 tuan, saudara. 2 orang pria. g.'s agreement perjanjian yang ditandatangani, tetapi dianggap berlaku atas pengertian bersama.
gentlemanlike	= gentlemanly.
gentleness	kb. kelemah-lembutan, kehalusan.
gentlewoman	kb. (j. -women). wanita baik-baik, wanita dari keluarga baik-baik, wanita yang berkedudukan baik.
gently	lih gentle.
gentry	kb. golongan yang berasal dari keluarga baik-baik.
genuflect	kki. bertekuk lutut (memuja sesuatu/seseorang).
genuflection	kb. tekuk lutut, pemujaan.
genuine	ks. 1 sejati, asli. 2 tulen. 3 sungguh-sungguh, ikhlas.
genus	kb. 1 (j. genera) jenis, macam, golongan. 2 bot.: ibu/induk jenis.
geodesy	kb. geodesi.
geodetic	ks. geodetik. g. survey penyelidikan geodetik.
geograher	kb. ahli ilmu bumi.
geographic(al)	ks. geografis. its g. location letak geografisnya.
geography	kb. (j. -phies) ilmu bumi, geografi. physical g. ilmu bumi alam.
geol.	1 [geology] geologi. 2 [geological] yang berhubungan dengan geologi.
geological	ks. yang berhubungan dengan geologi. g. survey direktorat (penjelajahan) geologi.
geologist	kb. geolog, ahli geologi.
geology	kb. (j.-gies) geologi.
geometric(al)	ks. geometris.
geometry	kb. (j. -ries) ilmu ukur. analytic g. ilmu ukur analitis.
geophysical	ks. yang berhubungan dengan geofisika. g. year tahun geofisika.
geophysics	kb. geofisika.
geopolitics	kb. geopolitik.
george	kb. by g.! ja, allah/sungguh mati. inf.: let g. do it biarlah orang lain yang mengerjakannya.
ger.	1[germany] negeri jerman. 2 [german] bahasa atau orang jerman.
geranium	kb. semacam bunga.
geriatrics	kb. geriatrik.
germ	kb. kuman, basil. g. cell sel kuman. disease g. kuman penyakit. g. warfare perang kuman.
german	kb. 1 seorang jerman. he's a g 2 bahasa jerman. she speaks g. dia berbahasa jerman. -ks. jerman. g. measles biring peluh. g. shepherd anjing herder/gembala.
germane	ks. berhubungan erat. that's not g. to the argument itu tidak ada hubungan dengan persoalan itu.
germanic	ks. yang berhubungan dengan bahasa/bangsa jerman. g. linguistics ilmu bahasa jerman.
germany	kb. negeri jerman. federal republic of g. republik federal jerman.
germfree	ks. suci hama.
germicide	kb. obat penghapus kuman penyakit.
germinal	ks. asal, mula-mula. g. idea gagasan semula.
germinate	kki. berkecambah.
germination	kb. pengecambahan.
gerontology	kb. gerontologi, ilmu mengenai usia lanjut.
gerrymander	gerrymander,kkt. memberi kesempatan dengan curang kpd suatu partai politik.
gerund	kb. kata benda yang dibentuk dari kata ditambah -ing (dalam bahasa inggris).
gestation	kb. 1 waktu selama hamil. 2 kehamilan. g. period masa persiapan.
gesticulate	kki. menggerakkan tangan. to g. when speaking menggerak - menggerakkan tangan waktu berbicara.
gesticulation	kb. gerak-isyarat tangan.
gesture	kb. 1 gerak-isyarat. 2 sikap, langkah. -kki. memberi/membuat gerak - isyarat.
get	kkt. (got, gotten) 1 memperoleh. 2 menerima. 3 membeli. 4 mengambil. 5 mengambilkan. 6 memecahkan. 7 mengejar. 8 kena. 9 mendapat. 10 mempunyai, memperoleh. 11 menangkap. 12 sl.: mengerti. 13 memanggil.14 membukakan. 15 mengangkat, terima. 16 menyuruh.
geyser	kb. air mancur panas.
ghastly	ks. mengerikan, menakutkan. g. picture foto yang mengerikan.
gherkin	kb. ketimun.
ghetto	kb. 1 kampung yahudi di kota. 2 bagian kota yang didiami terutama oleh golongan minoritas.
ghost	kb. hantu. to give up the g. meninggal. g. town kota mati. to ghost-write mengarang untuk orang lain. g. writer pengarang untuk orang lain.
ghostlike	ks. seram, angker, seperti setan/hantu.
ghostly	ks. pucat, remang-remang, seperti hantu.
ghoul	kb. setan /perampok kubur.
ghq	[general headquarters] markas besar.
giant	kb. 1 raksasa. 2 tokoh besar. giant-size ks. besar sekali. g.-size jar coffee sebotol besar kopi.
gibber	kki. omong-omong, merepet, mericau. he's a gibbering idiot ia seorang tolol yang merepet.
gibberish	kb. secara merepet/membual/ mericau.
gibbon	kb. siamang, ungka.
gibe	kb. ejekan cemooh. his gibes sting ejekannya menusuk. -kki. mencemoohkan, mengejek.
giblets	kb., j. jeroan ayam-itik.
giddiness	kb. perasaan pusing/mabuk/ gamang.
giddy	ks. pusing. i feel g. pusing kepalaku.
gifft	kb. hadiah, kado, pemberian. 2 bakat. to gift-wrap (gift-wrapped) membungkus dengan cantik sekali (untuk hadiah.
gifted	ks. berbakat. g. child anak yang berbakat.
gig	kb. lembing/tombak ikan.
gigantic	ks. 1 hebat, dahsyat. g. earth-quake gempa bumi yang hebat. 2 sangat besar, raksasa. he was g. dia sangat besar.
giggle	kb., kki., terkikih-kikih, tertawa genit.
gild	kkt. (gilded atau gilt.) menyepuh. to g. a frame menyepuh( dgn emas) bingkai.
gill	kb. insang. to look green around the gills kelihatan pucat sekali (spt orang yg tidak enak badan atau terasa mau muntah).
gilt	kb. lapisan yg berkilat. gilt-edge(d) ks. bermutu tinggi. g.-edge invesment penanaman (modal) yang tidak akan rugi. lih gild.
gimlet	kb. 1 geret kayu, bor kayu yang kecil. 2 minuman keras.
gimmick	kb. 1 alat. 2 tipu muslihat. what's the g. ? apakah maksud tersembunyi didalamnya ?
gin	kb. 1 jenewer, sopi. 2 (cotton-) mesin pemisah biji kapas.
ginger	kb. jahe, halia. g. ale air jahe dengan soda. inf.: he has lots of g. dia giat sekali.
gingerbread	kb. roti yang dibubuhi jahe dan manisan.
gingerly	kk. dengan hati-hati sekali.
gingersnap	kb. kue kecil yang garing dan dibubuhi jahe dan manisan.
gingham	kb. (kain) genggang.
gingivitis	kb. radang gusi.
ginseng	kb. jinsom.
gip	= gyp.
gipsy	= gypsy.
giraffe	kb. zirafah, zirafah, jerapah.
gird	kkt. bersiap-siap. he girded himself for a rough struggle dia bersiap-siap untuk suatu perkelahian yang seru.
girder	kb. bendul, balok penopang.
girdle	kb. korset.
girl	kb. 1 anak perempuan. 2 gadis (in her late teens). 3 pemudi. putri. 4 pacar.
girlhood	kb. masa gadis, masa remaja (perawan).
girlie	ks. sl.: yang memuat gambar-gambar wanita cantik. g. magazine majalah yang memuat gambar-gambar wanita.
girlish	ks. seperti anak perempuan, genit. she still had g. figure potongannya masih seperti gadis.
girth	kb. 1 ukuran lilitan. he has a tremendous g. ia gendut. 2 tali pelana.
gist	kb. intisari, pokok. g. of the story inti sari cerita.
give	kb. gaya-pegas. -kkt. (gave, given) 1 memberi. 2 memberikan. 3 menyumbang. 4 menyumbangkan. 5 membayar. 6 mengadakan. 7 mengucapkan (speech, talk). 8 menyajikan (a play). 9 mencurahkan. 10 menyampaikan. 11 memperlihatkan, memberikan. 12 mengorbankan.
giveaway	kb. inf.: 1 pembukaan rahasia tanpa sengaja.2 hadiah, pemberian.
given	lih give.
giver	kb. pemberi, penderma.
gizmo	kb. sl.: alat. useful g. alat yang berguna.
gizzard	kb. empedal unggas.
gk.	[greek] yang berhubungan dengan yunani.
glacial	ks. yang berhubungan dengan sungai es.
glacier	kb. sungai es, gletser.
glad	kb. inf.: = gladiolus. -ks. senang (hati), gembira. sl.: g. eye lirikan (mesra), permainan mata. inf.: glad-hand kb. salam yang ramah. sl.: g. rags pakaian yang paling bagus. -gladly kk. dengan senang hati, dengan gembira.
gladden	kkt. menggembirakan.
glade	kb. lapangan yang terluang ditengah-tengah tanah rimba.
gladiator	kb. seorang budak, tawanan atau orang upahan yang disuruh berkelahi dalam tontonan umum.
gladiolus	kb. (j. -li, -uses) gladiol.
gladness	kb. kesenangan hati, kegembiraan.
glamor	= glamour.
glamorize	kkt. mengagungkan.
