a.n.b.	(atas nama beliau) in his name.
aa	(asia afrika) asia-africa.
aal	(akademi angkatan laut) naval academy.
aam	see am.
aau	1 ouch ! (exclamation of pain). 2 what ! (exclamation of surprise)
ab	1 (anggaran belanja) budget. 2 (angkatan bersenjata) armed forces.
aba	1 (aba-aba) order, command. 2 father.
abab	exhaled breath.
abad	1 century. 2 age, era.
abadi	eternal, lasting, enduring.
abah	direction. 2 see aba1.
abah-abah	harness.
abai	neglectful.
abang	(jakarta and some other regions) 1 elder brother. 2 (in some regions only) red.
abangan	(jv) o. who does not adhere strictly to the precepts of o.'s nominal religion.
abar	(r.r.) brake.
abat	see abad.
abau	k.o. tortoise.
abbas	abbot.
abc	abese the abc's.
abd	see abdi.
abdas	(islam) absolution before prayer.
abdei	abbey.
abdi	1 servant. 2 slave.
abdidalemisme	sycophancy.
abdikasi	abdication.
abdis	abbess.
abdu	see abdi.
abece	[abc] alphabet, abc's.
abelur	see hablur.
aben	cremate.
aberasi	aberration.
aberikos	see abrikos.
abet	1 appearrance. 2 behavior.
abib	(in families of arabic descent) grandfather.
abid	1 pious, devout. 2 see abadi.
abidin	/abidun/ (islam) the faithful.
abil	see habil.
abis	see habis.
abiturien	o. who went as far as high school.
abjad	alphabet.
abjadiah	alphabetical.
ablak	(jakarta) open wide.
ablatif	(ling.) ablative.
ablur	see hablur.
abn	(anggaran belanja negara) national budget.
abnormal	abnormal.
abnormalitas	abnormality.
abnus	(lit.) ebony.
abolisi	abolition.
abon	shredded meat that has been boiled and fried.
abone	subscriber.
abonemen	subscription (to a magazine, etc.).
aborsi	/abortus/ abortion.
abrak	mica.
abrek	1 very much. 2 see ambreg.
abri	[angkatan bersenjata republik indonesia] indonesian armed forces.
abrikos	apricot.
abrit-abritan	see aprit-apritan.
abruk	(jakarta) slam or set s.t. down with a crash.
abs	[asal bapak senang] as long as the boss is happy.
absah	valid, legal, legitimate.
absen	absent.
absensi	take attendance.
abses	abscess.
absis	(math.) abscissa.
absolusi	(rel.) absolution (of sins).
absolut	absolute.
absolutisme	absolutism.
absorpsi	(ling., phys.) absorption.
absten	abstain.
abstrak	1 abstract, summary, precis. 2 abstract, theoretical.
abstraksi	abstraction.
absur	/absurd/ absurd.
absurditas	absurdity.
abu	1 dust. abu-kayu sawdust. 2 ashes. abu-bara cinders. abu-blarak (java) cleansing powder (of coconut frond). abu-gosok scouring sand.
abu-abu	gray.
abuh	1 swollen. 2 swelling.
abuk	fine powder.
abur	squander, waste.
abus	1 smallest portion. 2 of no value, worthless.
abyad	white, transparent, translucent.
ac	(air conditioning) air conditioning.
acak	1 disordered. 2 random.
acak-acak	in a hurry, hastily.
acak-acakan	in disorder, chaos.
acan	(sd) miniscule in amount.
acang-acang	1 confidential agent. 2 shop steward. 3 master of ceremonies.
acap	1 be under water. 2 be stuck in s.t. deeply.
acapkali	repeatedly, frequently.
acar	pickles, salad made with raw vegetables mixed with spices and a souring agent.
acara	1 agenda. 2 program. 3 judicial procedure. 4 jurisdiction
ace	see ac.
aceuk	(sunda) elder sister.
aci	1 agreed, settled. 2 valid. 3 (sumatra) pith, starchy core. 4 see acik.
aci-aci	example.
acik	(ch, sumatra) elder sister.
acir	(coll.) 1 in disarray. 2 helter-skelter.
aco	see kacau.
acrit	(coll.) come out in rush.
acu	/acuan/ 1. 1) hint. 2) reference. 2. 1) mold. 2) matrix. 3. ready.
acuh	1 care. 2 /acuhan/ (jakarta) not care.
acum	incite, instigate, provoke.
acung	point upward.
ad	1. [angkatan darat] army ground forces. 2. [anggaran dasar] statutes.
ad-interim	acting, temporarily in a position.
ada	1 there is, are. 2 (coll.) be, be present. 3 have, own. 4 did (do so-and-so). ada-lah am, is, are.
adab	1 courtesy. 2 culture. 3 knowing proper behavior.
adakalanya	sometimes.
adalat	justice, righteousness.
adam	1 proper name. 2 (islam) the prophet adam.
adan	see azan.
adang	1 intercept, block, ambush. 2 block. 3 flag down. 4 wait for (a parade to go by, etc.).
adanya	see ada . 1 presence. 2 existence. 3 situation.
adap	see hadap.
adaptasi	adaptation.
adapun	see ada.
adas	dill, fennel.
adat	1 custom, tradition. 2 customary law. 3 manners, proper behavior.
adati	traditional.
adecharge	(a decart) see saksi.
adegan	/adekan/ 1 scene (in a play). 2 (islam) movement.
adem	1 cool, calm. 2 cold. 3 tasteless, flat.
adempause	(sport) breathing spell.
adhesi	1 adhesion. 2 devotion, attachment.
adhyaksa	(leg.) a rank for prosecutors.
adi	1 superior. 2 splendid, highly valued.
adib	respectful.
adicita	ideology.
adidaya	see adi.
adiguna	(java) rely too much on o.'s own abilities.
adik	1 younger brother or sister or younger cousin. 2 form of address to younger brother or sister and younger people in extended family. 3 form of address from husband to wife, boyfriend to girlfriend.
adikara	dictatorial.
adikodrat	/adikodrati/ (rel.) the supernatural, the supreme power of god.
adikuasa	see adi.
adil	1 just, fair, equitable. 2 legal.
adinda	1 respectful form of address and reference to younger sibling or to a younger person of either sex, esp. 2 form of address to wife or female lover (more affectionate than adik).
adipati	title for bupati (colonial era).
adiratna-pekaca	(lit.) 1 lotus jewel, the sublime jewel. 2 young woman.
adiwarna	resplendent, excellent.
adm.	(administrasi) administration.
administrasi	administration.
administratif	/administratip/ administrative.
administratir	/administrator/ manager of an estate.
administratur	administration.
administrir	administrir administer, manage.
admiral	admiral.
adolensi	tax clemency.
adon	knead.
adonan	batter, dough.
adpertensi	advertisement.
adpis	see advis.
adpisir	adviser.
adpokat	see advokat2.
adreng	(java) eager.
adres	address (of letter).
adri	(angkatan darat republik indonesia) the indonesian army (revolutionary era).
adu	1 compete. 2 1) complain about, 2) sue, bring legal action. 3) inform, squeal, tell on, report. 3. sleep (of royalty).
aduh	1 auch ! ow ! (expression of pain). 2 oh my ! (expression of disappointed surprise).
aduhai	(lit.) 1 how beautiful ! how sad ! atc. 2 incredible. staggering.
aduk	1 stir (tea, etc.). 2 beat (batter, etc). 3 mix. 4 scramble (eggs). 5 interfere in, meddle in (the affairs of others). 6 stir up, confuse, annoy.
adun	1 dress, finery. 2 see adon.
adven	/advent/ seventh day adventist religious sect or adherent thereof.
adverbia	adverb.
adverbial	adverbial.
advertensi	see adpertensi.
advis	advice.
advokat	1 lawyer. 2 avocado.
adzan	see azan.
aerodinamika	aerodynamics.
aeronotika	aeronautics.
af	break off, break up.
afal	1(islam) works, deeds. 2 1) waste portions of butchered animals. 2) reject products of a factory. 3 see hafal.
afasi	aphasia.
afdal	1 good, fine, nice. 2 (islam) ritually pure.
afdeling	section, department (colonial era).
afdlal	/afdol/ see afdal.
afdruk	print, copy.
affiliasi	see afiliasi.
afiat	1 healthy. 2 good health.
afiks	(ling.) affix.
afiksasi	affixation.
afiliasi	affiliation.
afinitas	affinity.
afirmasi	affirmation.
afiun	see apiun.
afkir	see apkir.
aflos	/aflus/ see aplos.
afrikat	(ling.) affricate.
afrit	evil spirit.
afwah	blessing.
agah	meng-agah 1 stare fixedly forward (esp. in certain sports). 2 stare at (to start a fight). 3 put o.'s face forward.
agak	1 rather, somewhat. 2 approximately, about. agak-agak 1 guess, vague idea, fantasy. 2 careful.
agaknya	it seems, probably.
agam	1 virile, manly. 2 sturdy, hefty.
agama	religion.
agamawan	religious person, religionist.
agamawi	religious.
agamis	religious.
agan	intend, plan.
agar	in order that, in order to.
agar-agar	1 k.o. seaweed. 2 gelatin made of seaweed.
agas	sandfly, gnat.
agen	1 agency, branch. 2 agent.
agenda	agenda.
agendaris	secretary or clerk who draws up the agenda.
agendir	enter on an agenda.
agih	distribute evenly, apportion.
agitasi	agitation.
agogo	1 western dance. 2 rock and roll.
agraria	agrarian affairs.
agregat	1 electric generator. 2 aggregate.
agresi	aggression.
agresif	/agresip/ aggressive.
agresor	aggressor.
agressif	see agresif.
agri-bisnis	agribusiness.
agri-industri	agri-industry.
agronomi	agronomy.
aguk	locket.
agul	1 boast of. 2 make a show of, display, show off.
agung	1 exalted, high, noble. 2 impressive.
agustus	august.
ah	1 ah ! alas ! 2 yachh !(exclamation og disgust). see a1.
ah-ih-eh	exclamation of indecision.
aha	aha !
ahad	1 one. 2 sunday.
ahadiat	unity.
ahala	dynasty.
ahdiat	see ahadiat.
ahir	see akhir.
ahlak	see akhlak.
ahli	1.1) expert, specialist. 2) virtuoso. 3) skilled, highly competent, professional. 2. 1) members. 2 relatives.
ahlubait	(islam) owner of the house, host.
ahlukubur	(islam) the deceased.
ahlulsuluk	(pl.) mystics.
ahmak	1 a fool. 2 foolish. 3 stupid.
ai	(ad interim) acting, temporary.
ai-lap-yu	(sl.) a profession of love.
aib	1 shame, disgrace, scandal. 2 error, mistake.
aidil-fitri	see idul-fitri.
aih	exclamation of surprise.
ainulyakin	with the complete conviction of o. who has witnessed.
air	1 water, liquid. 2 juice.
ais	ais-an carrying cloth.
aisyiah	reformist muslim organization for women.
aja	(coll.) see saja.
ajab	1 surprised, astronished. 2 see azab.
ajaib	1 miraculous. 2 astonishing, remarkable. 3 remarkableness
ajak	1.1) invite. 2) challenge. 3) stimulus. 2. (java) wild dog. 3. (m) similar to, as.
ajal	predestined hour of death, end.
ajam	(lit.) iran, persia.
ajan	see azan.
ajang	1 site. 2 arena.
ajar	1.1) (coll.) study. 2) learn. 2 hermit.
ajat	see hajat.(jakarta).
aje	see saja.
ajeg	/ajek/ steady, stable, constant.
ajektif	/ajektiva/ adjective.
ajeng	see jeng.
ajengan	(java) community leader. s.o. to emulate.
aji	1 spell, charm, magical formula. 2 1) (lit.) king, ruler. 2) o. who is a champion at doing s.t.
ajidan	see ajudan.
ajimat	see azimat1.
ajinomoto	any k.o. taste enhancer, monosodium glutamate.
ajir	stake, marker.
ajojing	k.o. rock-style dancing.
ajrih	respect and fear.
aju	1 institute. 2 put, ask (a question). 3 file, submit, make (application).
ajubillah	see audubillahi.
ajudan	1 adjutant. 2 (navy) chief petty officer.
ajuk	1. 1) observe, estimate. 2) test, put to the test, sound out. 2 mimic, imitate, parrot, mock.
ajun	1 purpose. 2. adjunct.
ajung	adjunct.
ak.	(akuntan) accountant (used in academic degrees).
akabri	(akademi angkatan bersenjata) armed forces academy.
akad	contract, agreement, convenant.
akademi	academy.
akademik	academic.
akademikus	an academic.
akademis	academic.
akaid	dogma.
akal	1 mind, intellect, reason. 2. intelligence. 3 way, tactics. advice, instruction. 5 deceit, trickness, cunning.
akali	intelligent.
akan	1 will, about to (particle marking future events). 2 . 1) about, regarding. 2) for, with purpose of. 3) as for.
akang	(sunda, jakarta) term of address or reference for elder brother.
akar	1 root. 2 root, source.
akas	1. clever, handy, skillful. 2. 1) upside down. 2) the opposite.
akasa	see angkasa.
akasia	acacia.
akat	see akad.
akaunting	see akonting.
akbar	1 exalted, great. 2 big.
akekah	ritual shaving of baby's head for first time (us. on the seventh day after birth).
akh	see ah1.
akhbar	newspaper, the press.
akhir	end, finish.
akhiran	(ling.) suffix.
akhirat	the hereafter, the beyond.
akhirnya	final, last.
akhirulkalam	in conclusion.
akhlak	character, morals.
akhlas	see ikhlas.
akhli	see ahli1,2.
aki	1 storage battery. 2 (in some regions only) grandfather.
akiau	(jakarta, china) young china man.
akibat	result, consequence.
akibatnya	finally, as a consequence.
akidah	belief, faith.
akik	carnelian, agate.
akilbalig	/akilbaligh/ 1 of age, grown up (from age 15 on). 2 legally responsible.
akir	see akhir.
akisir	battery acid.
akkord	see akord.
aklamasi	acclamation.
aklimatisasi	acclimatization.
akmal	(rel.) utterly perfect (of god).
akmil	(akademi militer) military (army) academy.
akomodasi	accommodations.
akompanimen	accompaniment.
akonting	accounting.
akor	see akur.
akord	harmonic chords.
akordeon	/akordion/ accordion.
akpol	(academi kepolisian) police academy.
akrab	intimate, chummy.
akreditasi	accreditation.
akronim	acronym.
aksara	1 letter of the alphabet, 2 script.
aksarawan	o. who is literate.
aksef	(aksi sefihak) unilateral action.
akselerasi	acceleration.
aksen	accent.
aksentuasi	1 (ling.) accentuating. 2 accent, stress. 3 emphasis, stress.
aksep	an iou, promissory note.
akseptable	acceptable.
akseptor	acceptor, esp. o. who has agreed to practice birth control.
aksesori	/aksessory/ accessory.
aksi	1 action. 2 lawsuit. 3 boasting, bragging. 4 pretense, airs. 5 handsome, attractive (of apparel, behavior, etc).
aksioma	axiom.
aksiomatis	axiomatic.
akta	1 official document. 2 diploma, certificate.
akte	see akta.
aktentas	briefcase.
aktif	1 active, energetic. 2 (ling.) active (verb, etc). 3 functioning. 4 favorable.
akting	1 o. temporarily in charge. 2 o. who assumes responsibility.
aktip	see aktif.
aktir	see aktor.
aktiva	(fin.) assets.
aktivis	activist.
aktivitas	/aktivitet/ activity.
aktor	actor.
aktris	actress.
aktual	see aktuil.
aktualisasi	actualization.
aktualisir	actualize, bring up to date.
aktualitas	timeliness, topicality.
aktuil	recent, topical, current.
aku	1. i (familiar, intimate). 2. see aki1.
akuaduk	aqueduct.
akuan	1 confession, admission. 2 genie, spirit.
akuarel	aquarelle.
akuarium	aquarium.
akuisme	egocentricity, self-centeredness
akulturasi	acculturation.
akumulasi	accumulation.
akumulatif	accumulative.
akuntan	accountan.
akuntansi	accountancy.
akunting	see akonting.
akupungtur	/akupunktur/ acupuncture.
akur	agree to do, go along with.
akuran	muttually agree.
akurat	accurate, precise, exact.
akustik	/akustika/ acoustics.
akustis	acoustic.
akut	acute, critical (crisis, illness, etc.).
akwal	(lit.) words, speech.
al	(antara lain) among others.
al-masih	the messiah.
al-qur'an	the koran.
ala	1 in the style (of). 2 (alaah) exclamation of exasperation.
alah	1 defeated, beaten, conquered. 2 see ala2
alaihissalam	(islam) upon him be peace (used after mention of o. of the prophets other than muh.)
alaikum'salam	(islam) peace be unto you (said as a response to assalam alaikum).
alal-bihalal	see halal-bihalal.
alam	1. 1) world, realm. 2) nature, natural. 2. (islam) be more knowledgeable.3. banner, standard.
alamat	1 address. 2 omen, sign, indication. 3 target. 4 title (of a book).
alami	/alamiah/ natural, concerned with nature.
alan-alan	comedian, jokester.
alang	1 middle, medium. 2. 1) crosswise, diagonal. 2) crossbeam, bar. meng-alang-kan place s.t. athwart. 3. see halang.
alang-alang	tall, coarse grass.
alap	1. alap-alap 1) hawk. 2) thief. 2 nice, attractive, handsome.
alarm	/ alarem/ alarm, danger signal.
alas	1. 1)base, foundation. 2 layer, lining, convering. 2. (java) forest.
alat	1. 1) instrument, tool, device, equipment. 2). organization. 3) (fin.) asset. 4) bodily organ. 2. 1) guest. 2) feast, party.
album	album.
ale	(ambon) you (respectful).
alegori	allegory.
alegoris	allegorical
alegro	allegro.
aleksander	topaz.
alem	spoiled, pampered.
alergi	allergy, allergic.
alesduk	scarf.
alfabet	alphabet.
alfabetis	alphabetical.
alfatihah	(islam) first chapter of qur'an recited every prayer time and before praying for dead (esp. at burial), etc.
algojo	1 executioner, hangman. 2 bully. 3 butcher, murderer.
algoritme	algorithm.
alhamdu	(islam) 1 first word of the alfatihah. 2 the alfatihah.
alhamdulillah	(islam) praise be to god (us. said in thanksgiving).
alhasil	1 eventually, in the end. 2 consequently, in sum, the result.
ali-ali	man's ring.
ali-baba	ali-baba
aliansi	alliance.
alias	1 i.e., namely, in other words. 2 otherwise called.
alibi	alibi.
alif	first letter of the arabic alphabet.
alih	shift, change position.
alihbahasa	/alihbasa/ translation.
alik	see ulang.
alim	1 learned. 2 pious, religious, devout.
alimentasi	alimony.
aliminium	see aluminium.
alinea	paragraph.
aling	1 aling-aling shelter, protective cover. 2 mechanical bearing.
alir	1. ideology. 2. smooth. 3. a line with live bait (to catch crocodiles).
aliran	1 current. 2 current, trend, ideology. 3 political grouping, religious sect. 4 school of learning, scholarly tradition. 5 pipeline. 6 conduit, wiring.
alis	eyebrow.
alit	see tali.
aliterasi	alliteration.
aliyah	(islam) senior high school.
aljabar	algebra.
aljasair	/aljazair/ algeria.
aljir	algiers.
alkali	(chem.) alkali.
alkisah	/alkissah/ 1 the story. 2 once upon a time.
alkitab	the bible.
alkitabiah	biblical.
alkohol	alcohol.
alku	(coll.) pimp, procurer.
alkuran	see al-qur'an.
alkus	(zod.) sagittarius.
all round	(coll.) diverse capabilities, versatile.
all-in	(coll.) everything included, complete.
allah	god.
allahumma	(islam) o god (in prayers and koranic recitations).
allamah	(lit.) very learned.
alm.	(almarhum) the late, the deceased.
almahdi	(islam) the messiah (of the last judgment).
almaktub	(rel.) holy book.
almalun	(lit.) the damned.
almanak	1 almanac. 2 calendar.
almarhum	1 the late, the deceased. 2 pass away.
almarhumah	the late, the deceased (of women).
almari	see lemari.
alofon	(ling.) allophone.
alokasi	allocation.
alokir	allocate.
alomorf	(ling.) allomorph.
alon-alon	1. (java) slow, slowly. 2. see alun-alun.
alot	1 tought (of meat). difficult.
alpa	neglectful, inattentive.
alpabet	see alfabet.
alpaka	k.o. alloy.
alpukat	see advokat2.
alri	(angkatan laut republik indonesia) indonesian navy.
altar	altar.
alternasi	alternation.
alternatif	alternative.
alto	alto.
altruis	altruist.
altruisme	altruism.
altruistis	altruistic.
altur	(zod.) taurus.
alu	rice pestle.
alum	faded, wilted, withered.
aluminium	aluminum.
alumni	alumnus, alumna.
alun	wave, swell.
alun-alun	town square.
alunan	alunan
alur	1. 1) gully, channel 2) plot (of a story). 3) slot, groove. 4) space. 2. hold a discussion.
alus	see halus.
aluwung	(java) preferable.
alveolar	alveolar.
am	1 general, ordinary, common. 2 universal.
ama	1 see hama. 2. (jakarta) see sama.
amah	(in some regions only) female ch servant.
amal	1 deed, work. 2 good deed, charity.
amaliah	charitable.
aman	1 peaceful, calm. 2 safe, secure.
amanah	/amanat/ 1 trusteeship, mandate. 2 intruction, mandate, commission. 3 (mil.) order of the day. 4 speech, message.
amandel	1 almond. 2 tonsil.
amandemen	amendment.
amandir	amend.
amang	threat.
amar	(lit.) injunction, command (esp. of god). amar-an order, charge, injunction.
amarah	(lit.) anger.
amat	1 very, exceedingly. 2. 1) watch closely, keep track of. 2) inspect. 3) monitor, guard.
amatir	amateur.
amb	(abri masuk desa) policy of military personnel participating in village development projects.
ambah	trade, handicraft.
ambah-ambah	plague, pest.
ambai	scoop net.
ambai-ambai	k.o. sea crab.
ambal	1. carpet. 2. ambal-an 1) procession. 2) troops.
ambang	1. 1) threshold, sill. 2) railroad tie. 2. float.
ambar	1. 1) ambergris. 2) amber. 2. see hambar.
ambasadir	/ambasador, ambasadur/ ambassador.
ambeg-parama-arta	(java) first things first.
ambeien	hemorrhoids, piles.
ambek	pout, be unwilling to move, work, or take part. ambek-an tending to sulk.
ambekan	breath, breathe.
ambelas	see amblas.
ambeles	see ambles.
amben	1 sash worn with woman's sarong. 2 wooden or bamboo platform for sleeping.
amberol	see ambrol.
amberuk	see ambruk.
ambet	1 diaper. 2 swaddling clothes. 3 bindings, bandage.
ambia	the prophets (plural of nabi).
ambigu	ambiguous.
ambiguitas	ambiguity.
ambik	(call., m) see ambil.
ambil	take. ambil-alih take over.
ambin	1 strap, sling. 2 see amben2.
ambing	udder.
ambisi	ambition.
ambisius	ambitious.
ambivalen	ambivalent.
ambivalensi	ambivalence.
amblas	disappear, vanish.
ambleg	/amblek/ give way, collapse (of a bridge, etc.).
ambles	mire, bog down, sink in mud. ambles-an (geol.) subsidence.
amboi	hey ! (exclamation of surprise or sympathy).
ambok	arrogant, haughty.
ambrek	untidy, messy.
ambreng	strong-smelling.
ambrin	(coll.) sweetheart.
ambring-ambringan	indescribable, unheard of.
ambrol	1 collapse (esp. of flat surfaces), sag. 2 be destroyed.
ambruk	collapse (houses, buildings). fall down.
ambu-ambu	k.o. fish, the bonito.
ambul	1 bounce, rebound, ricochet. 2 bob up and down.
ambulan	/ambulans/ ambulance.
ambung	bounce, soar.
ambyar	(java) splatter, fall apart.
ambyuk	(java) 1 swarm, gather in large numbers. 2 fall down (of a tree).
ame	(jakarta) see sama 1,2.
amen	statement uttered when begging.
amendemen	see amandemen.
amendir	see amandir.
amerika	1 n. or s. america. 2 america, american.
amerikanisasi	americanization.
amerikanisme	americanism.
amfibi	amphibian (vehicle, animal).
amil	(islam) mosque official who collects the tithe.
amin	amen.
amir	(lit.) commander, leader (of gvt.).
amirulmukminin	(islam) caliph.
amis	putrid taste or odor of fish.
amit-amit	god forbid !
ammaba'dah	/ammaba'dahu/ and furthermore (used in formal correspondence and speeches).
ammi	illiterate
amn	(akademi militer nasional) national military academy.
amnesti	amnesty.
amoh	(java) in rags.
amoi	(in some regions only) form of address and reference to china girl.
amok	see amuk.
amonia	/amoniak/ ammonia.
amor	(lit.) love. dewi-amor goddess of love.
amoralitas	amorality.
amorf	(biol.) amorphous.
amortisasi	(econ.) amortization.
amour	see amor.
amoy	see amoi.
ampai	1 slim, slender.
ampai-ampai	jellyfish.
ampang	1 insipid, tasteless. 2 see empang.
ampas	waste, dregs.
ampat	(jakarta) see empat
ampe	see sampai.
ampek	1 have difficulty breathing. 2 asthma.
ampela	chicken gizzard.
ampelas	see amplas1,2.
ampelop	see amplop.
amper	1 (madura) porch, veranda. 2 . 1) (elec.) ampere. 2 electric meter.
ampera	(amanat penderitaan rakyat) message of the people's suffering (soekarno-era slogan).
amphibi	/ampibi/ (coll.) see amfibi.
ampir	see hampir.
ampiran	(java) stopping-off place.
ampitasi	see amputasi.
ampiteater	amphitheater.
ampitir	meng-ampitir amputate.
amplas	1 fig tree. 2 sandpaper.
amplasemen	see emplasemen.
ampli	/amplifayer/ amplifier.
amplop	envelope.
ampo	k.o. red medicinal clay for stomach upsets.
amprok	meet, run into.
ampu	1 support, prop up .2 see empu.
ampuh	1 1) endowed with magical power. 2) potent, efective (of medicine). 2. flood, overflow, inundation.
ampul	1 (med.) ampul. 2 swell, expand.
ampun	1 pardon, forgiveness. 2 mercy.
amput	(java, vulg.) have sexual intercourse .
amputan	1 female genitalia. 2 mistress.
amputasi	amputation.
amputir	see ampitir.
amra	k.o. mango.
amril	1 sandpaper. 2 emery board or paper.
ams	(algemene middelbare school) k.o upper secondary school (colonial era).
amsal	1 proverb. 2 parable. 3 (bib) proverbs.
amsiong	(china) internal injury.
amtenar	government official.
amtenarisme	officialism, bureaucratism.
amuba	amoeba.
amubawi	amoebic.
amuk	1 go berserk, run amuck. 2 rage violently.
amukan	1 fight. 2 uncontrolled raging.
amunisi	ammunition.
ana	(jakarta, used by those of arab descent or educated in islam schools) i.
anafora	anaphora.
anaforis	anaphoric.
anak	1 child. 2 offspring. 3 native of. 4 member of a group. 5 dependent, sub, smaller variant, accessory of. 6 term of address to a child (most often as nak).
anakanda	(lit.) 1 child, son (respectful, use mostly in letters with the meaning i or you). 2 familiar form of address to young people.
anakronisme	anachronism.
analis	analyst, analyzer.
analisa	analysis, examination.
analisawan	analyst.
analisir	analyze.
analisis	analysis.
analitik	analytic.
analitikus	analyst.
analitis	analytical.
analog	analog.
analogi	analogy.
anam	see enam.
ananda	see anakanda.
anarkhis	1 anarchic. 2 anarchist.
anarki	anarchy.
anarkis	see anarkhis.
anarkisme	anarchism.
anasir	element.
anatomi	anatomy.
anbia	see ambia.
ancai	disabled (of a ship).
ancak	1 bamboo stand or container for offerings to spirits. 2 rack, shelf.
ancak-ancak	indifferent, casual, nonchalant.
ancam	say s.t. threatening.
ancar-ancar	/ancer-ancer/ 1 estimate. 2 target date, time, or amount.
ancoa	(china) how's it going ?
ancuk	(java, vulg.) copulate.
anda	you (common in newspapers and journals, and sometimes used in speech as a neutral form).
andai	if. andai-nya supposing or suppose that.
andak	1 (naut.) reef, take in ( a sail). 2 limit, restrict, decrease.
andal	1 rely on. 2 trade on.
andalan	1 mainstay. 2 security, pledge. 3 chief seat (at national or territorial level).
andalas	(lit.) sumatra.
andam	1. 1) trim o's hair or beard neatly. 2) have a hairstyle that requires care. 2. lock up. 3 (m) grave.
andang	torch.
andang-andang	1 (jakarta) mole, birthmark. 2 (naut.) yardarm.
andap	(java) able to be humble.
andapita	k.o. cake.
andar	1 explain in great detail, give a long-winded account. andar-an protracted account, explanation. 2 see mati.
ande	see handai, andai.
andel	see andal.
andeng-andeng	see andang-andang.
andepi	see andewi.
anderak	elephant pit.
anderok	slip, petticoat.
andewi	endive.
andi	title of nobility in s. sulawesi.
andil	1 (fin.) share. 2 contribution.
andon	see andun.
andong	four-wheeled carriage drawn by two horses common in central java.
anduk	1. 1) hold up high in a strap. 2) hold. 2. see handuk.
andukan	1) support, prop. 2) sling.
andun	go to.
andunan	outsider.
andung	(medan) grandmother.
ane	(jakarta) see ana.
aneh	strange, queer, peculiar.
aneka	various, diverse, all sorts of.
anekdot	/anekdote/ anecdote.
aneksasi	annexation.
anem	see enam.
anemer	building contractor.
anemi	anemia.
anestesi	anesthesia.
anestesiologi	anesthesiology.
anfal	(coll.) 1 attack. 2 heart attack.
ang	(m) you (when addressing males).
angah	see enga2.
angan	1 thought, notion, idea. 2 chimera, illusion.
angan-angan	1 thought, notion, idea. 2 fantasy, illusion, day dreaming.
angcui	k.o. red china liquor.
angel	(java) 1 difficult. 2 strange, unusual.
anget	see hangat.
angga	tine, branch of antler.
anggak	conceited, arrogant, haughty.
anggal	1 light, insignificant. 2 slack, light. 3 lightly loaded (of a ship).
anggap	1 opinion. 2 (lit.) nod the head to invite another to join in dancing or drinking.
anggapan	1. 1) opinion, belief. 2) judgment. 3) suspicion, hunch, impression. 2. such an invitation (by a nod) to dance or drink.
anggar	1 estimate, calculate, compute. 2 (sport) fencing. 3. 1) (av.) hangar. 2) shed, warehouse (at harbor). 3 quay.
anggaran	estimate, calculation, consideration.
anggauta	see anggota.
angger	fixed (of prices).
anggerek	/anggerik/ see anggrek.
anggit	1 lace, thread, string (shoes, etc.) 2 fasten or secure with rattan (for thatching). 3 composed, draft.
angglap	(coll.) 1 embezzle (money). 2 steal (goods). 3 default, welsh (on debts).
anggota	1 member. 2 member, limb. 3 part, component.
anggrek	orchid.
anggrekwan	orchid grower or enthusiast.
angguk	nodding of head (to indicate agreement or due to dozing).
anggul	the head, tip upward.
anggun	1 neat, hansome. elegant (of building or appearance). 2 affected, pretentious. 3 haughty.
anggung	lift, raise.
anggur	1. 1) be unemployed, be idle. 2) lie idle. 2. slip. cutting (of plants). 3. 1) grape. 2) wine.
anggut	1 nod due to drowsiness. 2 move erratically, pitch (of a ship).
anghun	(china) k.o. tobacco.
angin	1 wind. 2 air. 3 rumor.
angin - anginan	blow hot and cold, fickle, be capricious.
angina	tonsilitis.
angit	odor of burnt rice or bread.
angka	1 figure, numeral, digit. 2 rate. 3 mark, grade.
angkar	see angker.
angkara	(lit.) 1 greedy (for power, wealth, position). 2 egotistical, self-centered. 3 brutal violence, savagery.
angkasa	1 sky. 2 heaven, firmament. 3 atmosphere.
angkasawan	1 spaceman, astronaut. 2 broadcaster, announcer.
angkasawati	1 spacewoman, female astronaut. 2 female broadcaster, announcer.
angkat	1 lift, raise. 2 take away, remove (esp. in petty commerce). 3 (in set phrases) begin to do s.t.
angkel	pocket money given to a military recruit.
angker	1. 1) eerie (esp. of haunted places). 2) (coll.) terrible. 2. 1) anchor. 2 motor armature.
angket	1 inquiry, poll. 2 questionnaire.
angkin	(china) cloth waistband, sash worn by women.
angkit	remove hot pans or coals from the fire.
angklung	musical instrument consisting of suspended bamboo tubes which sound when shaken.
angkong	k.o. gambling game with three cards.
angkong-angkong	sit idly, do no work.
angkota	see angkuta.
angkringan	(java) long carrying pole with hampers on either end.
angku	see engku.
angkuh	1 arrogant, conceited. 2. form, appearance.
angkup	tweezers. angkup-angkup 1 valve. 2 tweezers.
angkut	1 carry, transport. 2 carry away. 3 contain.
angkut-angkut	k.o. wasp.
angkuta	(angkutan kota) gvt. organized small vehicle transportation systems in small urban centers.
anglap	see angglap.
angler	1 pleasant. 2 smooth. 3 quiet, tranquil.
angler - angleran	calm, content.
anglisisme	anglicism.
anglo	brazier.
anglong	1 terrace. 2 speak in a confused manner.
angon	(java) graze cattle.
angonan	livestock.
angop	(java) a yawn.
angot	1 have a relape, become angry or ill again. 2 be delirious.
angpau	(china) gift of money in a red envelope (esp. at china weddings, new year).
angsa	goose.
angsana	k.o. tree.
angsio	(china) red-braised cooking.
angsu	(java) draw water.
angsur	1 little by little. 2 move forward a little. 3 in installments.
angus	see hangus.
angut	1 nap, doze. 2 fritter o.'s time away.
ani	wooden device of loom where warp fits.
ani-ani	small palm-held reaping knife for cutting rice stalks.
aniaya	1 ill treatment. 2 tyranny, oppression. 3 injustice.
aniem	/arim/ (algemene nederlandsch indisch electriciteit maatschappij) electricy (company) (esp. of colonial era).
animis	animist.
animisme	animism.
animo	1 zest, energy, gusto. 2 interest.
aning-aning	k.o. large wasp or bee.
anion	(chem.) negatively charged ion.
anis	anise, anisette.
anja-anja	spoiled, pampered.
anjak	thrust, push, shove.
anjal	1 bounce, rebound. 2 elastic, springy, resilient.
anjang-anjang	1 k.o. sea fish, the gurnard. 2 small trellis of split bamboo, lattice.
anjangkarya	field trip,study tour.
anjangsana	a visit of a high official to the field for inspection or to another country.
anjar	anchor.
anjiman	(lit.) merchant ship of the brithis e. indian company.
anjing	1 dog. 2 (derog.) despicable fellow.
anjing-anjing	k.o. tree.
anjir	k.o. tree.
anjlog	1 descend rapidly, plummet. 2 shift rapidly.
anju	attempt, running start.
anjung	1 extension, annex (often an enclosed veranda). 2 ship's bridge. 3 (r.r.) platform (of coach).
anjur	1. 1) stick out, jut out, protrude. 2) move on or toward. 2. withdraw.
anjuran	1 proposal, suggestion. 2 recommendation, advice.
anm.	(anumerta) posthumous.
annemer	see anemer.
annuitet	see anuitet.
ano	see anu.
anoa	/anoang/ (sulawesi) dwarf buffalo.
anoda	anode.
anom	(java) young.
anomali	anomaly.
anomi	anomie
anonim	anonymous.
anonimitas	/anonimitet/ anonymity
anonser	announcer.
anotasi	annotation.
ansambel	ensemble.
ansar	/ansor/ (islam) muh.'s followers in medina when he departed mecca.
ansur	see angsur.
ant.	(antara) indonesian news agency.
anta	see antah2.
antagonis	antagonist.
antagonisme	antagonism.
antagonistis	antagonistic.
antah	1 rice chaff, bran. 2 ber-antah fabled, imaginary. 3 see entah.
antakusuma	see baju.
antam	see hantam.
antamer	/antamir/ undertake, tackle.
antan	rice pestle.
antap	1 calm, quiet. 2 see antep.
antar	1 accompany. 2. inter-antar (used in compounds).
antar-antar	1 rotor. 2 piston rod.
antara	1 between. 2 in, about (of time). 3 not far from. 4 in the meanwhile.
antarabangsa	see antarbangsa.
antarbangsa	international.
antari	see baju.
antariksa	1 (outer) space, interplanetary space. 2 planetary atmosphere.
antariksawan	astronaut, cosmonaut.
antariksawati	female astronaut or cosmonaut.
antartika	antarctic.
antarvokal	(ling.) intervocalic.
anteb	see antep.
antedatering	retroactive dating.
antedatir	date s.t. retroactively.
antek	(coll.) henchman, lackey
antelas	see kain.
antem	see hantam.
antena	/antene/ antenna, aerial.
anteng	(java) 1 calm, quiet. 2 being quiet and sticking to o.'s work.
antep	(java) heavy, solid, massive.
anter	see antar1.
antere	/anteri/ see antre.
antero	whole, all, total, entire.
anteseden	antecedent.
anti	1 be opposed to. 2 anti-, resistant to. anti-biotika antibiotic. anti-gemuk nonfattening. anti-karat stainless (steel), rustproof. anti-peluru/pelor invulnerable to bullets. anti-perang antiwar.
antih	spin.
antik	1. 1) antique. 2) ornate, higly embellished (furnishings, etc.). 3 eccentric. 2. 1) lively. 2) cute (esp. of children).
antiklin	(geol.) anticline.
antilop	antelope.
antimon	/antimonium/ antimony.
anting	anting-anting 1 pendant, earring. 2 pendulum of clock.
anting-anting	drongo bird.
antipati	antiphaty.
antipoda	/antipode/ 1 antipodes. 2 wholly opposite (of individuals).
antisemit	anti-semite
antiseptis	antiseptic.
antisipasi	anticipation.
antisipir	meng-antisipir anticipate.
antitesa	/antitese, antitesis/ antithesis.
antologi	anthology.
antonim	antonym.
antonimi	antonymy.
antrasit	anthracite.
antre	/antri/ stand in line, queue up.
antropolog	anthropologist.
antropologi	anthropology.
antuk	1 come in contact with, touch. 2 see kantuk.
antul	bounce, rebound (of a ball).
antun	see orang.
antung-antung	hanging holder for earthen jugs.
antup	sting.
antusias	enthusiastic.
antusiasme	enthusiasm.
anu	1 whatchumacallit, what's-his-name (hesitation form). 2 (math.) unknown quantity. 3 say, by the way.
anuang	see anoa.
anugerah	1 (rel.) a gift from god. 2 gift from a person of higher status to o. of lower status.
anuitet	annuity.
anulir	annul, cancel.
anumerta	posthumous.
anut	attentive, meek, pliant.
anyal	1 peevish, petulant. 2 resentful, annoyed.
anyam	plait.
anyaman	1 cane work, plaited mats. 2 plait, tress, braid.
anyang	k.o. salad of raw meat and shellfish or raw fruit with spices.
anyar	(java, madura) new.
anyelir	carnation.
anyep	(java) 1 bland not salty. 2 clammy, damp.
anyes	(java) cold and damp.
anyir	rancid, rank, smelling of fish oil.
ap	(angkatan perang) armed forces.
apa	1 what, which. 2 a quetion marker. 3 or. 4 eh (hesitation marker, filler word).
apabila	(lit.) when (esp. in indirect questions).
apak	musty, moldy, sweaty.
apakala	(lit.) when (esp. in temporal clauses,).
apal	see hafal.
apalagi	1 above all, especially. 2 even less, let alone. 3 moreover, besides.
apalah	1 please. 2 what does it amount to ? (nothing !).
apam	k.o. rice flour cake.
aparat	1 apparatus, appliance, instrument. 2 institution, agency.
aparatur	apparatus.
aparteid	see apartheid.
apartemen	apartment.
apartheid	apartheid.
apas	1 elegant. 2 (coll.) be unlucky, be jinxed.
apati	apathy.
apatis	apathetic
apatisme	apathy.
apbn	(anggaran pendapatan dan belanja negara) national budget.
apdeling	see afdeling.
apdn	(akademi pemerintahan dalam negeri) civil service academy.
apdol	see afdal.
ape-ape	k.o. cake made from wheat flour.
apek	see apak.
apel	apple.
apem	see apam.
apermut	see havermut.
apersepsi	apperception.
apes	see apas2.
aphasi	see afasi.
api	1 fire. 2 flame, blaze. 3 spirit.
apik	1 neat and nice, trim. 2 attractive, chic.
apikal	apical.
apit	hemmed in, wedged in.
apitan	1 clam 2 (elec) terminal 3 press extractor (sugarcane , petroleum) 4 intercalation , interpolation.
apium	raw opium.
apkir	1 cast off. 2 rejected (for the army).
aplikasi	application.
aplos	1 relieve, take turns. 2 redeem.
aplus	1. applause. 2. see aplos.
