menguntir	twist.
menguntukkan	allocate, assign.
menguntungkan	cause s.o. to enjoy a profit or benefit.
mengunyah	1 chew, masticate. 2 digest (advice, a problem, etc.)
mengunyai	do s.t. slowly.
mengupacarai	/mengupacarakan/ hold a ceremony for.
mengupahi	pay s.o. wages or some remuneration.
mengupahkan	have s.t. done upon payment.
mengupam	polish, burnish.
mengupayakan	strive for, seek.
mengupgrade	/apgred/ upgrade s.t.
mengupil	1 pick o.'s nose. 2 form scab on a wound.
mengurah	1 (m) demolish, tear down. 2. relate.
mengurai	become disentangled.
menguraikan	1 loosen, disentangle (o.'s hair, a fastening, etc.). 2 scatter. 3 explain, analyze.
mengurapi	rub with ointment.
mengurapkan	apply s.t. to the body.
mengurat	1 be rooted. 2 become tough.
menguruk	1 bury. 2 fill (with soil, sand, etc.).
menguruki	put sand or soil on.
mengurungkan	1 cause to fail. 2 abandon, cancel.
mengurup	1 barter, exchange. 2 change money.
mengurus	1 arrange matters (with a higher-up). 2 take care of, manage.
mengurusi	take care of.
menguruskan	1 manage, run. 2 take care of on s.o.'s behalf, handle for s.o.
mengurut	1. 1) massage, rub. 2) caress, stroke. 2. 1) put in the right order. 2 trace s.t.
mengurutkan	put s.t. in the right order.
mengusahakan	1 carry on, expend o.'s energy at s.t. 2 organize, manage.
mengusang	dry up, wither.
mengusap	1 wipe s.t. off. 2 caress, stroke.
mengusapkan	wipe with s.t.
mengusik	1 tease. 2 touch on. 3 (phys.) perturb.
mengusir	chase away, drive out, expel.
mengusuli	examine s.o.
mengusulkan	propose, suggest.
mengusung	carry (together with others) on the shoulders.
mengusut	1 feel all over, handle. 2 examine.
mengutak-atik	/mengutak-utik/ tinker with s.t.
mengutamakan	consider as most important, give priority to.
mengutarakan	present, state in public.
mengutik	1.tinker with 2.pick (o.s nose ) 3.cavil,look for faults in another person.
mengutik-utik	touch with a finger, poke into s.t. to examinate it.
mengutip	1 pick up small bits (money, rice grains, etc.). 2 copy a portion, cite, excerpt s.t.
mengutuskan	delegate s.o.
menguyel-uyelkan	cause to jostle.
menhankam	[menteri pertahanan dan keamanan] minister of defense and security.
menhub	[menteri perhubungan] minister of communication.
meni	orange paint used as antirust primer.
meniadakan	1 abolish, destroy, nullify. 2 consider nonexistent.
meniangi	provide with poles, posts, masts, etc.
meniarap	(lie) face downward.
meniarapkan	place s.o. or s.t. face downward.
meniduri	1 (of a man) to have intercourse with s.o. 2 lie or sleep on s.t.
menidurkan	1 put to bed. 2 lay s.t. down.
menikam	1 stab s.o. 2 be cutting, be biting (words, wind, etc.). 3 put up a stake in a card game, etc.
menikamkan	stab with s.t.
menikmati	1enjoy. 2 benefit from.
menikung	1 curve or bend. 2 make a turn.
menilang	issue a traffic ticket.
menilik	1 tell the future. 2 observe carefully, watch. 3 consider, examine carefully. 4 supervise.
menimang	rock (a child) in o.'s arms or a cradle.
menimang-nimang	1 (lit.) test the balance of s.t. by shifting it in o.'s hand. 2 observe by holding in the hand. 3 consider an issue carefully.
menimba	1 bail out (a boat). 2 draw (water) from a well, etc.
menimbali	counterbalance, counter s.t.
menimbang	1 weigh. 2 consider, take into account. menimbang-terimakan hand over, transfer.
menimbangi	1 repay, counterbalance. 2 be in proportion to.
menimbangkan	weigh out on behalf of s.o.
menimbrung	(java) 1 interfere in s.o.'s affairs. 2 butt in on a conversation.
menimbrungi	interrupt a conversation.
menimbulkan	1 make s.t. to come to the surface. 2 cause s.t. to occur or appear.
menimbun	1 be heaped up, become piles. 2 be piled up on. 3 heap s.t. up.
menimbuni	heap piles on s.t.
menimbunkan	1 pile s.t.up. 2 accumulate s.t.
menimbusi	fill up s.t.
menimpai	1 fall on. 2 descend upon, strike down.
menimpakan	1 cause s.t. to fall upon. 2 blame.
menimpang	1 be unbalanced. 2 limp.
menimpe	(jakarta) swipe, pilfer.
menimpuki	(jakarta) throw at.
menimpukkan	throw s.t.
meninabobokan	lull to sleep.
menindak	take ation against.
menindakkan	carry on s.t.
menindas	1 crush with snapping action (esp. insects). 2 oppress. 3 suppress.
menindih	/menindihi/ 1 press with s.t. heavy, place a weight on s.t. 2 suppress. 3 oppress.
menindihkan	press wiht s.t.
menindik	pierce.
meninggal	die, pass away.
meninggali	1 live in, stay at. 2 leave behind to, bequeath.
meninggalkan	1 leave s.t. behind. 2 leave.
meninggi	1 go high, rise, advance. 2 boast, be boastful.
meninggikan	1 raise, heighten. 2 increase, enhance.
meningkahi	1. put on airs toward s.o., contradict. 2. strike a musical instrument to accompany other instruments.
meningkap	(lit.) peer from a window.
meningkar	(sunda) surround.
meningkat	1 rise, mount. 2 be promoted, advance. 3 terrace.
meningkatkan	1 increase s.t., raise. 2 upgrade.
meninjau	1 watch, observe at a distance. 2 view, consider. 3 observe s.t., reconnoiter s.t., survey s.t. 4 guess from afar.
meninju	be engaged in a fist fight.
menipis	1 become thin. 2 diminish, become less and less.
menipiskan	1. make s.t. thin. 2. dilute s.t. 3 reduce, decrease.
menipu	deceive s.o.
menir	1. finely ground grains of rice. 2. see meneer.
meniran	(java, jakarta) tired from speaking (of the lips).
meniru	imitate, do as s.o. does.
menirukan	imitate s.t.
menirus	taper, come to a point.
menisiki	darn, mend.
menisikkan	give to s.o. to mend.
menit	minute.
menitahkan	command, decree s.o.
meniti	walk on s.t. elevated, narrow, and long.
menitik	1 drip. 2 place a period.
menitikberatkan	1 stress, emphasize. 2 count heavily on.
menitiki	sprinkle on s.t.
menitikkan	cause s.t. to drip.
menitipi	entrust to s.o.
menitipkan	/menitip/ entrust s.t. to s.o. for a short period.
menitir	sound an alarm in such a way.
menitis	1(java) become incarnate. 2 (coll.) descend into o.'s offspring (of traits, etc.).
meniup	1 blow. 2 blow air into or through.
meniupi	1 blow on s.t. 2 blow on s.o. as part of a healing ritual.
meniupkan	1 cause to spread, cause to fan out. 2 blow on or up on behalf of s.o.
menj-	see also entries with j-.
menjabat	1 takehold of, grasp. 2 occupy an office.
menjadi	1 become 2 be 3 as,be 4 boil down to 5 succeed ,win out,go through with.
menjadikan	1 make into s.t 2 conclude ,bring into being 3 create ,make 4 cause bring about , bring to pass.
menjahanamkan	1 ruin, destroy. 2 curse, swear at.
menjahit	1 sew, stitch. 2 tailor. tailor, seamstress.
menjajaki	1 probe, sound out. 2 (naut.) fathom, take soundings, plumb.
menjajarkan	pull, drag s.t.
menjak	see semenjak.
menjalani	1 wolk on 2 undorge , endure ( an operation , military training ,punishment, etc ) 3 go through a period of o,s life . 4 travel trhough s.w .
menjalankan	1 drive ( car et ), operate ( machine) 2 start , put into operation ( a car etc ) 3 carry out , perform (o,s duty ) put into effect 4 serve ( prison sentence ) .
menjalar	1 creep, crawl (of snakes, plants). 2 spread (of fire, disease, etc.).
menjangan	(java, lit.) deer.
menjangat	1 skin, flay, fleece. 2 strip bark.
menjangkakan	1 measure (with calipers). 2 plan, work out.
menjangkau	1 reach. 2 reach to. 3 reach for. 4 reach out. 5 reach out, extend to.
menjaring	1 catch or pick up in a net. 2 encompass, embrace (a large area, etc.).
menjatuhkan	1 let fall , drop 2 drop , supply a lower level with money 3 toppley , overthrow , bring down ( the gvt,regime ) 4 ruin , topple , ruin a good name 5 (leg) pass (a sentence,judgement),hand down (a verdict,decision) .
menjauhi	1 avoid, keep away from. 2 be far from.
menjawikan	1 translate into malay. 2 put into the malay script.
menjayakan	glorify, extol.
menjebak	1 trap (animals, birds). 2 trap, frame s.o.
menjebloskan	1 throw s.t. into. 2 throw (into jail).
menjebol	1 break down (a door, etc.). 2 penetrate (enemy lines, etc.). 3 break through (a wall, etc.).
menjebrolkan	1 produce, bring forth, give birth to. 2 eject, expel s.t.
menjegali	interfere with, interrupt.
menjeglegkan	punch a hole in.
menjelajah	1 cruis over seas, cross land areas. 2 explore (an area, etc.). 3 examine.
menjelang	1 call on, pay o,'s respects to. 2 visit. 3. to (used to address mail). 4 around, toward. 5 approach, come close to.
menjelangak	look upward.
menjelempah	lie scattered about.
menjelirkan	stick out (o.'s tongue).
menjelmakan	1 create. 2 realize, bring about.3 transform s.o. or s.t.
menjelujur	1 baste (a hem). 2 tie or stitch together.
menjelujuri	1 stitch s.t. on. 2 hold s.t. together with a thread. 3 go over the lenght of s.t. 4 investigate.
menjemput	1 pick up (with fingertips). 2 pick up (figuratively). 3 call for, fetch.
menjemukan	1 bore s.o., boring. 2 tiresome, irksome.
menjemur	spread out in the sun to dry.
menjenguk	1 look or observe with head thrust forward. 2 pay a call, look in on.
menjentik	1 pinch, tweak, nip. 2 flick, rap with the fingers. 3 rap, scold, criticize s.o.
menjepitkan	1 squeeze, pinch s.t. 2 clip s.t., affix s.t. with clips.
menjepret	1 hit with a slingshot. 2 take a snapshot of.
menjerakan	1 teach s.o. a lesson. 2 frighten, intimidate. 3 be wary of, learn to avoid.
menjerat	1 snare. 2 trick, deceive, round up (criminals). 3 entice, inveigle (customers). 4 snarl, tangle.
menjeriau	install such joists.
menjering	chirp, cheep (of birds, etc.).
menjernihkan	1 make s.t. clear, clear up (a misunderstanding). 2 purify, cleanse
menjewang	snatch s.t. up.
menjidari	1 provide a line. 2 make a line with a ruler.
menjijikan	1 loathe, abhor, abominate. 2 nauseating, loathsome.
menjilat	1 lick. 2 flatter, curry (favor), apple polish.
menjinakan	curl the lower lip down (to tease).
menjiwai	menjiwai
menjojol	1 protrude (of eyes). 2 protrude upward (of palisades, etc.).
menjorokan	1 make s.t. protrude. 2 push or shunt aside.
menjotoskan	menjotoskan
menjuarai	win out, come up as champion.
menjublek	be silent, speechless (us. in bewilderment).
menjulur	1 stick outward. 2 panhandle, beg in street.
menjumpai	1 find. 2 go to meet. 3 meet with, encounter.
menjurus	1) point, lead (in certain direction, etc.). 2) go in a certain direction.
menkeh	[menteri kehakiman] minister of justice.
menkes	[menteri kesehatan] minister of public health.
menkesra	[menteri kesejahteraan rakyat] minister of public welfare.
menkeu	[menteri keuangan] minister of finance.
menko	[menteri koordinator] coordinating minister.
menkop	[menteri koperasi] minister of cooperatives.
menlu	[menteri luar negeri] minister of foreign affairs.
menmud	[menteri muda] undersecretary.
menobatkan	crown, install.
menodong	1 threaten s.o. by pointing a weapon. 2 commit armed robbery.
menodongkan	threaten by pointing with s.t.
menohok	stab downward.
menohokkan	use s.t. in a downward piercing motion.
menohorkan	dry s.t. up.
menojok	thrust (s.t. long) into s.t.
menojokkan	thrust s.t. (of long things).
menojor	hit with a fist.
menokoh	cheat, deceive.
menokohi	run, lead (a group).
menokohkan	feature s.t.
menokok	1. give or say s.t. extra. 2. tap, pound at.
menokong	shave.
menolak	1 push. 2 push aside, prevent. 3 repel. 4 reject. refuse. 5 (math.) subtract.
menolakkan	1 push away. 2 push off on to.
menoleh	1 turn o.'s head. 2 look toward by turning the head.
menolehkan	cause o.'s head or attention to turn somewhat.
menolok	compare.
menolong	help, aid, assist s.o.
menolongi	repeatedly help with s.t.
menombak	stab with a spear.
menombok	1 (jakarta) pay extra, pay an additional fee. 2 stake out money in gambling.
menomboki	1 add a sum of money to. 2 pay extra (of many persons). 3 bet on.
menonggak	1. make s.t. erecrt. 2. drink from a container by pouring its contens down o.'s throat.
menongkat	1 raise hight . 2 cane s.o.
menongkatkan	1 hold up with s.t. 2 raise.
menongkrongi	1 squat on s.t., hang out around at. 2 squat on land.
menongkrongkan	let s.t. remain idle.
menonjok	hit with the fist, fight.
menonjol	1 protrude, stick out. 2 conspicuous, prominent.
menonjol-nonjolkan	show s.t. off which is not worth showing off.
menonjolkan	menonjolkan
menonton	1 watch for entertainment, observe. 2 go to the movie.
menontoni	1 visit the family of o.'s future in-laws (to obtain information). 2 meet e.o. for mutual inspection (of future bridal pairs in arranged marriages).
menontonkan	1 show (off), exhibit. 2 play, perform.
menopang	1 prop up, shore up. 2 tidak-menopang contradict.
menopangkan	lean s.t. on.
menor	garish, gaudy in dress or make up.
menoreh	1 make a shallow cut. 2 slit open.
menpan	[menteri negara penertiban aparatur negara] state minister or control of machinery of the state.
menpen	[menteri penerangan] minister of information.
menpera	[menteri negara urusan perumahan rakayat] state minister of public housing.
menperdag	[menteri perdagangan] minister of trade.
menperhub	see menhub.
menpora	[menteri negara pemuda dan olah raga] state minister of youth and sports.
menpplh	[menteri negara pembinaan dan pelestarian lingkungan hidup] state minister of environmental affairs.
menristek	[menteri negara riset dan teknologi] state minister of research and technology.
mens	(coll.) menstruation, menstruate.
mensekneg	/mensesneg/ (menteri sekretaris negara] secretary of state.
menselkan	put into a prison cell.
mensentraliser	centralize.
menservis	service (of engines, etc.).
mensiang	k.o. rush.
mensinyalir	call attention to, point out.
mensinyalkan	give a signal.
mensistematikkan	systematization.
mensistematisasikan	systematize.
menskors	1 suspend s.o. 2 adjourn.
menslenger	crank, start a car with a crank.
menslogankan	utter s.t. as a slogan, make s.t. into a slogan.
mensolder	solder.
mensortir	sort (of mail, etc.).
mensos	[menteri sosial] minister for social affairs.
menstabilisasikan	stabilize.
menstabilo	mark a text with a highlighting pen.
menstarter	(coll.) start an angine.
mensteling	1 set up barricades around s.t. 2 (mil.) take up a position.
mensterilkan	sterilize.
menstimulasikan	stimulate.
menstimulir	stimulate.
menstruasi	menstruation.
mensublimir	sublimate.
mensubordinasikan	subordinate.
mensubstantifkan	make into a substantive.
mensubstitusikan	substitute.
mensucikan	1 purify, disinfect, clean. 2 sanctify.
mensugestikan	persuade s.o. to be of the same opinion.
mensyariahkan	/mensyariatkan/declare a certain deed to be islam law.
mensyukuri	1 be grateful to god to god about s.t. 2. (coll.) thank s.o.
mensyurkan	1.1) attract, absorb o.'s interest. 2) arouse, sexual desire. 2. advise, recommend.
ment-	see also entries with t-.
mentaati	1 ahere to, obey s.t. 2 be faithful to.
mentabukan	consider s.t. taboo.
mentafahus	1 search s.t. 2 examine s.t.
mentah	1 unripe, raw, uncooked. 2 incomplete, unfinished. 3 raw, unrefined.
mentahbiskan	consecrate, ordain.
mentahkikkan	(lit.) verify.
mentajaki	work soil or chop down weeds with such a tool.
mentajin	1 feed rice water (to an infant). 2 starch o.'s clothes.
mentajinkan	make rice water or starch out of s.t.
mentajong	strike (with the arm).
mentajuk	1 protrude. 2 prominent, well known.
mentajukkan	make s.t. into an editorial..
mentak	(jakarta) probable. ke-mentak-an probability.
mentakak	sew two ends of sarong together (to yield tube shape).
mentakdirkan	predestine, preordain
mentakhlikkan	create (of god).
mentakhtakan	crown, enthrone.
mentakik	1 make incisions to extract sap. 2 notch s.t.
mentaklik	read diligently, peruse carefully.
mentakrifkan	define.
mentakuk	cut a notch, incision.
mentakukkan	fix, determine.
mentakung	1 let s.t. settle. 2 cause liquid to accumulate.
mentakup	close itself together firmly.
mentakupkan	close s.t. (two symmetrical things) together firmly.
mentakzimkan	respect or esteem s.o.
mental	1 bounce off, rebound. 2 be launched (of a vessel). 3 uninjured. /me`ntal/ way of thinking.
mentalisme	mentalism.
mentalitas	/mentalitet/ mentality.
mentalkinkan	whispher instructions in the ear of the dead or dying.
mentamsilkan	1 compare. 2 relate in a parable or analogous manner.
mentamyizkan	discern.
mentan	[menteri pertanian] minister of agriculture.
mentanang	carry s.t. with the hands underneath it.
mentandangi	visit.
mentang	mentang-pun although. (se)-mentang-mentang, mentang-kan just because.
mentanting	carry in the palms of the hands.
mentargetkan	aim for s.t., target s.t.
mentari	see matahari.
mentasbehkan	extol god.
mentasdikkan	verify.
mentasrifkan	conjugate.
mentatui	injure.
mentauhidkan	1 acknowlege god's o.ness. 2 concentrate on s.t.
mentawuri	attack in a group.
mente	cashew.
mentega	1 butter. 2 margarine.
mentek	k.o. plant disease.
mentelaah	analyze, study carefully.
menteledorkan	neglect, be careless about.
mentenarkan	make s.o. well known.
menteng	elite section of jakarta. menteng-menteng-an in the mode of s.o. or s.t. from this area.
mententeramkan	1 pacify. 2 reassure, calm.
menteorikan	theorize about s.t.
mentera	see mantera.
mentereng	1 dressed up. 2 luxurious, magnificent.
menteri	1 cabinet minister. 2 (che.) bishop. ke-menteri-an ministry, department.
menterjemahkan	translate.
menterlantarkan	1) cause s.t. 2) pass on (a suggestion, etc.).
menternakkan	breed animals.
menteror	terrorize.
mentertawakan	laugh at.
mentertibkan	1 straighten up, put in order. 2 control, curb.
menterutamakan	consider as most important, give the highest priority to.
menteter	hit repeatedly.
mentilawatilkan	recite (koran) in a competition.
mentimun	cucumber.
mentintai	apply ink to s.t.
mentip-ex	apply white-out to s.t.
mentiriskan	1 cause to leak through. 2 drain.
mentiup-tiup	blow a problem out of proportion.
mentobatkan	cause s.o. to repent and change behavior.
mentok	(java) breast of chicken. /me`ntok/ (java) duck.
mentol	menthol.
mentoleransikan	tolerate.
mentolerir	tolerate.
mentololkan	consider s.o. a fool, make a fool of.
mentonilkan	1 act, perform. 2 dramatize, put into a play.
mentopikkan	use as a topic.
mentorpedir	torpedo s.t.
mentorpedo	torpedo s.t.
mentotalkan	add s.t. up, total s.t.
mentotolkan	cause s.t. to splatter on s.t.
mentour-of-dutykan	transfer s.o. to another post.
mentoyor	(jakarta) strike, punch.
mentraktir	treat s.o.
mentraktori	do work with a tractor.
mentrampilkan	train s.o.
mentransformasikan	tansform.
mentranskripsikan	transcribe.
mentransliterasi	transliterate.
mentransmigrasikan	resettle s.o.
mentransmutasi	transmute.
mentrase	trace.
mentrasir	trace.
mentrindili	(jakarta) rob s.o.
mentrompetkan	trumpet out s.t. (a song, etc.).
mentrondoli	defeat s.o.
mentua	see mertua.
mentuas	lever s.t. up.
mentuba	spread this poison in a pond.
mentubai	poison fish, etc. with such a poison.
mentujah	(lit.) stab downward.
mentukul	hammer.
mentul-mentul	springy.
mentunangi	take s.o. as o.'s betrothed.
mentunangkan	affiance.
mentunasi	prune.
mentunu	roast a fire.
mentunukan	roast for s.o.
menturbakan	cause close contact with the people.
menturis	make a notch or scratch.
mentuter	blow a horn.
mentutul-tutulkan	dab on.
menu	1 diet, what o. eats at a certain meal. 2 what is served at a party.
menua	1 become old. 2 ripen, come to head.
menuai	1 harvest rice by cutting each stalk individually close to the ear with such a reaping knife. 2 reap.
menuakan	menuakan
menuam	be treated with a hot compress.
menuami	apply a hot compress on s.t.
menuang	pour s.t. liquid.
menuangi	pour into s.t.
menuangkan	1 pour s.t. out. 2 cause to pour forth. 3 mold, cast.
menubir	deep, steep.
menubiri	trace the edge of s.t. precipitous.
menubruk	1 lunge at s.o. 2 collide with, run into. 3 run over, hit s.o.
menubrukkan	make s.t. crash into.
menuding	1 point at s.t. 2 accuse.
menudingi	point at repeatedly.
menudingkan	1. make s.t. slant. 2. point with s.t.
menuduh	accuse s.o.
menuduhkan	accuse of, charge with s.t.
menudungi	cover s.t. up carefully, repeatedly shade s.t.
menudungkan	use s.t. for a cover or shade.
menugal	dibble with a pointed stick in order to sow seeds.
menugalkan	sow seeds in this way.
menugasi	give an assignment to.
menugaskan	1 assign s.t. as a task. 2 assign, place s.o. in an assignment.
menuhankan	consider as a god, deify.
menuil	level s.t. up.
menuju	1 go in the direction of. 2 aim, strive. 3 concern, aim (accusation, etc.) at. 4 (lit.) practice a k.o. sorcery on s.o.
menujukan	1 point with s.t. 2 cause s.t. to point in a direction.
menukak	fester.
menukangi	1 craft s.t. 2 repair s.t.
menukar	1 change. 2 exchange, barter.
menukarkan	give s.t. in exchange.
menukas	1. columniate. 2 say in repetition.
menukik	1. dive. 2. make a notch.
menukiki	dive at.
menukikkan	1 let dive, point s.t. downward. 2 point s.t. at, direct s.t. to.
menulahi	curse s.o. or s.t.
menular	1 infect, contaminate. 2 spread.
menulari	spread to s.o. or s.t.
menulikan	make deaf.
menulis	1 write. 2 draw.
menulisi	1 write on s.t. 2 doodle on s.t., jot graffiti on s.t.
menuliskan	1 write s.t. down. write with s.t.
menulup	blow with a pipe.
menumbangkan	1 cause to come crashing down. 2 slaughter (cattle, etc.).
menumbuhi	sprout up over s.t.
menumbuhkan	1 make s.t. grow. 2 cause to emerge or sprout up.
menumbuk	1 pound,crush. 2 strike, deliver a blow to. 3 crash into. 4 let the eyes alight on s.t.
menumbukkan	1 pound with s.t., beat s.t. against. 2 crush for s.o.
menumis	saute at high temperatures.
menumpahi	spill on s.t.
menumpahkan	1 cause s.t. to spill. 2 spill s.t. out, concentrate s.t.
menumpang	1 ride in, go by. 2 join in, go along with use s.t. belonging to s.o. else. 3 stay with. 4 please, may i, (particle preceding polite queries).
menumpangkan	1 cause s.o. or s.t to go with, cause s.o. to be a passenger. 2 cause s.o. to stay with.
menumpas	1 destroy, eradicate. 2 extinguish.
menumpaskan	1 destroy s.t. or s.o.'s behalf. 2 destroy, exterminate.
menumpatkan	cram s.t., stuff s.t.
menumpil	prop up.
menumpu	1 become concentrated. 2 support, sustain.
menumpuk	1 pile up, accumulate. 2 pile s.t. up.
menumpukan	1 lean with s.t., lean s.t on to. 2 provide suppport for s.t. or s.o. 3 cause s.t. to rest. 4 concentrate.
menumpuki	pile up on top of s.t.
menumpukkan	1 pile s.t. up. 2 hoard, accumulate.
menumpul	1 become blunt. 2 become stupid.
menumpulkan	blunt s.t.
menumpurkan	destroy.
menunaikan	1 fulfill, carry out. 2 cash.
menunda	tow.
menundakan	1 postpone, delay. 2 adjourn.
menunduk	bow.
menunduk-nunduk	bow repeatedly, humble o.s
menunduki	bow over s.t.
menundukkan	1 cause s.o. or s.t. to bow. 2 cause s.o. to submit.
menundung	expel, exile.
menung	musing, pondering. ber-menung 1 muse, ponder, meditate. 2 act gloomy. pe-menung dreamer, ponderer. per-menung-an contemplation, musing.
menunggak	be in arrears.
menunggal	1 be alone. 2 be a single entity.
menunggalkan	concentrate into o.
menunggang	ride, mount.
menunggangi	1 ride s.t. 2 use an exiting, activity or situation for o.'s own purpose or profit, get a free ride out of.
menunggangkan	turn s.t. over.
menungging	1 move with the rear and higher than the front. 2 sink bow first. 3 be upside down. 4 dive. 5 bulge toward the bottom.
menunggingkan	1 place s.t. upside down. 2 lift or raise rear portion. 3 overthrow (a high authority).
menunggu	1 wait for. 2 look forward to. 3 (java) stay at a place to take care of what has to be done there.
menunggu-nunggu	look forward to eagerly for some time.
menunggui	1 watch over, look after, guard. 2 take care of, tend, nurse.
menunggukan	watch over on behalf of s.o.
menungkai	kick.
menungkul	1. 1) bow o.'s head. 2) submit. 2. 1) push from behind. 2) do s.t. to s.o. from behind.
menungkulkan	bow s.t.
menungkup	be in a face-downward position.
menungkupkan	place s.t. or s.o. face downward.
menungkus	wrap s.t.
menunjal	(lit.) find footing for a leap.
menunjang	kick s.o. or s.t.
menunjuk	1 point toward, indicate. 2 show, indicate. 3 appoint, designate. 4 raise o.'s band. 5 with reference to (your letter).
menunjuki	advise s.o., train s.o.
menunjukkan	1 point out s.t. 2 indicate. 3 refer.
menuntaskan	treat exhaustively.
menuntun	1 guide s.o. or s.t. by a line, the hand, etc. 2 give guidance to.
menuntung	1 cut into tiny pieces. 2 empty.
menuntut	1 demand. 2 (leg.) prosecute, sue. 3 strive for.
menurun	1 go down, descend, down (in crossword puzzles). 2 decline, sink, decrease. 3 be herditary. 4 (ling.) falling (of tones).
menuruni	1 go down along s.t. 2 go down to, descend to.
menurunkan	1 cause s.t. to go down. 2 discharge passenger or cargo. 3 reduce, lower. 4 send down s.t. to o.'s inferiors. 5 generate (descendants), produce a hereditary line of.
menurus	straight and erect.
menuruskan	(lit.) tie s.o. to a post as a punishment.
menurut	1 follow. 2 according to. 3 imitate, follow along. 4 obey, follow.
menuruti	1 follow . 2 grant. 3 comply with, observe (regulation, etc.).
menurutkan	1 obey, follow. 2 copy, imitate. 3 cause s.o. to follow or joint in.
menusuk	1 stab s.o. 2 prick, stick. 3 skewer s.t. 4 vote by perforating the symbol of o.'s choice on the ballot, punch a ballot. 5 penetrate.
menusuki	1 perforate s.t. in many places. 2 penetrate s.t.
menusukkan	stab or prick with s.t.
menutuh	lop off, trim.
menutuk	1 tap, knock on. 2 strike with o.'s fingers (in martial arts).
menutup	1 close, shut. 2 cover. 3 hide, cenceal. 4 fill in, cover over. 5 lock, shut up in jail.
menutup-nutupi	cover s.t. up.
menutupi	1 provide a cover for. 2 cover up. 3 cover or shut repeatedly.
menutupkan	menutupkan
menuturkan	1 relate, narrate, tell about. 2 pronounce, express. 3 inform, announce.
menwa	[resimen mahasiswa] students with military training.
meny-	see also entries with s-, n-, c-.
menyabet	1 whip. 2 snatch, grab.
menyabetkan	whip s.t. against.
menyabit	cut (grass, rice, etc.). 2. certain, definitive.
menyabot	sabotage.
menyabur	1 disappear into the crowd. 2 become confused.
menyadap	1 make incisions in a tree to obtain sap. 2 sample blood. 3 tap, bug (telephone, information, room, etc.).
menyadari	realize, be aware (of).
menyajikan	1 serve, dish up. 2 provide, supply, present.
menyakral	sanctify, make holy.
menyalang	stab with a knife, dagger.
menyalangkan	open (eyes), see jalang.
menyalip	pass, overtake (a car).
menyamakan	1 compare s.t. (with). 2 treat the same as. 3 place on a par, make the same.
menyamankan	1 makefit, freshen up 2 make pleasant or compfortable .
menyamaratakan	1 treat alike. 2 generalize 3 raze to the ground.
menyambar	1 swoop down and seize. 2 strike, attack. 3 steal, rob.
menyambit	lash.
menyambut	1 welcome, receive. 2 accept. 3 parry, reply. 4 on the occasion of.
menyampaikan	1. 1) convey, extend (information, etc.). 2) hand over, give. 3) deliver. 2. 1) put on (a dress). 2) carry on a pole.
menyampang	paddle at stern of the boat.
menyamperi	call on s.o., drop by to pick s.o. up.
menyan	see kemenyan.
menyandang	1) carry s.t. strapped over the shoulder. 2) bear (a tittle).
menyanggah	protest, oppose, contradicted the truth of the report.
menyanggupkan	1 enable. 2 promise.
menyangka	1 think, suppose. 2 suspect.
menyangkak	have goose flesh, ruffle feathers.
menyangkul	be engaged in hoeing, prepare (ground) for cultivation.
menyangrai	(sunda, jakarta) fry without oil.
menyanyi	sing.
menyapih	wean a child.
menyapu	1 wipe off, brush off. 2 sweep. 3 finish s.t.
menyargut	rip with o.'s teeth.
menyaring	1 filter, strain, sift. 2 refine, distill. 3 sift, separate, sort out (information, meaning, etc.). 4 screen (personel for job).
menyaru	disguise o.s.
menyaruk	1. make o.'s way through (bushesh, jungle etc.). 2. have luck (in game), win.
menyarungi	1 encase. 2 put s.t. on. 3 sheathe.
menyarungkan	use as a sheath, pillowcase, casing, etc.
menyasap	pull up weeds.
menyatakan	1 explain, clarify. 2 declare, assert
menyatroni	(java) be hostile toward.
menyatu	become or be one.
menyatukan	1 unite, joint, ally. 2 concentrate s.t. on.
menyaur	repay a debt.
menyayangkan	1.regret ,deplore,consider s.t to be a pity. 2 spare form s.t bad.
menyayat	1 slice, slash into. 2 touch profoundly.
menycetak	1 print (books, banknotes, etc.). 2 cast, shape, mold. 3 produce, stamp (coins, etc.). 4 achieve, produce.
menyebal	(java) deviate (from a principle).
menyebar	spread.
menyebar-luaskan	spread, disseminate, propagate.
menyebarkan	menyebarkan
menyebuk	1 infiltrate, penetrate. 2 interrupt a conversation.
menyebukan	fill up, plug up.
menyebut	1 mention. 2 name, call.
menyebutkan	name, list names.
menyederhanakan	1 simplify. 2 economize.
menyediakan	1 prepare. 2 set aside (food, funds, etc.) in preparation. 3 equip, supply, make available.
menyedot	1 suck. 2 inhale, sip from.
menyejukkan	cool s.t.
menyeka	rub, wipe, polish.
menyekam	shut in, repress.
menyekir	sand s.t., grind.
menyekutui	joint, ally o.s.
menyekutukan	1. consider as an ally. 2. provide forces as an ally.
menyelak	insist.
menyelakkan	1. open (o.'s shirt, etc.). 2. reveal.
menyelam	1 dive. 2 be under water.
menyelamatkan	1 save, rescue. 2 bury.
menyelamkan	1 convert s.o. to islam. 2 circumcise.
menyelang	1 interrupt, intercede. 2 alternate two things. 3. lend.
menyelapi	take possession of (of a spirit).
menyelapkan	arouse o.'s fury.
menyelaputi	from a thin layer around s.t., coat.
menyelarkan	1 brand. 2 singe, sear. 3 fry (without oil).
menyelatkan	insert, thrust between.
menyelekehi	smear, stain.
menyeleksi	select.
menyelempangkan	worry about.
menyelendangkan	hang, carry on the shoulder.
menyelenggarakan	1 run s.t., take care of, operate. 2 organize. 3 execute, carry out, implement.
menyelengi	put money in a piggy bank.
menyelesaikan	1 finish s.t. 2 solve, settle, discharge (debt, etc.).
menyeleweng	1 deviate, digress. 2 engage in improper activity. 3 be unfaithful in an amorous relationship.
menyelewengkan	divert, deflect, s.t.
menyelidiki	1 investigate. 2 do research. 3 spy, pry into.
menyeligi	throw a javelin.
menyelimpang	deviate from the right path.
menyelimpat	stay clear of, wind s.t.
menyelimuti	1 cover s.t. with a blanket, 2 cover, hide s.t.
menyelimutkan	1 hide behind, use as a cover. 2 cover, blanket with s.t.
menyelinap	1 slitther, move stealthily. 2 get, slip away or into s.t.
menyelinapi	1 crawl, move stealthily into s.t. 2 get, slip into s.t.
menyelingi	intervening, go in between.
menyelip	slip into a place.
menyelipkan	insert s.t. in between.
menyeliputi	cover, envelope.
menyelisik	1 go through the hair to pick lice or nits. 2 investigate, get at the bottom of.
menyelisipkan	insert s.t.
menyelisir	go along the edge of s.t.
menyelit	be wedged or inserted in between.
menyelitkan	insert between two objects.
menyelobokkan	slip s.t. into s.t.
menyelomot	(java) fool, hoodwink.
menyelomoti	burn, touch fire to s.t.
menyelon	exile, deport.
menyelongkar	1 turn over, put in disorder. 2 rummage through.
menyelot	lock.
menyelubungi	cover with a veil or wrapper.
menyeluduk	crawl under s.t.
menyeluk	feel (around) for.
menyelundup	1 duck into, hide. 2 smuggle. 3 infiltrate.
menyelundupkan	smuggle s.t. in.
menyelungkup	cover, close.
menyelungkupkan	enclose, cover.
menyeluruh	1 spread all over. 2 comprehensive.
menyelusup	penetrate, infiltrate.
menyelusur	slide.
menyelusuri	1 go along, follow. 2 go through s.t. carefully.
menyemahkan	sacrifice s.t.
menyemaikan	raise seedlings, make seeds germinate.
menyemak	1 be like underbrush. 2 entangled. 3 confused. 4 worried.
menyemakkan	1 allow to become a wilderness, let (a garden, etc.) run wild. 2 confuse, worry.
menyemangati	inspire.
menyemarakkan	1 embellish, adorn. 2 cheer up, brighten.
menyematkan	fasten, pin, attach.
menyemayamkan	bury.
menyembah	1 pay homage. 2 worship.
menyembahkan	put (the hands or s.o.'s hands) in the position of respectful greeting.
menyembahyangkan	pray for, conduct services for.
menyembam	roast in hot ashes.
menyembat	1 whip up with a jerk. 2 grab while passing.
menyembilu	1 cut (with such a blade). 2 be cutting (of words)..
menyembir	deviate..
menyemboyankan	1 give a prearranged signal. 2 use s.t. as a slogan.
menyembuhkan	cure.
menyembul	1 appear partially, emerge. 2 swell, bulge, protrude.
menyembulkan	1 hold out or up. 2 make s.t. protrude, appear.
menyembunyikan	1 hide s.t. 2 conceal, suppress.
menyembur	1 squirt, spurt. 2 spray spit at.
menyemburatkan	sparkle.
menyemburiti	sodomize.
menyemburkan	spray or spout s.t. out.
menyeminarkan	hold a seminar on.
menyemir	1 to polish. 2 spread s.t. oily or greasy on, lubricate. 3 bribe, grease the palm.
menyempadani	delimit.
menyempal	/tersempal/ 1 stick. 2 gag.
menyempang	trip s.o.
menyempar	push, hurl s.t.
menyempatkan	1 make use of. 2 give o. time.
menyempil	/tersempil/ stick out so that a small part can be seen.
menyempit	tighten, narrow, constrict.
menyemprit	blow (a whistle).
menyemprot	1 spray. 2 scold.
menyemprotkan	1 squirt s.t. out. 2 inject, spray.
menyempurnakan	1 perfect. 2 complete s.t. 3 be given a proper ceremony.
menyemut	swarm, teem.
menyenakkan	oppress.
menyenandungkan	hum s.t.
menyenangkan	please, gratify.
menyendeng	lean, slant.
menyendengkan	tilt s.t.
menyendiri	1 be alone, apart, separated. 2 be aloof, isolate o.s.
menyendok	1 ladle up, ladle out, spoon. 2 scoop up, scoop out.
menyendoki	1 skim. 2 spoonfeed.
menyendokkan	spoon out on behalf on s.o.
menyengajakan	do s.t. on purpose.
menyengat	sting s.o. or s.t.
menyenget	slant, be at an angle.
menyengetkan	put s.t. on an angle.
menyenggangkan	free (time), allow (time) for.
menyenggol	1 snudge with the elbow, brush against. 2 brush against.
menyengguk	repeatedly nod (often from weariness).
menyengihkan	cause to open (the mouth).
menyengkak	massage the abdomen with an upward motion..
menyengkang	1 arrange a crossbar on s.t. 2 have a fish bone, etc.) caught in the throat.
menyengkelit	be worn in this way.
menyengkelitkan	attach to o.'s waist-belt.
menyengsarakan	torment s.o.
menyenguk	(java) sniff.
menyensus	take a census.
menyentak	1. pull at s.t. 2. (java) snap at s.o., verbally abuse s.o., tongue-lash.
menyentakkan	1 pull at, jerk at. 2 startle s.o.
menyental	rub hard, scour, scrub.
menyenter	1. shine, light. 2. 1) center (a ball). 2) play as a center.
menyenteri	1 light with a flashlight. 2 expose (in photography).
menyentil	1 (jakarta) snap o.'s fingers. 2 flick s.t. with o.'s finger, snap o.'s fingers at s.t. 3 criticize, reprimand.
menyentuh	touch s.t., nudge.
menyepak	kick.
menyepelekan	belittle, consider insignificant (of s.t. which is worth consideration).
menyepi	/nyepi/ 1 grow still, become desolate. 2 retire into seclusion.
menyerah	1 surrender. 2 give in, accede.
menyerahi	hand over to s.o., deliver to s.o., submit to s.o.
menyerahkan	hand s.t. over, transfer s.t.
menyerakahi	covet.
menyeramkan	1 cause o.'s hair to stand on end. 2 terrify.
menyerampang	harpoon a.t. with a trident.
menyerandang	support with a trestle.
menyeranikan	1 convert s.o. to christianity. 2 legally marry an indonesian wife (in the colonial period).
menyerap	1 absorb a fluid. 2 pervade.
menyerapahi	be abusive, curse.
menyerati	make tight
menyeraya	ask for help.
menyerbak	be perfumed, be good-smelling.
menyerbakkan	spread s.t. (fragnance, etc.).
menyerbeti	wipe off with a napkin.
menyerbu	attack or invade in a throng.
menyeret	1 drag s.t. or s.o. 2 cause s.t. to drag.
menyeretkan	make business sluggish, make sales slow.
menyergap	1 attack, ambush. 2 catch (in a raid, etc.). 3 snarl at
menyerimpung	(serimpung) (jakarta, jakarta) 1 tie or entangle another's feet. 2 block s.t., impede s.t. 3 make o. stumble (by hurling s.t. to entangle the feet).
menyering	plait or twine s.t.
menyeringai	1 grin, grimace. 2 curl into a grin or grimace.
menyerit	remove lice with this comb.
menyerkah	break or tear off.
menyerkai	1 wring out (wet clothes, etc.). 2 squeeze out liquid (from cheesecloth, etc.).
menyerkap	1 catch fish with such a fish trap. 2 cover with s.t. (us. cone-shaped).
menyerkup	seize or cover with a concave object (a cone, cupped hand, etc.).
menyerobot	1 get in front of. 2 interfere with or take arbitrarily.
menyerok	1 scoop up (food, etc.). 2 round up in a swoop.
menyerongkan	tilt s.t., slant s.t.
menyeropot	(jakarta) sip s.t. noisily.
menyerpih	1 splinter. 2 fragment.
menyertai	1 participate in. 2 accompany s.o. or s.t.
menyertakan	enclose.
menyertifikatkan	(leg.) formalize (ownership of land, etc.) with a certificate.
menyeruak	1 make o.'s way through a narrow passage or dense foliage or a crowd. 2 waft out through narrow spaces.
menyerudi	polish by grinding.
menyeruduk	1 go with the head lowered. 2 (java, jakarta) ram into. 3 go into a place unobstrusively.
menyeruit	1. harpoon s.t. 2. blow a whistle.
menyerukan	1 call, shout out s.t. 2 proclaim s.t.
menyerum	treat with serum.
menyerusuk	go through (bushes, crowds, etc).
menyerut	plane s.t.
menyesah	wash clothes by pounding them.
menyesakkan	oppress, tighten, constrict.
menyesal	see sesal.
menyesap	1 sip, lap up. 2 suck.
menyesarkan	move or push s.t. aside.
menyesatkan	lead astray, mislead.
menyeset	skin, peel.
menyesuaikan	adjust, adapt, bring into line.
menyetarafkan	1 make equal, make equivalent. 2 consider on a par with. 3 balance.
menyetel	1. match. 2. 1) tune up, adjust. 2) turn on.
menyetem	1. vote for s.o. or s.t. 2. tune up.
menyeterika	1 iron s.t. 2 (coll.) flatten, smash..
menyetir	1 drive, steer. 2 (coll.) control, wield control over.
menyetop	stop s.t.
menyetor	1 make a deposit. 2 pay a rental fee. 3 put in storage. 4 (sl.) defecate.
menyetrum	1 induce. 2 electrify, charge.
menyetubuhi	copulate with s.o.
menyetujui	agree to s.t., approve s.t.
menyetum	1 dry-clean with steam. 2 let steam off.
menyia-nyiakan	make s.t. useless, cause s.t. to have no result, neglect.
menyiagakan	alert s.o., prepare s.o. for action.
menyiangi	clear s.t. of weeds.
menyiapkan	1 prepare. 2 finish s.t.
menyiasati	pry into s.o.'s affairs or get the better of s.o. (by questioning, using certain tactics or approaches, etc.).
menyiasatkan	punish.
menyibak	1 separate s.t. 2 cleave s.t. apart.
menyibakkan	move s.t. aside.
menyibukkan	1 stir up, incite. 2 occupy, busy o.s. with.
menyidak	hang out to dry.
menyidangkan	1 convene on a matter. 2 (leg.) bring s.o. or s.t. to trial.
menyidik	investigate.
menyigai	climb up on such a ladder.
menyigar	part (hair).
menyigi	1 light with a torch. 2 investigate.
menyikat	1 brush s.t. 2 comb s.t. 3 rake out, harow s.t. 4 (coll.) take away. 5 (coll.) wipe out , clean out. 6 (sport) defeat completely.
menyiksa	1 torture s.o. 2 (coll.) annoy, irritate.
menyiku	1 nudge, elbow o.'s way. 2 form a rectangle. 3 curve or bend at a right angle.
menyikut	1 nudge with elbow. 2 (coll.) deceive, cheat.
menyilam	disappear.
menyilet	slice with a razor blade.
menyilih	1 change. 2 shed skin, molt.
menyilik	observe, note carefully.
menyimak	1. scrutinize, observe attentively. 2. gather, collect.
menyimbah	1 splash, bespatter. 2 break out, appear.
menyimpan	1 store, lay away. 2 have inside, keep s.t. in storage.
menyimpang	1 deviate, diverge. 2 take a side route.
menyimpul	1. 1) button clothing. 2) form a knot. 2. form an embarrassed smile.
menyimpulkan	1 form s.t. into a knot. 2 conclude, summarize.
menyinarkan	1 radiate, send off. 2 cause s.t. to shine.
menyindir	tease us. by insinuation and allusion.
menyinggat	divide, part.
menyinggung	1 touch, contact. 2 offend, insult, hurt (o.'s feelings). 3 touch on, treat (a subject, problem).
menyingkap	1 unveil, expose, open. 2 reveal. 3 be turned back and open a bit (sheets, skirts, etc.).
menyingkir	1 step aside, yield. 2 evacuate, move to.
menyingkirkan	1 evacuate s.t. 2 remove, put away, lay aside. 3 eliminate, purge, get rid of s.o. or s.t.
menyingkuri	turn o.'s back to s.o. or s.t., ignore.
menyingsatkan	1 tighten. 2 roll up. 3 shrink s.t.
menyingsing	rise, lift, break clear.
menyingsingkan	roll, tuck up.
menyingsring	blow o.'s nose.
menyintung	touch with the elbow.
menyipit	become squinted or narrowed (of eyes).
menyiram	pour (water) over s.t., flush.
menyirapkan	1 raise slightly. 2 scare s.o.
menyirat	make a knot.
menyiratkan	imply.
menyirepkan	1 cast a sleeping spell over s.o. 2 (java) calm s.o.
menyiring	scoop up carefully.
menyirnakan	1 make disappear. 2 abolish. 3 destroy, kill.
menyiru	use such a tray to winnow.
menyisakan	1 leave behind. 2 set aside (for later).
menyisi	1 move to the side. 2 go along the side of s.t.
menyisih	1 give way, get out of the way. 2 be separate, aloof from. 3 set s.t. aside, put s.t. to the side.
menyisihkan	1 set aside, separate out. 2 reject, ignore. 3 (sport) eliminate.
menyisikan	move s.t. to the side.
menyisipi	1 insert into s.t. 2 repair s.t. by putting s.t. flat in between, e.g. insert new parts in roof, etc.
menyisipkan	insert s.t. in.
menyisir	1 comb s.t. 2 harrow s.t.
menyisirkan	comb s.t. for s.o.
menyita	/mensita/ 1 seize, confiscate. 2 consume (o.'s time or attention).
menyiuk	groan, moan.
menyjelaskan	1 clarify, explain s.t. 2 resolve, settle, clean up (a debt, conflict, etc.).
menyjumlahkan	add or count up.
menyjunjung	1 carry s.t. on the head, shoulders, or high on the back. 2 respeck, hold in high esteem.
menylentik	1 snap s.o. or s.t. with o.'s index finger. 2 reprimand s.o.
menyobek	tear, rip.
menyodok	1. shovel, scoop up. 2. thrust, poke.
menyodorkan	1 thrust s.t. forward, stretch s.t. out. 2 put forth.
menyogok	bribe s.o.
menyohorkan	make s.o. or s.t. famous.
menyokong	1 prop up, support. 2 aid.
menyolok	see colok 2.
menyombol	cram food into the mouth.
menyondang	lift, raise on o.'s head or shoulders.
menyondol	1 charge by lowering the head, butt s.t. 2 (sport) hit the ball with the head.
menyondong	catch shrimp.
menyongel	protrude, jut out.
menyongsong	1. 1) welcome. 2) commemorate. 3) carry out (s.o.'s wishes, etc.). 2. go against.
menyontakkan	1. mutilate, disfigure. 2. tug at, give a (sudden) jerk at.
menyontek	1. push away. 2. copy, cheat in class, crib.
menyorakkan	yell out s.t.
menyorong	1 push, slide. 2 urge. 3 propose, suggest. 4 bribe s.o.
menyorongkan	1 slide s.t. forward. 2 shove, push forward, hand.
menyorot	1 shine, gleam, irradiate. 2 project (pictures). 3 gaze, look (of eyes). 4 draw attention to, highlight.
menyoroti	1 illuminate s.t., light up. 2 spotlight s.t. or s.o., give prime importance to.
menyosoh	1. whiten or clean rice. 2. 1) fight, engage in combat. 2) do s.t. with vigor.
menyosor	use the bill to scoop up or to peck at.
menyruduk	ram or butt with o.'s head.
menyuap	1 eat with the hand. 2 bribe s.o.
menyuapi	feed s.o., esp. by placing food in the mouth.
menyuarakan	1 give voice to s.t., express s.t. 2 utter.
menyubal	substitute with fake material.
menyuburkan	1 make s.t. fertile, make s.t. grow. 2 make s.t. prosper.
menyudet	(java) 1 make an incision (e.g. on a boil, ulcer). 2 make a connecting passage between canals.
menyudip	stir s.t.
menyudutkan	put s.t. into a corner.
menyuguhkan	serve (a guest, etc.). with s.t.
menyuhun	showgreat respect for s.o.
menyukabumikan	kill.
menyukai	like, love.
menyula	1 shear off coconut husks by exerting downward pressure on such a stake. 2 (lit.) impale s.o.
menyulam	1. embroider. 2. replace dead rice seedlings with new ones.
menyulap	1 conjure up s.t. 2 (coll.) cause s.t. to disappear (esp. in embezzlements, etc.).
menyuling	1. play the flute. 2. distill.
menyulingkan	turn s.t. upside down.
menyuluhi	1 light s.t. with a torch, cast a light upon s.t. 2 inform, instruct. 3 investigate.
menyulur	climb, creep.
menyulut	1 (java) kindle, ignite. 2 become heatedly angry
menyulutkan	ignite or light s.t. on s.o.'s. behalf.
menyumbang	1 contribute. 2 help, assist.
menyumbat	stop, close up, plug up.
menyumbi	repair the edge of s.t. damaged (e.g. crown a tooth, etc.).
menyumbur	1 protrude. 2 emerge.
menyumburkan	1 extend s.t. (hand, leg, tongue, etc.). 2 hang out or raise the flag.
menyumpal	1 plug s.t., fill a gap. 2 (vul.) feed.
menyumpalkan	plug up, with s.t.
menyumpit	shoot with a blowpipe.
menyumpitkan	use as a blowpipe.
menyunat	1 circumcise s.o. 2 skim money off the top of a budget to that the grantee gets only a portion.
menyunatkan	1. have s.o. circumcised. 2. 1) consider a deed meritorious. 2) prescribe for s.o. as a meritorious deed.
menyundak	1 (m) bump o.'s head. 2 rise.
menyundut	1.(m) carry. 2. (lit.) light, kindle.
menyungga	stick with a spike.
menyunggi	carry on the head.
menyungging	produced s.t. decorative with delicate details.
menyungkahkan	devour s.t. greedily.
menyungkal	plow, dig up.
menyungkit	embroider in such a way.
menyungkupi	cover with s.t.
menyungkur	1 root up, grub up (earth). 2 lower the head (as if to root up).
menyungkurkan	put down, lower.
menyungsang	1 be upside down. 2 go against the grain.
menyungsangkan	place s.t. upside down.
menyuntih	(m) cut into small pieces.
menyuntik	1 inject. 2 inoculate, vaccinate. 3 incite.
menyunting	1. 1) proofread and correct. 2) insert s.t., edit s.t. into. 2.marry s.o. (of men).
menyuntingkan	1. place behind the ear or in the hair. 2. have s.o. as a wife.
menyuplai	supply s.t.
menyurati	1 incribe. 2 write a letter to s.o.
menyuruh	order s.o. to do s.t.
menyuruk	1 duck the head. 2 hide.
menyurup	set, sink (of heavenly bodies).
menyurut	lessen, subside.
menyurutkan	1 withdraw s.t. 2 decrease, lessen.
menyusahkan	1 make s.t. difficult. 2 worry about.
menyusu	suckle on the breast.
menyusui	give suck.
menyusuk	1 magically insert s.t. subcutaneously to improve o.'s attraction. 2 (java) stab with a pin.
menyusukkan	stick s.t. in.
menyusul	1 follow, come afterward. 2 follow and catch up with.
menyusun	arrange s.t. in orderly fashion.
menyusunkan	arrange s.t. in an orderly fashion on s.o.'s behalf.
menyusup	1 move (below s.t.), pass in a low posture. 2 penetrate, infiltrate.
menyusupi	enter into s.t. stealthily.
menyusupkan	1 place s.t. below s.t. else. 2 smuggle, have infiltrate.
menyusur	1.1) go along the edge. 2) trace, follow. 2. chew tobacco.
menyusuri	1 go along the edge. 2 trace, follow.
menyusut	1 decrease in size, shrink (of cloth, etc.). 2 subside (of a wind, storm, swelling, etc.). 3 wipe off.
menyusuti	1 reduce, decrease. 2 wipe off (repeatedly).
menyusutkan	decrease s.t.'s size.
menyutradarai	direct a film or play.
menyuwir	shred.
menyuwuk	(java) heal magically by blowing on s.t.
menzakatkan	donate s.t.
menziarahi	visit (a sacred place).
