digression	kb. penyimpangan.
dike	kb. 1 tanggul, pematang. 2 (small) gili-gili. 3 bendungan, tambak.
dilapidate	kkt. merusak. -dilapidated ks. bobrok (karena tidak dipelihara). a d. mansion sebuah rumah besar yang bobrok.
dilate	kki. membesar, meluas, melebar.
dilatory	ks. terlambat, lalai. to be d. in terlambat dalam. d. tactics siasat atau perbuatan memperlambat.
dilemma	kb. 1 pilihan, dilema. 2 malu. on the horns of a d. bagai makan buah simalakama.
dilettante	kb., ks. penggemar, pencinta kesenian (tanpa menjadi ahli).
diligence	kb. kerajinan, ketentuan.
diligent	ks. rajin, tekun.
dill	kb. tumbuh-tumbuhan yang bijinya harum dipakai untuk asinan, masak-masakan, minyak wangi dan obat-obatan. d. pickle acar timun yang memakai "dill".
dilly	kb. sl.: (j. -lies) sl.: orang atau hal yang dianggap luar biasa. she's a d. perempuan itu betul-betul hebat.
dilly-dally	kki. (dilly-dallied) membuang-buang waktu, berlengah-lengah.
dilute	kkt. mencairkan, menipiskan. -diluted ks. yang ditambah air. d. orange juice air jeruk yang ditambah air.
dim	ks. suram. d. light lampu yang suram. -kkt. (dimmed) mengurangkan, mengecilkan, mengedim. to d. the headlights mengecilkan lampu mobil. -kki. kecil cahayanya. the lights dimmed lampu-lampu berkurang cahayanya.
dime	kb. sepicis, uang picisan. a d. a dozen banyak dan mudah didapat. d. store toko murah yang menjual barang dengan harga beberapa sen keatas.
dimension	kb. 1 ukuran. the dimensions of a room ukuran sebuah ruangan. 2 besarnya, luasnya. we still do not know the dimensions of the problem kami belum mengetahui besarnya persoalan itu.
dimensional	ks. yang bertautan dengan ukuran, dimensi atau luas. two-d. dua-dimensi.
diminish	kkt. mengurangi. to d. s.o's enthusiasm mengurangi semangat seseorang. -kki. berkurang. -diminishing ks. yang berkurang.
diminution	kb. 1 pengurangan. d. of strength pengurangan tenaga. 2 penyusutan.
diminutive	kb. gram.: kata pengecil. -ks. kecil. d. replica of the original tiruan yang kecil daripada yang asli.
dimmer	kb. lampu dim, alat penyuram.
dimple	kb. lesung/cawak pipi.
dimwit	kb. inf.: orang yang tolol.
dimwitted	ks. inf.: bodoh, tolol, goblok.
din	kb. keriuhan, hiruk-pikuk. -kkt. (dinned) meneriakkan terus-menerus.
dine	kki. makan malam. to d. on makan. to d. on fish makan ikan. to d. out makan malam diluar. dining car kereta makan, restoran kereta api. dining room kamar/ruang makan.
diner	kb. 1 rr.: kereta makan. 2 pengunjung untuk makan malam. 3 (restaurant) kedai makan.
ding-dong	kb. bunyi (genta). -ks. inf.: a d. game pertandingan yang seru.
dinghy	kb. joli. sampan kecil.
dinginess	kb. 1 kekotoran, kekumalan. 2 kesuraman.
dingy	ks. 1 kumal, kotor, renyuk dan kotor. d. room kamar yang kumal. 2 suram.
dinky	ks. inf.: kecil. d. house rumah yang kecil.
dinner	kb. makan malam. d. dance jamuan makan malam diikuti dengan dansa. d. hour waktu makan malam.
dinnerware	kb. serpis makan.
dinosaur	kb. dinosauria.
dint	kb. d. of berkat, hanya dengan, akibat. by d. of hard work berkat kerja keras.
diocese	kb. keuskupan.
dioxide	kb. dioksida.
dip	kb. 1 mandi, masuk kedalam air. 2 desinfleksi. 3 lobang, tempat yang menurun (di jalan). 4 food : keju untuk pesta. -kkt. (dipped) 1 memasukkan. 2 mencedok. 3 menurunkan dan menaikkan (the flag). -kki. 1 menukik. 2 turun.
diphtheria	kb. difteri, depteri.
diphthong	kb. diftong, harakat/bunyi rangkap.
diploma	kb. diploma, ijazah.
diplomacy	kb. diplomasi.
diplomat	kb. diplomat.
diplomatic	ks. 1 diplomatik. d. corps korps diplomatik. 2 pandai. d. in o's relations with his colleagues pandai berhubungan dengan teman-teman sejawatnya.
dipper	kb. pencedok, gayung. the big d. bintang biduk/jung (ursa mayor). the little d. bintang beruang kecil (ursa minor).
dipsomania	kb. sifat mencandu terhadap minuman keras.
dire	ks. yang mengerikan/menakutkan.
direct	ks. 1 langsung. 2 sebenarnya. -kkt. 1 menunjukkan. 2 mengatur (traffic). 3 menyutradarai (a play or movie). 4 menujukan. 5 memerintah. -kki. memimpin. -directly kk. 1 (dengan) langsung, tepat. 2 dengan segera.
direction	kb. 1 pimpinan (of orchestra, play, movie). 2 petunjuk. 3 arah. 4 bimbingan. 5 jurusan.
directional	ks. yang berhubungan dengan arah. d. signal tanda jurusan.
directive	kb. petunjuk, instruksi, perintah.
director	kb. 1 mus.: pemimpin. 2 adm.: direktur. d. general direktur jenderal. 3 sutradara (of a movie, play).
directorate	kb. badan/dewan pimpinan.
directory	kb. (j. -ries) 1 petunjuk. telephone d. buku petunjuk telephone. 2 buku alamat dagang.
diretorship	kb. jabatan direktur.
dirge	kb. lagu/nyanyian penguburan.
dirigible	kb. kapal seplin, balon berkemudi.
dirt	kb. 1 kotoran. 2 sl.: desas-desus. 3 tanah, lumpur, kotoran. dirt-cheap ks. sangat murah. dirt-poor sangat miskin.
dirtiness	kb. 1 kekotoran, kecemaran. 2 kelicikan.
dirty	ks. 1 kotor, dekil. 2 kotor, cabul. 3 busuk, serong. 4 tidak murni -kkt. (dirtied) mengotorkan. -kki. menjadi kotor.
disability	kb. (j. -ties) 1 cacat. physical d. cacat jasmaniah. 2 ketidak mampuan.
disable	kkt. mencacatkan, melumpuhkan. -disabled ks. cacat. d. veteran veteran cacat.
disabuse	kkt. membebaskan dari kesalahan/penipuan. to d. s.o. of his feeling of superiority membebaskan seseorang dari perasaan unggul.
disadvantage	kb. keadaan merugikan. to be at a d. berada dalam keadaan merugikan.
disadvantageous	ks. yang tak menguntungkan, bersifat merugikan. in a d. position didalam keadaan yang merugikan.
disaffect	kkt. tidak senang, tidak setia. -disaffected ks. yang tak senang, yang tak setia/puas.
disaffection	kb. ketidaksenangan, ketidakpuasan, ketidaksetiaan.
disagree	kki. 1 membantah. 2 berselisih. 3 tidak cocok. some foods d. with me ada makanan yang tak cocok untuk saya.
disagreeable	ks. 1 yang tak enak. 2 marah-marah. 3 tidak menyenangkan.
disagreement	ks. 1 pertentangan, percekcokan, perselisihan pendapat. 2 kegagalan menyetujui.
disallow	kkt. menolak. to d. a request menolak permohonan.
disappear	kki. hilang, menghilang. the child disappeared anak itu hilang. the snow disappeared salju sudah menghilang.
disappearance	kb. 1 hilangnya. the child's d. caused concern hilangnya anak itu menimbulkan kekhawatiran. 2 kehilangan. news of the d. kabar tentang kehilangan itu.
disappoint	kkt. mengecewakan. -disappointed ks. kecewa. -disappointing ks. mengecewakan. d. performance pertunjukan yang mengecewakan.
disappointment	kb. kekecewaan, ketidakpuasan. to be a d. for merupakan kekecewaan bagi.
disapproval	kb. (pen)celaan.
disapprove	kki. mencela, tidak menyetujui. -disapproving ks. tidak menyetujui. -disapprovingly kk. dengan mencela. she looked at me d. ia memandang saya dengan sikap menyalahkan / mencela/tidak menyetujui.
disarm	kkt. , kki. melucuti senjata. -disarming ks. bersifat yang memenangkan orang lain, yang memperdayakan. orang. -disarmingly kk. dengan mudah memperdayakan orang.
disarmament	kb. 1 perlucutan senjata. 2 pengurangan/pembatasan angkatan bersenjata dan persenjataannya.
disarrange	kkt. mengusutkan, mengacaukan. the wind disarranged her hair angin mengusutkan rambutnya
disarray	kb. kekacauan. in d. 1 berantakan. the room was in d. kamar itu berantakan. 2 tidak rapi. he clothes were in d. pakaiannya tidak rapi.
disassemble	kkt. membongkar (a motor).
disaster	kb. 1 bencana. 2 kemalangan, mala petaka.
disastrous	ks. yang membawa atau mendatangkan malapetaka. d. flood banjir yang mendatangkan malapetaka. -disastrously kk. dengan mendapat malapetaka.
disavow	kkt. mengingkari, memungkiri. he disavowed participation in the burglary ia mengingkari bahwa ia ikut dalam pencurian itu.
disavowal	kb. keingkaran, sangkalan.
disband	kkt. membubarkan. -kki. bubar. the team disbanded regu itu bubar.
disbelief	kb. ketidak percayaan, kesangsian. to receive the news with d. menerima kabar itu dengan perasaan tidak percaya.
disburse	kkt. mengeluarkan, membayar.
disbursement	kb. pengeluaran, pembayaran.d. of fund pembayaran dana-dana.
disc	= disk.
disc.	(discount) potongan.
discard	kb. 1 barang-barang yang dibuang 2 bridge : kartu-kartu yang dibuang. -kkt. membuang (clothes, cards ,etc). -kki. membuang (cards).
discern	kkt. melihat. to d. the difference between melihat perbedaan antara. -discerning ks. tajam, cerdas. d. mind pikiran yang tajam.
discernible	ks. yang dapat dilihat.
discernment	kb. ketajaman.
discharge	kb. 1 pemberhentian. 2 pemecatan, pemberhentian. 3 penembakan (of a rifle). 4 pelaksanaan. 5 pembongkaran (of cargo). 6 keluarnya. 7 pembebasan, pelepasan. 8 kotoran.
disciple	kb. murid. d.of christ murid kristus. tagore had many disciple tagore mempunyai banyak murid.
disciplinarian	kb. orang yg berpegang kpd disiplin.
disciplinary	ks. disipliner.
discipline	kb. disiplin.2 ketertiban.3 mata pelajaran.-kkt. menertibkan.
disclaim	kkt.1 menyangkal.2 melepaskan.
disclaimer	kb. sangkalan, penolakan.
disclose	kkt. menyingkap.2 memperlihatkan. the open window disclosed a beautiful view jendela yg terbuka itu memperlihatkan pemandangan yg indah.
disclosure	kb. penyingkapan.
discolor	kkt. mengotorkan, menghitamkan.
discoloration	kb1. pengotoran. 2 perubahan warna.3 perusakan warna.
discomfort	kb. kegelisahan, keadaan tak senang, ketidaksenangan.
disconcert	kkt. membingungkan, memalukan.-disconcerting ks. membingungkan.
disconnect	kkt.1 melepaskan, mencopot.2 memutuskan.
disconsolate	ks. putus asa, sedih.
discontent	kb. perasaan tdk senang, ketidakpuasan.
discontented	ks. tdk senang/puas.
discontinuance	kb. penghentian, pemberhentian, pemutusan.
discontinue	kkt. menghentikan, memutuskan
discontinuity	kb. (j.-ties) keadaan yg terputus, keadaan yg tak tersambung
discontinuous	ks. terputus
discord	kb. 1 perselisihan (paham), perbantahan, perpecatan. 2 mus.: bunyi sumbang.
discordance	kb. 1 kejanggalan bunyi. 2 perselisihan, perpecahan.
discordant	ks. 1 penuh pertentangan. the discussion struck a d. note dalam diskusi itu terdengar suara-suara yang bertentangan. 2 tidak harmonis, sumbang.
discotheque	kb. diskotik.
discount	kb. potongan , korting. at a d. dengan potongan harga. d. house/store toko yang memberi potongan. -kkt. mengabaikan, melalaikan. to d. much of what one says mengabaikan banyak hal yang dikatakannya.
discourage	kkt. mengecilkan hati. to d. him mengecilkan hatinya. -discouraging ks. mengecilkan hati.
discouragement	kb. kehilangan semangat, keputus asaan.
discourse	kb. pidato atau tulisan, percakapan, ceramah. scientific d. wacana ilmiah. -kki. bercakap-cakap. to d. on bercakap-cakap mengenai.
discourteous	ks. tidak sopan, kasar, kurang ajar.
discourtesy	kb. (j. -sies) kekasaran, ketidak sopanan, kekurangajaran.
discover	kkt. 1 menemukan (oxygen, america, a new singer). 2 mengetemukan. 3 mengetahui.
discovery	kb. (j. -ries) penemuan, pendapatan.
discredit	kb. 1 kehilangan kepercayaan. 2 noda, cemar. -kkt. 1 tidak mempercayai. 2 menghilangkan gengsi. 3 mendiskreditkan (the government).
discreet	ks. bijaksana, berhati-hati.
discrepancy	kb. (j. -cies) ketidaksesuaian, ketidakcocokan.
discrete	ks. 1 mempunyai ciri-ciri tersendiri. a book is a d. object buku adalah benda tersendiri. 2 yang berlainan. an apple and a stone are d. objects apel dan batu adalah benda yang berlainan.
discretion	kb. kebijaksanaan, keleluasaan. to leave s.t. to your d. menyerahkan sesuatu kepada kebijaksanaan saudara.
discretionary	ks. dengan kebebasan untuk menentukan atau memilih, terserah kepada kebijaksanaan seseorang.
discriminate	kkt. membedakan. -kki. 1 membedakan. 2 mengadakan diskriminasi. -discriminating ks. suka membeda-bedakan.
discrimination	kb. 1 diskriminasi. 2 perbedaan. d. of colors is not easy membedakan warna tidak gampang. 3 sifat memilih-milih. d. in choise of boy friends sifat memilih-milih dalam hal teman-teman lelakinya.
discriminatory	ks. yang mendiskriminasi. d. practices praktek-praktek diskriminasi.
discursive	ks. tidak bersambungan satu sama lain. his lectures are d. kuliah-kuliahnya tidak bersambungan satu sama lain.
discus	kb. cak(e)ram, diskus.
discuss	kkt. membicarakan, merundingkan. to d. problem with membicarakan masalah itu dengan.
discussant	kb. peserta dalam perundingan, diskusiwan, pembahas.
discussion	kb. pembicaraan, diskusi, perundingan. to open a d. memulai pembicaraan. to come up for d. dikemukakan untuk pembahasan.
disdain	kb. penghinaan, hina. to regard an offer with d. menganggap hina suatu tawaran. -kkt. meremehkan, tidak menghargai. to d. assistance meremehkan bantuan.
disdainful	kb. penuh kehinaan, bersifat (meng)hina. to take a d. attitude towards mengambil sikap menghina terhadap.
disease	kb. penyakit. d. carrier penyebar penyakit.
diseased	ks. yang sakit. the d. part bagian yang sakit.
disembark	kki. turun dari kapal, mendarat, naik darat.
disembarkation	kb. pendaratan, penurunan dari kapal.
disembowel	kkt. mengeluarkan isi perut.
disenchant	kkt. mengecewakan. he was dischanted after six months ia merasa kecewa setelah enam bulan.
disenchantment	kb. kekecewaan.
disengage	kkt. melepaskan. to d. o's hand from the rope melepaskan tangan dari tali.
disentangle	kkt. menguraikan/melepaskan/ membebaskan dari kekusutan.
disfavor	kb. to be in d. with tak disukai oleh. to look with d. on tidak setuju dengan, tidak disukai oleh.
disfigure	kkt. menodai, menjelekkan. to d. a beautiful view menjelekkan pemandangan yang indah.
disfigurement	kb. 1 penodaan, pencacatan. 2 pengrusakan. d. of the countryside by billboards pengrusakan pemandangan di daerah pedalaman oleh papan-papan iklan.
disfranchise	kkt. mencabut hak memilih (dari).
disfranchisement	kb. pencabutan hak memilih.
disgorge	kkt. 1 mencurahkan. 2 memuntahkan.
disgrace	kb. aib, malu, arang dimuka. to be a d. to mendapatkan/mendatangkan nama buruk bagi. -kkt. memalukan, menodai, mencemarkan.
disgraceful	ks. memalukan. d. conduct tingkah laku yang memalukan. -disgracefully kk. secara memalukan. to act d. berlaku secara memalukan.
disgruntled	ks. tidak puas. a d. employee pegawai yang tidak puas.
disguise	kb. 1 penyamaran. 2 samaran. -kkt. menyembunyikan. -disguised ks. yang tersembunyi. d. un-employment pengangguran tersembunyi.
disgust	kb. kejijikan, kemuakan. -kkt. 1 menjijikkan. 2 memuakkan. 3 benci akan. -disgusted ks. jijik. -disgusting ks. 1 cabul (book movie). 2 menjijikkan. -disgustingly kk. yang menjijikkan.
dish	kb. 1 hidangan, masakan. 2 piring. 3sl.: bagian. 4 makanan. 5 sl.: gadis yang cantik. -kkt. sl.: meremukkan.
dishcloth	kb. kain untuk pencuci piring.
dishearten	kkt. mengecilkan hati. -dishearting ks. mengecilkan hati, mematahkan harapan.
disheveled	ks. 1 terurai. d. hair rambut terurai. 2 tak rapi, kusut. d. clothing pakaian tidak rapi, pakaian kusut.
dishful	kb. sepiring penuh.
dishonest	ks. tidak jujur.
dishonesty	kb. (j. -ties) ketidak jujuran.
dishonor	kb. kecemaran, aib. to bring d. on o's family menyebabkan kecemaran pada keluarganya. -kkt. 1 memalukan. 2 menolak.
dishonorable	ks. tidak hormat. d. discharge pemecatan dengan tidak hormat.
dishpan	kb. panci untuk pencuci piring.
dishrag	kb. kain untuk pencuci piring.
dishwater	kb. air pencuci piring, air cucian.
disillusion	kb. kekecewaan. -kkt. mengecewakan. -disillusioning ks. mengecewakan. d. experience pengalaman yang (sangat) mengecewakan.
disillusionment	kb. kekecewaan.
disinclination	kb. keseganan, rasa benci.
disinclined	ks. segan, tidak sudi.
disinfect	kkt. mendesinfeksi/menghapus/membasmi hama atau kuman.
disinfectant	kb. obat pembasmi kuman, obat desinfeksi.
disinherit	kkt. mencabut hak waris. to d. a child mencabut hak waris seorang anak.
disinheritance	kb. pencabutan hak waris.
disintegrate	kkt. menghancurkan. -kki. hancur. the books disintegrated buku-buku itu hancur.
disintegration	kb. kehancuran.
disinter	kkt. (disinterred) menggali dari kuburan.
disinterested	ks. ks. yang tidak berkepentingan, yang tidak memihak. d. observer peninjau yang tidak berkepentingan.
disinterment	kb. penggalian kuburan.
disjointed	ks. 1 terpotong-potong. d. fowl unggas yang terpotong-potong anggota badannya. 2 terputus-putus. d. account of a trip keterangan yang terputus-putus tentang perjalanan.
disk	kb. 1 cakra(m). 2 mus.: piringan (hitam). d. jockey penyiar radio yang menghidangkan lagu-lagu rekaman saja. 3 piringan sendi. slipped d. piringan sendi yang tergelincir.
dislike	kb. benci, perasaan tidak suka. to have a d. for merasa tidak suka terhadap. -kkt. tak suka, membenci. i d. getting up early saya tak suka bangun pagi-pagi.
dislocate	kkt. melepaskan. i dislocated my shoulder tulang bahu saya tergelincir.
dislocation	kb. terlepas/tergelincir dari sambungan. shoulder d. sambungan bahu saya terlepas.
dislodge	kkt. mengeluarkan, mencabut. to d. a fishbone from the throat mengeluarkan tulang ikan dari tenggorokan.
disloyal	ks. tidak setia/patuh.
disloyalty	kb. (j. -ties) ketidaksetiaan, ketidakpatuhan.
dismal	ks. 1 muram, sedih. d. future hari depan yang malang. 2 malang, tidak mujur. a d. day hari yang suram.
dismantle	kkt. membongkar.
dismay	kb. kekagetan, kecemasan. to my d. saya cemas. - kkt. mencemaskan hati.
dismember	kkt. 1 memotong-motong. the body was dismembered badan itu terpotong-potong. 2 memecah dalam bagian-bagian. the country was dismembered negeri itu dipecah dalam bagian-bagian.
dismemberment	kb. pemotongan, pembagian dalam bagian-bagian.
dismiss	kkt. 1 membebaskan, memecatkan. 2 meliburkan. 3 menolak. 4 menghilangkan. 5 membubarkan.
dismissal	kb. 1 pembubaran. 2 pemecatan. 3 pembebasan. 4 penolakan.
dismount	kki. turun. to d. from a horse turun dari kuda.
disobedience	kb. hal tidak mematuhi, ketidaktundukan, pengabaian perintah.
disobedient	ks. tidak tunduk (to kepada).
disobey	kkt., kki. tidak mematuhi perintah, mengingkari peraturan.
disorder	kb. 1 kekacauan. 2 keadaan tidak teratur, keadaan berantakan. 3 penyakit.
disorderly	ks. kacau, yang melanggar peraturan. d. conduct perbuatan melanggar peraturan.
disorganization	kb. kakacauan. social d. kekacauan kemasyarakatan.
disorganize	kkt. mengacaukan, menyebabkan berantakan. -disorganized ks. berantakan, tidak teratur, kacau, bingung.
disoverer	kb. penemu.
disown	kkt. tidak mengakui, memungkiri. to d.o 's son memungkiri anaknya.
disparage	kkt. meremehkan, menghina, mengecilkan, memperolok-olokkan. -disparaging ks. yang meremehkan. -disparagingly kk. secara yang meremehkan. to speak d. berbicara dengan pandangan rendah/hina.
disparagement	kb. penghinaan, peremehan.
disparate	ks. berbeda, tidak sama, berlainan. their ages are quite d. usia mereka sangat berbeda.
disparity	kb. ((j. -ties) disparitas, perbedaan.
dispassionate	ks. tidak memihak, tenang. to take a d. view of mengambil sikap yang tidak memihak mengenai.
dispatch	kb. pengiriman. 2 kabar, berita tertulis. -kkt. 1 mengirim, menyuruh, mengutus (troops, a messenger). 2 membunuh.
dispatcher	kb. orang yang memberangkatkan atau yang membolehkan trem atau mobil berangkat.
dispel	kkt. (dispelled) 1 menghalaukan. 2 menghilangkan.
dispensary	kb. (j. -ries) 1 apotik. 2 klinik, rumah obat.
dispensation	kb. 1 dispensasi. 2 takdir. d. of providence takdir allah.
dispense	kkt. 1 menyalurkan. 2 mengeluarkan. 3membagikan. 4 menyelenggarakan (justice). to d. with 1 membuang. 2 melepaskan.
dispenser	kb. 1 mesin penjual. cigarette d. mesin penjual rokok. 2 (person) pemberi, orang yang mengeluarkan.
dispersal	kb. 1 pengusiran. d. of a crowd pengusiran orang ramai. 2 pembubaran.
disperse	kkt. 1 membubarkan. to d. a demonstration membubarkan demonstrasi. 2 mengedarkan (leaflets). - kki. bubar. the mob dispersed when the arrived orang ramai itu bubar ketika polisi tiba.
dispersion	kb. 1 pembubaran. 2 penyebaran.
dispirited	ks. sedih, putus asa, kecil hati.
displace	kkt. 1 menggantikan. 2 memecat, memindahkan. -displaced ks. yang terlantar. d. person orang terlantar.
displacement	kb. 1 pemindahan. 2 beratnya.
display	kb. pameran, pertontonan, pertunjukan. book d. pameran buku. -kkt. 1 memperlihatkan, memamerkan. 2 memperlihatkan. 3 mempertunjukkan. 4 mengibarkan (the flag).
displease	kkt. tak menyenangkan bagi. his attitude displeases me sikapnya tak menyenangkan bagi saya.
displeasure	kb. perasaan tidak senang, perasaan tersinggung. to incur s.o.'sd. menimbulkan perasaan tidak senang pada seseorang.
disposable	ks. yang dapat dibuang. d. cup cangkir yang dapat dibuang sesudah dipakai. d. tissues kertas/serbet yang dapat dibuang.
disposal	kb. 1 pembuangan. 2 penyelesaian. 3 pemberian, pembagian.
dispose	kkt. mengatur. -kki. menentukan. to d. of 1 membuang. 2 memberikan.3 makan, 4 menjual, 5 menyelesaikan. 6 mengalahkan. -disposed ks. 1 ingin. 2 cenderung.
disposition	kb. 1 watak. 2 pembagian, penempatan. 3 penyusunan, pengaturan. 4 kecondongan.
dispossess	kkt. mencabut hak milik rumah/flat (karena tak bayar).
disproportion	kb. ketidakseimbangan.
disproportionate	ks. bersifat, tidak sepadan, tidak seimbang (to dengan).
disprove	kkt. menyangkal, menyanggah, membantah. to d. a statement menyangkal ucapan.
dispute	kb. perselisihan, percekcokan. -kkt. membantah. to d. with memperselisihkan, memperdebatkan.
disqualification	kb. diskwalifikasi, pembatalan.
disqualifies	lih disqualify.
disqualify	kkt. (disqualified) membatalkan. to d. s.o. for membatalkan seseorang buat
disquiet	kb. keadaan tidak tenang, kegelisahan.
disquieting	ks. yang bersifat menggangu, menggelisahkan. d. rumors desas-desus yang mengganggu.
disregard	kb. sikap acuh tak acuh. -kkt. 1 tidak memperdulikan, tidak menghiraukan. 2 mengabaikan, mengenyampingkan.
disrepair	kb. keruntuhan, rusak. the house is in d. rumah itu rusak.
disreputable	ks. 1 jelek. d. looking car mobil yang jelek. 2 bernama buruk. d. bar bar (warung) yang namanya tidak baik.
disrepute	kb. keburukan. to hold in d. mengganggap hina/buruk, tidak menghormati.
disrespect	kb. ketiadaan respek, sikap tidak sopan/hormat.
disrespectful	ks. kasar, kurang ajar, tidak sopan. he's d. to his father ia tak menghormati ayahnya.
disrobe	kkt., kki. membuka/menanggalkan pakaian.
disrupt	kkt. mengacaukan, mengganggu.
disruption	kb. gangguan, kekacauan. d. of power service gangguan tenaga listrik.
disruptive	ks. yang mengacaukan, yang mengganggu, yang memecahbelah. d. influence pengaruh yang mengacaukan.
dissatisfaction	kb. ketidakpuasan.
dissatisfied	ks. tidak puas (with dengan).
dissect	kkt. membedah, memotong.
dissection	kb. pemotongan, pembedahan.
dissemble	kkt. menyembunyikan.
disseminate	kkt. 1 menyebarkan (information). 2 menebarkan, menaburkan (seed).
dissemination	kb. 1 penyebaran (of information). 2 penebaran, pertebaran, penaburan (of seed).
dissension	kb. pertikaian, perselisihan.
dissent	kb. perbedaan pendapat, ketidaksepakatan. -kki. tidak setuju, menolak.
dissenter	kb. orang ingkar.
dissertation	kb. disertasi.
disservice	kb. perbuatan yang merugikan. one who overpraises performs a d. orang yang terlalu memuji, merugikan orang.
dissident	kb. orang yang tak sepakat/setuju. -ks. yang tak sepakat/setuju. several d. voices beberapa suara-suara yang tak sepakat.
dissimilar	ks. tidak sama, tidak cocok, berbeda.
dissimulate	kkt. berpura-pura, sok, menyembunyikan.
dissimulation	kb. penipuan, pura-pura, sok.
dissipate	kkt. menghamburkan. -kki. 1 menghilang. 2 merisau, berfoya-foya. -dissipated ks. yang merisau, tidak teratur/senonoh.
dissipation	kb. 1 menghilangnya. d. of the fog menghilangnya kabut. 2 pemborosan. d. of energy pemborosan tenaga.
dissociate	kkt. memisahkan, menjauhkan. to d. o.s. from memisahkan diri dari.
dissociation	kb. 1 disosiasi. 2 peruraian. 3 pemisahan diri.
dissolable	ks. bisa menjadi cair, bisa larut. sugar is d. in water gula dapat menjadi cair dalam air.
dissolute	ks. risau, jangak.
dissolution	kb. 1 pembubaran (of a firm, government). 2 terputusnya. d. of a marriage terputusnya pernikahan.
dissolve	kkt. 1 membubarkan. to d. a partnership membubarkan persekutuan. 2 melarutkan. d. a cup of sugar in water larutkan satu cangkir gula dalam air. -kki. larut. the sugar dissolved gula itu larut.
dissonance	kb. 1 ketidakcocokan, ketidaksesuaian. 2 hiruk pikuk (of auto horn). 3 mus.: kejanggalan bunyi.
dissonant	ks. tidak cocok/sesuai. d. music musik yang tidak harmonis.
dissuade	kkt. meminta supaya jangan mengerjakan sesuatu.
dissyllabic	= disyllabic.
dist.	(district) daerah, distrik.
distaff	kb. keluarga dari pihak ibu. we are related on d. side kami ada hubungan keluarga dari pihak ibu.
distance	kb. 1 jarak. 2 kejauhan. in the d. di kejauhan disana. to keep at a d. menjauhkan, menjauhi. to keep o's d. tidak terlalu ramah dengan, menjauhi.
distant	ks. 1 jauh. 2 tidak ramah. -distantly kk. terpencil, renggang, jauh terpisah. d. related berhubungan renggang, bersanak jauh, berfamili jauh.
distaste	kb. kebencian, rasa tidak suka. to have a d. for tidak suka pada.
distasteful	distasteful
distemper	kb. penyakit pada binatang.
distend	kkt. melembungkan. -kki. menggelembung, gembung. his abdomen was distended perutnya menggelembung.
distill	kkt. 1 menyuling, menyaring. to d. water menyuling air. 2 menyaring. to d. the truth from the hearsay menyaring mana yang benar mana yang omong kosong dari apa yang dikatakan orang. -distilled ks yang disuling. d. water air suling(an).
distillate	kb. hasil sulingan atau saringan, sulingan.
distillation	kb. penyulingan, distilasi.
distiller	kb. penyuling. 2 penyulingan.
distillery	kb. (j. -ries) 1 tempat penyulingan. 2 perusahaan penyulingan. whiskey d. perusahaan penyulingan wiski.
distinct	ks. 1 terang, jelas. 2 nyata. 3 berbeda. to keep s.t. d. membedakan sesuatu. -distinctly kk. dengan jelas.
distinction	kb. 1 perbedaan. 2 hormat. 3 jasa. 4 tanda kehormatan, medali.
distinctive	ks. 1 khusus. d. manner of dress cara berpakaian khusus. 2 tersendiri. d. sound bunyi yang tersendiri.
distinguish	kkt. 1 membedakan. 2 membeda - bedakan, melihat dengan jelas. -kki. to d. between membedakan antara. -distinguished ks. terhormat,terkenal, terkemuka, masyur. -distinguishing ks. yang membedakan, istimewa, khusus.
distinguishable	ks. dapat di (per)bedakan.
distort	kkt. mengubah. -distorted ks. berubah (bentuk), menyimpang.
distortion	kb. 1 distorsi. d. -free viewing penglihatan yang bebas dari distorsi. 2 penyimpangan, pemutar-balikan. d. of the facts penyimpangan dari kenyataan-kenyataan.
distowel	kb. lap piring.
distract	kkt. 1 mengalihkan. 2 menggangu, membingungkan. -distracted ks. bingung, kacau pikiran. -distracting ks. mengacaukan pikiran, membingungkan.
distraction	kb. 1 selingan. pleasant d. selingan yang menyenangkan. 2 gangguan, kebingungan. to drive s.o. to d. menyebabkan seseorang bingung.
distraught	ks. bingung sekali, putus asa. to be d. over bingung sekali, ketakutan karena.
distress	kb. keadaan yang sukar/berbahaya, kesukaran. -kkt. menyusahkan. -distressed ks. menderita. -distressing ks. menyedihkan, menyusahkan.
distribute	kkt. 1 membagikan. 2 menyalurkan (commercial products). 3 menyebarkan, mengedarkan (leaflets). 4 mendistribusikan, membagikan. 5 mengageni (cars).
distribution	kb. 1 penyaluran. d. of rice penyaluran beras. 2 distribusi, pembagian (of prizes, wealth, candy).
distributor	kb. 1 penyalur (of rice, cloth). 2 pengecer. car d. pengecer mobil. 3 auto.: pembagi arus, distributor, delko.
distributorship	kb. 1 usaha atau daerah pengecer (of cars, refrigerators). 2 (agency) perwakilan, peragenan (sebagai penyalur).
district	kb. 1 daerah (pemerintahan), daswati. 2 distrik. d. attorney jaksa wilayah. d. court pengadilan wilayah. d. judge ketua/hakim mahkamah daerah. d. manager pemimpin wilayah.
distrust	kb. rasa tidak percaya, ketidak percayaan. -kkt. tidak percaya. i d. him saya curiga kepadanya.
distrustful	ks. bersifat curiga. he is d. of me dia mencurigai saya.
disturb	kkt. mengganggu. sorry to d. you maaf saya menggangu saudara. -disturbing ks. mengganggu, menggelisahkan. d. news berita yang menggelisahkan.
disturbance	kb. 1 gangguan, godaan. atmospheric d. gangguan cuaca. 2 kerusuhan, perusuhan. 3 kekacauan, pengacauan.
disturber	kb. 1 pengganggu. d. of the peace pengganggu ketentraman/perdamaian. 2 perusuh, pengacau.
disunite	kkt. memecah-belah. the country was disunited negeri itu terpecah-belah.
disunity	kb. (j. -ties) perpecahan.
disuse	kb. keadaan tidak dipakai. that expression has fallen into d. ungkapan itu sudah tak dipakai lagi.
diswasher	kb. mesin atau orang pencuci piring.
disyllabic	ks. bersuku dua.
disyllable	kb. suku dua.
ditch	kb. selokan, parit. -kkt. 1 mendaratkan diatas air (a plane). 2 sl.: melenyapkan, menyingkirkan, membuang. to steal a car and then d. it mencuri mobil dan menyingkirkannya.
ditchdigger	kb. penggali parit.
dither	kb. 1 sibuk sekali. to be all in a d. over o's wedding sibuk sekali karena perkawinannya. 2 gentar, gigil.
ditto	kb. sama, dito. -kkt. menyalin, membuat suatu kopi. to d. a letter menyalin surat.
div.	(division) 1 bagian. 2 divisi.
divan	kb. dipan, amben.
dive	kb. penyelaman (of a submarine). 2 tukikan. 3 inf.: tempat minuman dan permainan judi yang murah. -kki. 1 terjun. 2 menyelam. 3 inf.: masuk. 4 berkecimpung, terjun. 5 menghilang. 6 merogoh. -diving kb. 1 penyelaman. 2 sport ; loncat indah.
diver	kb. penerjun. 2 penyelam, juru selam.
diverge	kki. 1 berbeda. 2 menyimpang, bercabang. the roads d. two miles farther on jalan-jalan itu bercabang pada jarak dua mil lagi.
divergence	kb. perbedaan. a d. of opinion perbedaan pendapat.
divergent	ks. berlainan, berbeda. to hold d. opinions mempunyai pendangan-pandangan yang berlainan.
diverse	ks. bermacam-macam. d. talents bermacam-macam bakat.
diversification	kb. perbedaan, pembedaan, diversifikasi, penggolongan. d. of crops penggolongan hasil bumi.
diversify	kkt. (diversified) membuat variasi, menanam berjenis-jenis tanaman. -diversified ks. berjenis-jenis, bergolongan. d. farming pertanian berjenis-jenis tanaman.
diversion	kb. 1 hiburan. 2 pengalihan. 3 mil.: (gerakan) pengalihan perhatian. to create a d. mengadakan gerakan mengalihkan perhatian musuh.
diversionary	ks. bersifat mengalih. d. tactics taktik mengalihkan perhatian, taktik untuk membingungkan.
diversity	kb. (j, -ties) perbedaan. d. of industry aneka ragam industri.
divert	kkt. 1 mengalihkan. 2 menggelapkan, menyelewengkan. 3 membelokkan. -diverting ks. mengasyikkan.
divest	kkt. membebaskan, melepaskan. to d. o.s. of o's business interests membebaskan dari kepentingan-kepentingan dagangnya.
divide	kb. pembagi. -kkt. 1 membagi. 2 memisahkan. -kki. 1 bercabang. 2 membagi. -divided ks. yang bercabang. a dividing wall sebuah tembok pemisah (antara dua rumah).
dividend	dividend
divider	kb. 1 pembagi. 2 sekat, dinding pembagi. -dividers j. jangka pembagi garis.
divine	ks. 1 bersifat ketuhanan. 2 hebat. -kkt. meramalkan.
divinity	kb. (j. -ties) 1 dewa, tuhan. 2 ketuhanan, kedewaan. d. school sekolah tinggi teologi(a).
divisible	ks. dapat dibagi. ten is d. by two sepuluh dapat dibagi dengan dua.
division	kb. 1 divisi. d. commander komandan divisi 2 pembagian. 3 bagian. 4 pembelahan. cell d. pembelahan sel.
divisional	ks. yang berhubungan dengan divisi atau bagian. d. headquarters markas besar divisi.
divisive	ks. yang bersifat memecah belah. their actions are d. in nature tindakan-tindakan mereka itu bersifat memecah- belah.
divisor	kb. pembagi.
divorce	kb. 1 perceraian, talak. to get a d. minta cerai/talak. 2 pemisahan. -kkt. menceraikan, bercerai, talak. d. decree surat cerai/lepas/talak.
divorcee	kb. orang yang diceraikan/bercerai.
divot	kb. lubang bekas tanah yang turut terpukul ketika melakukan pukulan bola golf.
divulge	kkt. membuka rahasia, membocorkan, memberitahukan.
divvy	kkt. (divvied) sl.: membagi-bagi.
dixie	d. cup mangkok minuman (terbuat dari kertas).
dizziness	kb. kepusingan, kepeningan.
dizzy	ks. pusing, pening, tujuh keliling. to d. heights tinggi (sekali) sehingga memusingkan kepala. d. spell serangan pusing.
do	kb. yang boleh atau yang harus dikerjakan. -kkt. (did, done) 1 mengerjakan. 2 lari, menempuh. 3 melakukan, mengerjakan. 4 menyelesaikan. 5 membuat. 6 membereskan. 7 memecahkan, membuat. 8 bermain dalam. 9 mementas.
do.	(ditto) sama.
doc	kb. inf.: cara berbicara pada seorang dokter.
doc.	(document) dokumen.
docile	ks. 1 jinak. d. dog anjing jinak. 2 patuh. d. people orang yang patuh.
dock	kb. 1 dok, dermaga. 2 galangan kapal. -kkt. 1 membawakan ke dok (a ship) 2 memotong (wages, a horse's tail). 3 mengaitkan (a spaceship). -kki. masuk dok. -docking kb. 1 masuk dok. 2 perkaitan (of a spaceship).
docker	kb. buruh pelabuhan.
docket	kb. acara pengadilan.
dockside	kb. tepi dok. at d. di tepi dok sebelah pelabuhan. -ks.di pelabuhan. d. strike pemogokan di pelabuhan.
dockworker	kb. buruh pelabuhan.
dockyard	kb. galangan kapal.
doctor	kb. (kep. dr., dr) 1 acad.: doktor. 2 med.: dokter. -kkt. inf.: 1 mengobati, merawat. 2 membetulkan. 3 memalsukan (a document).
doctoral	ks. doktoral. d. dissertation disertai doktoral.
doctorate	kb. gelar doktor.
doctrinaire	ks. bersifat teoretis, yang tak praktis. d. ideas gagasan-gagasan yang tidak praktis. d. attitude sikap dogmatis.
doctrine	kb. doktrin, ajaran.
document	kb. 1 dokumen. 2 surat-surat perjalanan. -kkt. membuktikan kebenaran sesuatu.
documentary	kb. (j. -ries) film dokumentasi. -ks. dokumenter (film, proof).
dodder	kki. gemetar, menggetar. -doddering ks. gemetar, menggigil. a d. idiot seorang pandir yang gemetar.
dodge	kb. 1 alasan (menghindarkan sesuatu). 2 muslihat. 3 (peng)elakan. -kkt. 1 mengelak (a blow, question). 2 menghindari, menjauhi. -kkt. mengelak.
dodger	kb. pengelak.
dodo	kb. semacam burung yang tak dapat terbang. as dead as the d. punah, mati konyol/katak.
doe	kb. 1 (deer) kijang betina. 2 (rabbit) kelinci betina.
doer	kb. seorang yang bertindak/berbuat, pelaku.
does	lih do.
doff	kkt. mengangkat. to d. o's hat mengangkat topinya.
dog	kb. 1 anjing. 2 inf.: orang. -dogs j. sl.: kaki. -kkt. (dogged) mengikuti. d. pound tempat mengumpulkan anjing-anjing yang hilang. -dogged ks. berkeras kepala, tabah, mantap. d. determination ketetapan yang pasti/mantap.
dogcart	kb. 1 bendi sado. 2 kereta yang ditarik anjing.
dogfight	kb. 1 perkelahian sengit. 2 pertempuran antara pesawat pemburu yang kejar-mengejar.
dogfood	kb. makanan anjing.
doggerel	kb. sanjak yang tidak bermutu kesusasteraan.
doggone	ks. sl.: celaka. -kk. sangat, amat.
doggy	kb. (j. -gies) anjing kecil. d. bag kantong untuk mengumpulkan sisa makanan (di restoran) untuk dibawa pulang.
doghouse	kb. rumah/kandang anjing. sl.: in the d. dibenci, tidak disukai. i'm in the d. at home saya menjadi dibenci di rumah.
dogma	kb. dogma, ajaran agama, akaid.
dogmatic	ks. dogmatis. a d. person seorang yang fanatik terhadap sesuatu ajaran.
dogpaddle	kki. berenang seperti anjing.
dogwood	kb. pohon atau tanam-tanaman yang daun-daunnya putih atau merah.
doily	kb. (j. -lies) alas yang ditaruh dibawah piring, semacam serbet kecil.
dokumentation	kb. dokumentasi.
doldrums	kb. j. meteor.: daerah angin mati. to be in the d. 1 tidak bersemangat, patah hati. 2 lesu, melempen. business is in the d. usaha dagang sedang melempem.
dole	kb. sedekah, uang sokongan. to be on the d. menerima uang sokongan karena menganggur. -kkt. to d. out mendermakan kepada.
doleful	ks. muram, sedih.
doll	kb. 1 boneka. 2 (girl) gadis cantik. -kkt., kki. to d. up berdandan. she 's all dolled up dia berdandan bagus.
dollar	kb. dolar. d. sign lambang dolar ($).
dollhouse	kb. rumah-rumahan, rumah boneka.
dolly	kb. (j. -lies) kb. 1 boneka. 2 kerek pengangkut barang berat. 3 mobil gerobak kecil yang memuat kamera tv atau kamera gambar hidup. 4 semacam lori.
dolphin	kb. ikan lumba-lumba.
dolt	kb. orang tolol.
domain	kb. 1 daerah/bidang kekuasaan. in the d. of law dalam bidang hukum. 2 wewenang. that matter is not within my d. masalah itu tidak merupakan wewenang saya.
dome	kb. kubah (of a church). 2 lengkungan puncak (of a hill). dome-shaped ks. berbentuk kubah.
domestic	kb. pelayan rumah, babu dalam. -ks. 1 dalam negeri. 2 rumah tangga. 3 piaraan. d. help pembantu rumah. d. science kepandaian puteri, kepandaian rumah tangga.
domesticate	kkt. menjinakkan.
domesticity	kb. 1 kerumahtanggaan. 2 kesukaan akan kehidupan rumah tangga dan keluarga.
domicile	kb. tempat tinggal.
dominance	kb. kekuasaan.
dominant	ks. 1 berkuasa. d. in asia berkuasa di asia. 2 berpengaruh, terkemuka. d. figure in local politics tokoh yang berpengaruh di kalangan politik setempat. 3 kuat, yang menonjol. d. characteristic sifat/ciri yang kuat.
dominate	kkt. menguasai. to d. other people menguasai orang lain. -kki. berkuasa, besar pengaruhnya blacks d. in this section of the city orang kulit hitam berkuasa di bagian kota ini.
domination	kb. penguasaan, kekuasaan.
domineer	kki. menguasai. he domineers over the whole family ia menguasai seluruh keluarganya dengan mutlak. -domineering ks. bersifat menguasai dengan keras sekali. d. father bapak yang menguasai dengan keras sekali.
dominion	kb. dominion. the d. of canada dominion kanada. to hold d. over berkuasa di.
domino	kb. kartu domino. -dominoes j. permainan domino.
don	kkt. (donned) mengenakan. to d. o's robe mengenakan jubah.
don't	(do not) 1 jangan. 2 tidak, tak. 3 lih do.
donate	kkt. mendermakan, menyumbangkan. to d. blood mendermakan darah.
donation	kb. sumbangan, derma.
done	lih do.
donee	kb. penerima.
donkey	kb. keledai. d. engine mesin pembantu. d. work pekerjaan yang membosankan.
donor	kb. donor, penderma, dermawan, pemberi. blood d. penderma/donor darah.
doodad	kb. inf.: perhiasan (yang tak berharga).
doodle	kb. gambar yang tak berarti. -kki. menggambar dengan melamun atau sambil bercakap-cakap atau sambil memikirkan sesuatu.
doohickey	kb. sl.: barang/alat kecil (tanpa nama).
doom	kb. 1 ajal. to meet o's d. menemui ajalnya. 2 malapetaka. a sense of impending d. firasat akan datangnya malapetaka. -kkt.menghukum. the murderer was doomed to death pembunuh itu dihukum mati.
doomsday	kb. hati din/kiamat.
door	kb. 1 pintu. 2 rumah. 3 kemungkinan, kesempatan. to lay at the d. of menyalahkan. door-to-door ks. dari rumah ke rumah. d. prize karcis berhadiah.
doorbell	kb. bel pintu.
doorkeeper	kb. penjaga pintu.
doorknob	kb. kenop/tombol pintu.
doorman	kb. (j. -meen). penjaga pintu.
doormat	kb. kosek kaki, kesetan, pengeset kaki.
doornail	kb. paku pintu. dead as a d. mati betul.
doorstep	kb. ambang pintu.
doorway	kb. pintu keluar masuk.
dope	kb. 1 sl.: obat bius seperti morfin, candu dsb. 2 sl.: si tolol. 3 pernis. 4 sl.: keterangan. -kkt. 1 mengobati. 2 memberi obat.
dopey	ks. sl.: 1 lemas/pusing karena obat bius. 2 tolol, bebal, bodoh.
dorm	inf.: = dormitory.
dormant	ks. 1 terbengkalai/terhenti, tidak aktif. 2 tidur. bears are d. during the winter beruang-beruang tidur selama musim dingin.
dormer	kb. d. window jendela pada atap.
dormitory	kb. (j. -ries) asrama (mahasiswa).
dorsal	ks. yang bertautan dengan punggung. d. sound bunyi belakang lidah. d. nerve saraf (bagian) punggung. d fin sirip belakang.
dosage	kb. takaran, dosis.
dose	kb. dosis. to take a d. of medicine minum setakar atau makan satu dosis obat. -kkt. mengobati, memberi obat.
dosn't	[ does not ] lih do.
dossier	kb. catatan/dokumen tentang sesuatau hal atau seseorang.
dot	kb. titik. 2 bintik, tutul. -kkt. (dotted) menaruh titik. on the d. tepat pada waktunya. -dotted ks. ditandai dengan titik-titik.
dotage	kb. sifat pikun, sifat kekanak-kanakan, karena umur tua.
dote	kki. menjadi kekanak-kanakan karena umur tua. to d. on sangat gemar akan. -doting ks. 1 yang gemar akan. 2 bersifat kekanak-kanakan.
double	kb. 1 aktor/aktris pengganti. 2 pasangan. -ks. 1 rangkap, dobel. 2 dua kali (lipat). kk. lipat dua. -kkt. 1 menggandakan, menduakalikan. 2 mendobelkan. 3 mengepalkan. kki. 1 merangkap. 2 berlipat dua. -doubling kb. pergandaan, lipat.
doublet	kb. sepasang benda yang sama.
doubt	kb. ragu-ragu, kesangsian. -kkt. 1 menyangsikan. 2 ragu. kki. menyangsikan. -doubting ks. yang meragukan.
doubtful	ks. sangsi, ragu-ragu. i'm d. about the weather tomorrow saya sangsi akan udara besok.
doubtless	kk. pasti, yakin. he'll d. win dia pasti akan menang.
douche	kb. pancuran, semprotan air. to use a d. to relieve nasal congestion menggunakan obat semprotan untuk menghilangkan kemampatan di hidungnya.
dough	kb. 1 adonan. 2 sl.: uang, duit.
doughnut	kb. (kue) donat.
doughty	ks. (gagah) berani.
dour	ks. keras, masam. d. look wajah yang keras.
douse	kkt. 1 menyiramkan air kedalam. to d. fire menyiramkan air kedalam api. 2 memasukkan kedalam air, mencelupkan. to d. burning paper in water memasukkan kertas yang terbakar kedalam air.
dove	lih dive.
dovetail	kb. sambungan pada kayu, besi dsb. terdiri dari bagian-bagian yang dimasukkan ke celah-celah pada bagian yang akan disambung. -kki. 1 menyambung gengan mmasukkan bagian ke celah-celah bagian yang lain. 2 cocok, pas.
dowager	kb. 1 janda permaisuri. 2 janda yang berhak menerima warisan.
dowdy	ks. tidak rapi (berpakaian).
dowel	kb. 1 paku dinding/semat. 2 sepotong kayu dipantakkan kedalam tembok untuk tempat paku-paku.
down	kb. 1 bulu burung. 2 isi bantal. 3 bulu halus. -downs j. lih up. -ks. 1 yang turun. 2 murung, muram. 3 turun. 4 datang, turun. 5 membayar dulu/dimuka. 6 sakit. 7 kempis, kurang angin. 8 tenggelam/ terbenam. 9 ketinggalan. 10 reda. 11 surut.
downbeat	kb. 1 permulaan/pembukaan lagu/musik. 2 gerakan tangan pemimpin orkes kebawah menunjukkan musik dimulai.
downcast	ks. sedih, putus asa, susah.
downfall	kb. keruntuhan, kehancuran (of a kingdom, empire). 2 kejatuhan. heavy d. of snow salju yang turun dengan lebatnya.
downgrade	kb. lereng (bagian yang menurun). to be on the d. 1 mulai menurun (of business). 2 martabat turun (of a person). -kkt. 1 menurunkan pangkat/kelas (an employee). 2 merendahkan (s.o.).
downhearted	ks. sedih, putus asa, murung.
downhill	kk. to god. turun bukit. going d. is dangerous berjalan menurun di jalan membahayakan.
downpour	kb. hujan lebat.
downrange	ks., kk. several hundred miles d. beberapa ratus mil dari tempat peluncuran.
downright	downright
downrodden	ks. tertindas, tertindih.
downstairs	kb. ruang bawah. -ks. yang terletak di ruangan bawah. -kk. dibawah, kebawah. to fall d. jatuh dari tangga.
downstream	kk. hilir, menghilir. he lives d. ia tinggal dihilir. to go d. berlayar kehilir.
downtown	ks. the d. section kota bagian yang ramai. -kk. kota (bagian yang ramai tempat perdagangan). to go d. pergi kekota.
downturn	kb. kecenderungan untuk menurun.
downward	ks. yang menurun. d. trend kecenderungan untuk menurun. -kk. kebawah. bent d. dilengkungkan kebawah.
downwards	= downward kk.
downwind	ks., kk. menurut jurusan angin.
downy	ks. tertutup dengan bulu halus, berbulu halus.
dowry	kb. (j. -ries) mas kawin, mahar.
dowse	= douse.
doxology	kb. (j. -gies) kidung-puji, zikir, lagu-lagu pujian.
doz.	(dozen) lusin.
doze	kb. tidur sebentar/sejenak. -kki. tidur-tiduran, tidur ayam, mengantuk. to d. off tertidur sebentar.
dozen	kb. lusin, dosin. three d. eggs tiga lusin.
dp	[displaced person] kb. orang terlantar.
dr.	[doctor] 1 acad.: doktor. 2 med.: dokter.
drab	kb. kain belacu. -ks. 1 membosankan. 2 tidak menarik. 3 menjemukan, membosankan.
draft	kb. 1 (tindakan) wajib militer (wamil). 2 naskah isi, konsep. 3 teguk. 4 sarat/daya muat (of a ship). 5 aliran udara, angin jujut 6 alat mengatur jalan udara pada tempat perapian. 7 surat wesel. -kkt. 1 memanggil wajib militer. 2 membuat bagan.
draftee	kb. wamil, wamida, orang yang kena wajib militer.
draftsman	kb. (j. -men) juru gambar, penggambar.
drafty	ks. banyak angin, berangin.
drag	kb. 1 tarikan. 2 sl.: isapan (an a cigarette). 3 pengerem, penahan. 4 sl.: seorang yang membosankan. -kkt. (dragged) 1 mengeruk. 2 menarik, menyeret. 3 memaksa pergi. -kki. 1 berlarut-larut. 2 terseret. 3 sl.: ngebut.
dragnet	kb. 1 jala seret, pukat. 2 jaring (of the police).
dragon	kb. (ular) naga.
dragonfly	kb. (j. -flies) capung.
dragoon	kkt. memaksa. to d. s.o. into doing s.t. memaksa seseorang agar melakukan sesuatu.
drain	kb. 1 saluran. 2 pipa saluran/kuras, urung-urung. 3 pengosongan. down the d. sia-sia, gagal. -kkt. 1 menghabiskan. 2 mengeringkan. 3 meminum habis. 4 mengalirkan. 5 menarik, mengeluarkan. -kki. keluar airnya.
drainage	kb. 1 pengeringan, pembuangan air. 2 pengurasan, penyaluran, pengaliran. 3 susunan saluran jalan air. 4 daerah yang dikeringkan. d. basin kolam tempat menyalurkan air. d. ditch parit saluran air. d. tube tabungan penyalur(an).
drainboard	kb. rak untuk mengeringkan piring-piring.
drainpipe	kb. pipa saluran air, talang.
dram	kb. dram (1/8 ons).
drama	kb. 1 sandiwara. 2 seni drama. 3 drama. 4 kejadian. the assassination was an exciting d. pembunuhan itu adalah suatu kejadian yang menggugah perasaan
dramamine	kb. obat mabuk, dramamin.
dramatic	ks. 1 dramatis. 2 yang berhubungan dengan drama, sandiwara. 3 beraksi.
dramatics	kb. 1 seni drama. d. is taught at that school seni drama diajarkan disekolah itu. 2 sandiwara amatir. d. are presented in that theater sandiwara amatir dipentaskan di gedung sandiwara itu.
dramatis personae	kb. para pelaku.
dramatist	kb. penulis/pengarang sandiwara.
dramatization	kb. dramatisasi, penulisan drama.
dramatize	kkt. 1 menguraikan dengan cara yang mengesankan. to d. o's experiences menguraikan pengalaman-pegalamannya dengan cara yang mengesankan. 2 menyandiwarakan (a novel).
drank	lih drink.
drape	kb. (kain) tirai, gorden. -kkt. 1 mengenakan. to d. a shawl the shoulders mengenakan sal di bahu. 2 menghias. to d. in/with bunting menghias dengan kain-kain bendera.
drapery	kb. (j. -ries) bahan gorden.
drastic	ks. tegas, ganas. to take d. measures mengambil langkah - langkah tegas. -drastically kk secara drastis/radikal.
drat	kkt., kseru. inf.: d. it ! it's raining again persetan ! hujan lagi.
draught	= draft.
draughtsman	= draftsman.
draw	kb. 1 tarikan. 2 seri. -kkt. (drew, drawn) 1 menggambar (a picture). 2 menarik, menutup (a curtain). 3 mengambil(kan). 4 mendatangkan. 5 menghela. 6 menyebabkan. 7 mendapat. 8 menyeret. 9 memindahkan. 10 membuang isi perut. (of foul).
drawback	kb. kekurangan. d. to a house kekurangan pada rumah.
drawbridge	kb. jembatan jungkatan/tarikan.
drawer	kb. 1 laci. 2 ahli gambar. cloth.: -drawers j. celana panjang dalam.
drawerful	kb. selaci penuh.
drawl	kb. cara berbicara dengan memperpanjang bunyi-bunyi kata.
drawn	lih draw.
drawstring	kb. (tali) kolor, tali seluar/celana.
dread	kb. rasa takut, ketakutan. -kkt. takut (kepada).
dreadful	ks. yang mengerikan/menakutkan. d. accident kecelakaan yang mengerikan. -dreadfully kk. sangat. d. slow sangat pelan. i'm d. sorry saya sangat menyesal.
dreadnought	kb. kapal penempur.
dream	kb. impian, mimpi. to have a d. bermimpi. -kkt., kki. (dreamed atau dreamt). 1 bermimpi. 2 membayangkan. 3 memikirkan. -dreaming kb. bermimpi, melamun.
dreamer	kb. 1 penghayal. 2 orang yang tak praktis. i'm a d. saya tukang bermimpi.
dreamland	kb. alam mimpi/khayal.
dreamt	lih dream.
dreamy	ks. 1 mengelamun. 2 sl.: hebat.
dreariness	kb. kesuraman. d. of the weather kesuraman cuaca.
dreary	ks. suram, redup. d. day hari redup.
dredge	kb. kapal korek/keruk, kilang keruk. -kkt. mengeruk. to d. up membangkit-bangkitkan, mengorek- ngorek, membongkar-bongkar. d. bucket gayu yang pengeruk, singkup keruk. -dredging kb. pengerukan.
dredger	kb. kapal keruk.
dregs	kb., j. 1 ampas (of coffee, tea). 2 sampah. d. of society sampah masyarakat.
drench	kkt. 1 memberi minum (a horse). 2 membuat basah kuyup. i was drenched by the storm saya basah kuyup karena hujan angin ribut itu.
dress	kb. 1 rok, gaun. 2 pakaian. -kkt. (dressed atau drest). 1 mencabuti bulu (a chicken). 2 mengenakan baju. 3 menghiasi. 4 membalut. -kki. 1 berpakaian. 2 berdandan. -dressing kb. 1 pembalut, balutan. 2 bumbu-bumbu isian 3 kuah. 4 berdandan,.
dresser	kb. furn.: 1 lemari (rias). 2 juru rias.
dressmaker	kb. penjahit, modiste.
dressy	ks. berpakaian, bergaya.
drest	lih dress.
drew	lih draw.
dribble	kb. 1 tetesan. 2 meteor.: gerimis. 3 penggiringan bola (in basketball). -kki. 1 menetes, mencucurkan air liur (of babies). 2 sport : menggiring bola mendrible.
dried	lih dry.
drier	lih dry.
dries	lih dry.
driest	lih dry.
drift	kb. 1 penyimpangan. 2 arus, aliran. 3 arah. -kkt. menimbun, meniup. -kki. 1 bertimbun. 2 melayang. 3 menggeluyur. 4 melintas. 5 ikut-ikutan masuk. 6 singgah, mampir. 7 berhanyut-hanyut. 8 lepas. -drifting kb., ks. yang ditiup angin.
drifter	kb. orang gelandangan/jembel.
driftwood	kb. kayu apung/pelampung.
drill	kb. 1 bor. 2 gurdi, jara, penggerek. 3 latihan. 4 cloth.: (kain) dril. -kkt. 1 membor. 2 melatih. -kki. berlatih. -drilling kb. 1 pemboran, penggerekan, penggurdian, pengeboran. 2 mil.: latihan berbaris.
drillmaster	kb. 1 mil.: pelatih berbaris. 2 pelatih. he's a stern d. dia seorang pelatih yang keras.
drink	kb. 1 minuman. 2 (strong) minuman keras. 3 sl.: kumpulan air sebagai kolam, danau, sungai. -kkt. (drank, drunk) minum. -kki. minum. -drunk kb. pemabuk. -drinking kb. minum minuman keras.
drinker	kb. peminum. hard/heavy d. peminum yang banyak sekali minum.
drip	kb. tetes (an). 2 sl.: orang yang menghambat. -kkt. (dripped) meneteskan. -kki. menetes. -dripping ks. menetes. -drippings. j. tetesan gemuk atau air daging.
drive	kb. 1 perjalanan. 2 jalan raya. 3 kampanye, gerakan. 4 sport.: pukulan. 5 persneling. 6 jalan mobil (= drivemay).7 perangsang. 8 serangan/serbuan pembasmian. 9 gerakan. -kki. 1 mengendarai. 2 naik mobil, berkendaraan. -driving kb. mengemudikan.
drivel	kb. 1 air liur. 2 omongan yang tolol.
driven	lih drive.
driver	kb. 1 supir, pengemudi, tukang setir, pengendara. 2 golf : alat pemukul bola golf yang ujungnya terbuat dari kayu untuk pukulan jauh. 3 poros penggerak. 4 mandor.
driveway	kb. jalan untuk mobil (di halaman).
drizzle	kb. hujan, gerimis, hujan rintik-rintik. -kki. gerimis. it drizzled all day gerimis sepanjang hari.
drizzly	ks. muram/mendung dengan hujan rintik-rintik.
drogue	kb. parasut pesawat.
droll	ks. lucu, menggelikan hati. d. sense of humor perasaan yang lucu/menggelikan.
drone	kb. 1 (bee) lebah jantan. 2 gemuruh (of a plane, etc) 3 pemalas. 4 dengungan. d. of mosquitoes dengungan nyamuk. -kki. 1 berbicara dengan yang membosankan. 2 berdengung (of a bee, plane).
drool	kb. air liur. -kkt. mengeluarkan air liur.
droop	kb. keadaan terkulai. -kki. 1 layu. 2 terasa berat. -drooping ks. murung. d. spirits semangat yang sudah melempem/kendor.
drop	kb. 1 tetes (an). 2 gula-gula. 3 penurunan, keadaan menurun, kemerosotan. 4 keadaan jatuh. -kkt. (dropped) 1 menjatuhkan. 2 memasukkan. 3 membubarkan, menyuruh bubar. 4 mengeluarkan, mencoret. 5 menghentikan. 6 mengalahkan. -droppings j. tahi (burung).
dropper	kb. (alat) penetes.
dropsy	kb. sakit gembur-gembur.
dross	kb. barang-barang yang dibuang.
drought	kb. masa kekeringan, (musim) kemarau.
drove	kb. kumpulan. a d. of cattle sekumpulan ternak. in droves berbondong-bondong. lih drive.
drown	kkt. 1 menenggelamkan.(s.o). 2 menghilangkan. 3 menggenangi. -kki. mati tenggelam. -drowned ks. sl.: basah kuyup. -drowning kb. there was a d. at the beach ada seorang yang tenggelam di pantai. ks. yang mati tenggelam.
drowsiness	drowsiness
drowsy	ks. mengantuk. i feel d. saya (malas dan) mengantuk.
drub	kkt. (drubbed) 1 mengalahkan. 2 memukuli. -drabbing kb. 1 kekalahan. 2 pukulan.
drudge	kb. orang yang mengerjakan pekerjaan yang membosankan.
drudgery	kb. (j. -ries) pekerjaan yang membosankan.
drug	kb. kb. 1 med.: obat, obat-obatan. 2 narc.: obat bius. -kkt. (drugged) 1 meracuni. 2 membiuskan.
druggist	kb. apoteker, ahli obat.
drugstore	kb. 1 toko obat yang juga menjual barang-barang lain seperti minuman-minuman, eskrim dsb. 2 apotik.
drum	kb. 1 genderang, gendang, tambur. 2 drum. 3 drum, tong. 4 teromol. -kkt. (drummed) memompakan berulang-ulang. -kki. mengetok. -drumming kb. permainan tambur.
drumstick	kb. 1 mus.: tongkat pemukul genderang. 2 kaki ayam/kalkun (bagian bawah).
drunk	lih drink.
drunkard	kb. pemabuk.
drunken	ks. yang mabuk. a d. man seorang yang mabuk. d. driving mengendarai mobil dalam keadaan mabuk.
drunkenness	kb. keadaan mabuk, kemabukan.
dry	ks. (drier, driest) 1 kering. 2 membosankan. 3 haus. -kkt. (dried, drying) 1 mengusap, mengeringkan. 2 mengeringkan (dishes, hair, car). -kki. kering. -dried ks. yang dikeringkan. -drying kb. pengeringan. -dryly kk. secara kering.
dryer	kb. (alat) pengering.
dryness	kb. 1 kekeringan. 2 sifat yang membosankan.
du.	[dutch] belanda.
dual	ks. rangkap dua, dwirangkap. dual purpose ks. dwiguna, untuk dua macam keperluan.
dub	kb. orang yang canggung/kaku. -kkt. (dubbed) 1 menganugerahi pangkat. 2 memberi julukan. 3 membubuhkan musik, suara, dll. -dubbing kb. penyuaraan, diisi suara.
dubious	ks. 1 yang meragukan. d. advantages keuntungan-keuntungan yang meragukan. 2 ragu-ragu. i'm d. about his ability saya ragu akan kecakapannya.
duchess	kb. isteri seorang duke, wanita bangsawan.
duck	kb. bebek, itik. -ducks j. celana kain lina (putih). -kkt. 1 inf.: menghindari. 2 membenamkan. 3 menundukkan. -kki. 1 membungkuk. 2 masuk, mampir.
duckling	kb. anak itik.
duct	kb. 1 pembuluh. tear d. pembuluh air mata. 2 pipa, saluran.
dud	kb. 1 sesuatu yang tidak meletus. the bomb was a d. bom itu tidak meletus. 2 sl.: orang yang tidak berbakat.
dude	kb. pesolek.
due	kb. hak. she never asks for more than her d. dia tak pernah meminta lebih daripada haknya. -dues j. iuran. -ks. seharusnya
duel	kb. perang tanding, duel, perkelahian/pertandingan.-kki. (juga duelled) berduel. -dueling kb. perkelahian antara dua lawan, memakai pistol/pedang.
duet	kb. duet
duff	kb. sl.: pantat.
duffer	kb. inf.: orang yang canggung. d. at golf pemain golf yang masih canggung atau yang masih belum pandai benar.
duffle	kb. d. bag ransel.
dug	lih dig.
dugout	kb. mil.: lubang perlindungan. 2 sport : tempat tunggu para pemain baseball. 3 nau.: sampan dibuat dari batang kayu yang dikorok.
duke	kb. adipati.
dull	ks. 1 tumpul, majal. 2 sepi. 3 pudar. 4 menjemukan, membosankan. 5 tidak mengkilap (of shoes). -kkt. 1 menumpulkan. 2 mengurangi, menghilangkan. -kki. menjadi tumpul. dull-witted ks. bodoh, tidak tajam.
duly	kk. sebagaimana, seharusnya, sepatutnya. he was d. installed as chairman dia dilantik sebagai ketua sebagaimana mestinya.
dumb	ks. bisu, kelu. animals are d. binatang itu bisu. 2 dungu, bodoh, bebal. a d. remark ucapan yang bodoh betul.
dumbbell	kb. 1 (exercise) halter. 2 sl.: orang bodoh.
dumbfound	kkt. menakjubkan, mengherankan. -dumbfounded ks. tercengang, ternganga. i was d. by his remark saya tercengang mendengar ucapannya itu.
dumbwaiter	kb. rak piring dan cangkir yang dapat naik-turun ke ruangan atas.
dumfound	= dumbfound.
dummy	kb. (j. -mies) 1 boneka untuk menggantungkan pakaian di etalase. 2 boneka yang dipakai oleh tukang jahit untuk mengenakan baju. 3 orang-orangan yang dipakai sebagai sasaran menembak. 4 contoh, model. 5 bridge : dumi. -ks. kosong.
dump	kb. 1 tempat sampah. 2 sl.: tempat yang kotor. -dumps k. kesedihan. -kkt. 1 membuang. 2 melimpahkan. 3 membanjiri, mengeluarkan. -dumping kb. dumping
dumpling	kb. kue bola. apple d. kue bola berisi buah apel.
dumpy	ks. gemuk dan pendek.
dun	kkt. (dunned) menagih, mengganggu dengan tagihan.
dunce	kb. 1 orang bodoh, anak yang dungu. 2 anak yang lembut dalam pelajaran.
dune	kb. bukit pasir (di pesisir).
dung	kb. tahi hewan,pupuk kandang, kotoran.
dungaree	kb. celana jengki.
dungeon	kb. kamar dibawah tanah tempat menahan orang.
dunk	kkt. mencelupkan (a person, doughnut).
duo	kb. pasangan.
duodecimal	ks. perduabelas.
duodenum	kb. usus dua belas jari.
dupe	kb. korban penipuan. -kkt. menipu, menggait.
duplex	ks. rangkap (dua), rakit. d. apartment flat dengan dua tingkat. d. house rumah kopel (untuk dua keluarga).
duplicate	kb. 1 salinan, duplikat. 2 salinan, turunan duplikat. -ks. rangkap. -kkt. 1 menyalin (a letter, document). 2 meniru. 3 mengerjakan hal yang sama. duplicating machine duplikator.
duplication	kb. 1 hal melipat-gandakan/memperbanyak. 2 salinan, turunan (of a letter, document).
duplicator	kb. duplikator, mesin stensil.
duplicity	kb. (j. -ties) sikap/perbuatan bermuka dua.
durability	kb. daya tahan.
durable	ks. dapat tahan lama.
duration	kb. lamanya. d. of an appointment masa jabatan, lamanya pengangkatan. for the d. of the war selama masa perang.
duress	duress
durian	kb. durian, duren.
during	kb. 1 selama. 2 pada waktu.
dusk	kb. petang, menjelang malam, waktu samar-samar.
dusky	ks. kehitam-hitaman, agak hitam.
dust	kb. 1 debu (on a table, etc.). 2 abu. -kkt. 1 membersihkan (furniture) 2. menyapu, mengelap. 3 menaburi. -kki. menyapu. to d. off 1 menyapu debu. 2 mengemukakan. d. bowl daerah dimana sering terjadi angin debu yang dahsyat.
dustcloth	kb. (kain) lap.
duster	kb. 1 kain lap, penghapus. 2 semacam baju luar yang dipakai di rumah.
dustpan	kb. pengki, pungki.
dustproof	ks. tahan debu, kedap abu.
dusty	ks. berdebu. d. road jalan yang berdebu.
dutch	kb. bahasa belanda. the d. orang-orang belanda. -ks. belanda. inf.: d. treat makanan atau hiburan yang dibayar sendiri-sendiri.
dutchman	kb. (j. -men) orang belanda.
dutiable	ks. kena bea-cukai. d. goods barang-barang yang harus dikenakan beacukai.
dutiful	ks. patuh, menurut. d. doughter anak perempuan yang patuh.
duty	kb. (j. -ties) 1 kewajiban. to do o's d. menunaikan kewajiban. 2 tugas. what are my duties ? apa tugas saya ? 3 bea. import d. bea import/ masuk.duty-bound ks. merasa wajib/berkewajiban. duty-free ks. tanpa/bebas bea.
duumvirate	kb. dwitunggal.
dwarf	kb. orang kerdil/katai. -kkt. menyebabkan menjadi kecil.
dwell	kki. (dwelt atau dwelled) 1 tinggal. 2 menghuni, mendiami. -dwelling kb. tempat tinggal/kediaman.
dweller	kb. penduduk, penghuni.
dwelt	lih dwell.
dwindle	kki. berkurang, menjadi kecil. the water supply dwindled persediaan air berkurang.
dyak	kb. 1 orang dayak. 2 bahasa dayak.
dye	kb. celup (an), bahan celup. -kkt. mencelup. to d. a dress green mencelup gaun menjadi hijau. -kki. dicelup. -dyed-in-wool ks. sejati tulen. -dyeing kb. (pen) celupan.
dyer	kb. tukang celup.
dying	lih die.
dyke	= dike.
dynamic	ks. dinamis, dinamik, bersemangat. d. personality kepribadian yang dinamis.
dynamics	kb. 1 ilmu dinamika. 2 tenaga gerak. the d. of a hurricane tenaga gerak topan.
dynamism	kb. dinamisme, tenaga yang dinamis.
dynamite	kb. 1 dinamit, bahan atau alat peledak. 2 inf.: hal yang menggemparkan. -kkt. mendinamit, meledakkan dengan dinamit. -dynamiting kb. dinamo, pesawat pembangkit listrik.
dynastic	ks. yang berhubungan dengan dinasti atau wangsa. d. rule pemerintahan wangsa/dinasti.
dynasty	kb. (j. -ties) dinasti, wangsa, keluarga/keturunan raja. literary d. keluarga sastera.
dysentery	kb. disentri, berak darah, sakit buset.
dysfunction	kb. gangguan/penyelewengan fungsi. kidney d. gangguan fungsi ginjal.
dyspepsia	kb. pencernaan yang terganggu
dyspeptic	ks. muram, suram.
dystrophy	kb. penyakit otot.
e, e	kb. 1 huruf kelima abjad inggris. 2 mus.: nada e.
e.g.	[exempli gratia] misalnya, umpamanya.
each	ks. (tiap-) tiap, setiap. -kg. masing-masing. e. one tiap orang, masing-masing. e. and everyone tiap orang. e. other 1 saling. 2 satu sama lain.
eager	ks. ingin sekali, hasrat. to be e. to go ingin sekali pergi. inf.: e beaver orang yang rajin sekali. -eagerly kk. dengan tak sabar, dengan keinginan yang amat besar.
eagerness	kb. hasrat, keinginan. e. to learn hasrat belajar.
eagle	kb. 1 burung rajawali/elang, garuda. 2 golf : jumlah pukulan kurang dua dari par. -eagles j. tanda pangkat kolonel tentara as. eagle-eyed ks. bermata/berpenglihatan tajam.
ear	kb. 1 telinga, kuping. inf.: to be all ears mendengarkan dengan penuh perhatian, diam menelinga. 2 menyelenggarakan sesuatu tanpa persiapan atau petunjuk yang cukup. e. specialist ahli penyakit telinga.
earache	kb. sakit telinga. i have on e. saya sakit telinga
eardrum	kb. gendang pendengar.
earful	kb. lebih dari cukup. 2 teguran, celaan. he got an e. ia mendapat celaan.
earl	kb. gelar kebangsawanan yang tinggi, pangeran.
early	ks. (earlier, earliest) 1 lekas. 2 muda. 3 pagi-pagi. -kk. pagi-pagi. e. on dari/sejak permulaan. early-warning radar radar pemberi peringatan pertama.
earmark	kb. ciri-ciri. the e. of a politician ciri-ciri seorang ahli polotik. -kkt. memperuntukkan. to e. funds for books memperuntukkan dana untuk buku-buku.
earmuff	kb. alat penutup telinga.
earn	kkt. 1 mendapat bayaran/gaji. to e. a living mendapat penghasilan. 2 memperoleh. -earnings kb., j. pendapatan, upah, penghasilan. earning power daya pendapatan.
earnest	kb. in e. bersungguh-sungguh. -ks. sungguh-sungguh, tekun. e. money uang panjar/muka. -kk. dengan sungguh-sungguh, dengan betul-betul.
earphone	kb. alat pendengar.
earplug	kb. penyumbat telinga.
earring	kb. anting-anting, subang.
earshot	kb. jarak pendengaran. out of e. diluar pendengaran. within e. dalam jarak pendengaran.
earsplitting	ks. yang memekakkan telinga.
earth	kb. 1 tanah. 2 dunia, bumi. 3 bumi. earth-circling ks. yang mengitari bumi. e. mover buldozer. earth-shaking ks. yang menggemparkan/menggegerkan.
earthbound	ks. terikat/terbatas pada bumi. man is no longer e. manusia tak lagi terikat pada bumi.
earthen	ks. terbuat dari tanah. e. bowl mangkuk dari tanah.
earthenware	kb. barang tembikar, barang (dari) tanah.
earthly	ks. keduniawian. e. goods benda keduniawian. that's of no e. use itu tak ada gunanya samasekali.
earthquake	kb. gempa bumi, lindu.
earthward(s)	kk. menuju kebumi.
earthworm	kb. cacing tanah.
earthy	ks. 1 yang berbau tanah. an e. odor bau tanah. 2 biasa, sederhana, bersahaja. an e. person seorang yang biasa/sederhana.
earwax	kb. tahi telinga/kuping.
ease	kb. kesenangan, ketentraman. -kkt. 1 mengurangi. 2 meredakan (the situation). 3 menurunkan/mendorong/mengerakkan pelan-pelan. 4 meringankan. -kki. 1 berkurang. 2 menyelinap. -easing kb. peringanan.
easel	kb. kuda-kuda.
easily	lih easy.
east	kb. timur. -ks. timur. e. wind angin timur. e. coast negara-negara bagian as di pantai timur. e. indian yang berhubungan dengan hindia timur.
easter	kb. paskah. e. sunday hari minggu. paskah. e. island pulau paskah.
