semenda	related by marriage.
semendal	(geog.) mica.
semenggah	proper, seemly.
semenjak	(lit.0 since.
semenjana	mediocre.
sementang	just because.
sementara	1. 1) while. 2) provisional, temporary, interim. 2. certain unnamed party.
semer	see semir.
semerap	absorbent, absorptive.
semerbak	1 fragrant. 2 pervade (fragrance).
semesta	whole, entire, total.
semestaan	universalism.
semestinya	should have been.
semi	young shoot.
semi-final	1 (sport) semi-finals. 2 semifinal.
semi-finals	semifinalist.
semiang	1 a bit. 2 a grain, a drop of s.t.
semilih	alternating.
semilir	breezy (of wind).
seminar	see sinar. /se`minar/ seminar.
seminari	(rel.) seminary.
seminaris	(rel.) seminarian.
semingkin	all the more.
semiotika	semiotics.
semir	polish.
semisal	be like.
semoga	may it happen, i hope that.
semokel	smuggling.
semokelar	(coll.) smuggler.
sempadan	1 border, demarcation. 2 (sport) finishing line.
sempak	1. chipped. 2. see swempak.
sempal	(java) broken, chipped.
sempalan	fragment.
sempana	see sempena.
sempat	1 have sufficient time, opportunity. 2 still be able to do s.t.
sempe	k.o. waffle, wafel. /se`mpe`/ (ambon) k.o. earthenware bowl.
sempelah	1 rubbish, dregs. 2 useless, of no value.
sempena	blessing.
sempena-hati	conscience.
semper	paralyzed.
semperit	see semprit 1.
semperong	see semprong.
semperot	see semprot 1.
sempit	1 narrow, tight. 2 pressed, limited.
sempoa	(china) abacus.
sempor	see cempor.
sempoyongan	totter, stagger from drunkenness.
semprit	1. a whistle. 2. s- shaped cookie made of sago or tapioca flour.
sempritan	whistle (sound).
semprong	1 lamp chimney. 2 chimney, smokestack, ship's funnel. 3 tube, telescope.
semprot	1. syringe, squirt gun. 2. s-shaped cookie made of sago or tapioca flour.
semprotan	1 syringe, squirt gun. 2 scolding.
semprul	(java) mild swear word : you jerk !.
sempurat	see semburat.
sempurna	1 perfect. 2 complete.
semrawut	chaotic, disorganized.
semsem	see sengsem.
semu	1 appearance, mien. 2 apparent, pseudo-, quasi-. 3 deceit, trick.
semua	all. semua-nya all (of them), everything.
semudera	see samudera
semuhun-dawuhisme	see sumuhun-dawuhisme.
semuka	1 having the same appearance. 2 having the same front, fronting in the same direction.
semula	1 from the beginning. 2 since. 3 formerly, originally. 4 at first.
semur	dish of meat and sometimes bean curd, tempeh, etc. stewed with spices.
semusim	semusim
semut	ant. semut-rangrang/keranggang k.o. red ant.
sen	1. cent. 2 (auto.) mechanical turning signal.
sen-an	1 o.-cent piece. 2 in cents.
sena	k.o. timber tree, narra.
senada	senada
senak	1 tight, oppressed. 2 having a stuffed feeling (from overeating).
senam	1. (sport) gymnastics, calisthenics. 2. indigo blue.
senam-jantung	panic, pounding of the heart.
senamaki	senna, a purgative.
senandung	a hum.
senang	1 happy, contented. 2 like. 3 comfortable.
senang-senang	gladly.
senantiasa	always.
senapan	/senapang/ rifle, gun. senapan-angin air rifle. senapan-buluh bamboo toy gun.
senapati	(java) commander in chief.
senar	string (of musical instrument, racquet, for fishing, etc.).
senat	1 (acad.) faculty senate. 2 (pol.) senate.
senawi	boat passenger who is working his way.
senda	see sandal.
senda-gurau	senda-gurau
sendang	(java) spring, source.
sendat	stagnant, not flowing freely (water or, figuratively, s.t. else).
sendawa	1. saltpeter, gunpowder. 2. a burp.
sendel	lean on.
sendeng	1 slanting, leaning. 2 mentally off.
sender	(coll.) transmitting station. /se`nde`r/ see sandar.
sendera	see sandera.
sendi	1 hinge, joint. 2 socket. 3 pivotal strenght, principle.
sendiri	1 self (the intensifier). 2 own. 3 on o.'s own. 4 (java) most.
sendiri-sendiri	individual, apart.
sendirian	alone.
sendok	1 spoon. 2 ladle. 3 spoonlike tool (e.g. trowel, etc.).
sendorong	slide forward.
sendratari	[seni, drama, dan tari] (thea.) dance-drama, ballet.
sendu	sad.
senduduk	k.o. flowering shrub, melastoma.
senduk	see sendok.
senel	see sepur.
senen	monday. senen-kemis precarious (that is, in a situation where o. should intensify religious duties, e.g. fast on mondays and thursdays).
senentiasa	see senantiasa.
senewen	nervous, have a nervous fit.
seng	1 zinc. 2 iron sheeting. 3 roofing.
sengaja	intentional, deliberate, expressly.
sengak	1) pungent, piercing in smell (like vinegar, etc.) 2) obnoxious.
sengal	painful joints.
sengal-sengal	out of breath, having difficulty breathing.
sengam	eat up, devour gluttonously.
sengap	quiet, silent.
sengat	the sting (organ) of certain insects.
sengatan	pain or wound resulting from a sting.
sengau	talk through the nose, nasal.
senget	1 slanted. 2 placed on o. side.
senggak	1. snarl. 2. (java) applaud, cheer (in dancing and singing).
senggama	coitus.
sengganen	k.o. flowering shrub, melastoma.
senggang	be free, unoccupied (of time).
senggara	see selenggara.
senggeruk	(tobacco) snuff.
senggol	pasar-senggol market packed so that people brush against e.o.
senggolan	a shove, push, nudge.
senggugut	irregular menstrual periods.
senggulung	millipede.
senggut	see sesenggukan.
sengih	1 open o.'s mouth a little. 2 smile, grin.
sengir	1. turpentinelike, having the sharp acrid taste of an orange peel. 2. see cengir.
sengit	1 k.o. stinging insect. 2 sharp (odor, words, etc.). 3 violent. 4 poignant, bitter (emotions). see senget.
sengkala	see sangkakala.
sengkalan	(java) chronogram.
sengkang	1 crossbar. 2 spoke of wheel. 3 (math.) diameter of a circle. 4 dash, hyphen. /se`ngkang/ with legs far apart.
sengkar	(lit.) removable plank deck on a sail boat.
sengkarut	chaos.
sengkeh	see singkeh.
sengkelang	/sengkeling/ crossing (of arms or legs).
sengkelit	1. a loop worn around o.'s legs for shimmying up tree trunks. 2. (java) the wearing of a kris stuck in a belt at the back of o.'s waist.
sengkenit	k.o. jungle tick.
sengketa	1 (leg.) lawsuit, legal action. 2 quarrel, dispute.
sengkilit	(jakarta) 1 trip up by tying or grabbing a leg. 2 cheat s.o.
sengkong	see singkong.
sengkuang	1 plant with a white edible tuber (pachyrrhizus sp.). 2 k.o. tree.
sengkuap	(lit.) shed, awning.
sengsai	wretched.
sengsara	1 misery, suffering. 2 suffer, be miserable.
sengse	see sinse.
sengsem	(java) 1 highly attracted to s.t. 2 absorbed, engrossed in managing the hotel.
sengut	frown.
seni	1. 1) refined, fine. 2) art. seni-pahat/patung sculpture. seni-taman landscaping. 2. see air. 3. see zeni 1,2.
seniah	artistic.
seniman	artist.
senin	see senen.
senior	1 senior, o. who has more authority, o. with more experience, etc. 2 sr. (after a name). 3 (coll.) male university seniors. 4 (coll.) hazing of incoming freshmen.
senioren	(coll.) hazing of incoming freshmen.
seniorita	(coll.) female university seniors.
senirupa	plastic arts, fine arts.
senirupawan	artist.
seniwati	female artist.
senja	twilight, dusk.
senjak	see sejak 1.
senjang	1. 1) asymmetrical, imbalanced. 2) differing, unlike. 2. see senja.
senjata	1.1) weapon. 2) rifle, gun. senjata-makan tuan 1) s.t. that back-fires, turns against o. 2) evil done to others comes back to the perpetrator. 2. (lit.) a vowel sign in arabic script.
senjolong	see ikan.
senonoh	proper, polite.
senopati	see senapati.
sensasi	sensation, sensational news.
sensasional	/sensasionil/ sensational.
sense	see sinse.
sensitif	sensitive.
sensitivitas	sensitivity.
sensor	/sensur/ censor.
sensus	census.
senta	wooden beam attached lengthwise to the ribs of a boat to support the dect.
sentadu	see belalang 1.
sentak	1. (java) snap at s.o., verbally abuse s.o., tongue-lash. 2. pull, pull out.
sentakan	a jerk, jolt.
sental	see sintal.
sentana	1. (lit.) possible. 2. (java) relative by birth or adoption. 3 (java) cemetery. 4 see sentana 1.
sentap	see sentak 1.
sentara	see sementara 1.
sentausa	see sentosa.
senteng	1. in short supply, fall short, insufficient. 2. see sinting.
senter	1. flaslight, spotlight. 2. (sport) center.
senterhaf	(sport) center half-back.
senteri	see santri.
senterpor	(sport) center forward.
senti	centimeter.
sentiasa	see senantiasa.
sentilan	scolding, criticism.
sentimen	1 grudge, have ill feeling, bias. 2 have or hold a grudge, have ill feelings.
sentimental	sentimental.
sentimentalitas	/sentimentalitet/ sentimentality.
sentimentil	see sentimental.
sentimeter	centimeter.
senting	1. k.o. shrub used for fences or fertilizer. 2. (m) difficult.
sentiong	(jakarta) china graveyard.
sentolop	flashlight.
sentong	(java) small inner room of a house (traditionally used for family ceremonies or as a storage room).
sentosa	1 quiet, tranquil. 2 safe.
sentral	1 central. 2 center.
sentralisasi	centralization.
sentralisme	centralism.
sentralistis	centralistic.
sentrap-sentrup	(java) nasal, esp. of s.o. speaking while weeping or suffering from a cold.
sentrifugal	centrifugal.
sentrifuse	centrifuge.
sentris	centrally (located).
sentrum	1 center. 2 (geol.) centrum.
sentuh	touch.
sentuhan	touch, contact.
sentul	k.o. tall, tree bearing yellow fruit similar to the mangosteen but sour.
sentung-pelalai	a charm which prevents a woman from obtaining a husband.
senuh	full feeling from overeating.
senut-senut	feeling of gnawing pain.
senyak	see nyenyak.
senyampang	1 supposing that, if. 2 (lit.) although.
senyap	1. 1) very quiet, deserted. 2) silent, quiet. 3) sound asleep. 2. see lenyap.
senyar	funny bone, numb sensation from bumping the ulnar nerve in o.'s elbow.
senyawa	1 of o. soul, completely agreed. 2 (chem.) compound.
senyawaan	union, complete mixture.
senyum	smile. senyuman-hambar 1 expressionless smile. 2 forced smile. senyum-kecut a grim smile.
senyuman	a smile.
senyur	1. see sinyo. 2. see insinyur.
seok-seok	/seot-seot/ sound of s.t. dragged.
seorang	1 somebody, someone. 2 alone. 3 one (of persons).
sep	1. (coll.) o. in charge (of an office, railway station, etc.). 2. see sip.
sep-	see also entries with sp-.
sepa	(java, jakarta) flat, uninteresting, with no spices.
sepada	(coll.) anybody in ? (said when entering shop or home).
sepadan	1. 1) suit, match. 2) match, correspond with. 2. having a common border.
sepah	a chew of s.t., remain of s.t. already chewed or sucked on.
sepaham	like-minded.
sepak	a kick. sepak-bola soccer.
sepakan	1 kicking. 2 kick.
sepakat	1 agreed. 2 unanimously, in harmony.
sepakbor	see spatbor.
sepala-pala	if so and so has already gotten started, been done to a certain extent (o. might as well go ahead and finish it, do it the whole way).
sepalek	see spalek.
sepan	tightly, tight.
sepancaran	homologous.
sepandri	private first class (in the colonial army).
sepanduk	see spanduk.
sepang	k.o. tree the wood of which produces a red dye.
sepanjang	see panjang.
sepantar	/sepantaran/ being of the same age as.
sepantun	a little o., a little bit.
sepanyol	spain, spanish.
separasi	separation.
separatis	separatist.
separatisme	separatism.
separuh	/separoh, separo/ see paro.
sepasan	see sepesan.
sepasar	a week.
sepasi	see spasi.
sepat	1. astringent to the taste. 2. k.o. fresh water fish found in flooded rice fields.
sepatah-kata	1 one word. 2 a few words.
sepatbor	see spatbor.
sepatu	shoe, footwear.
sepeda	bicycle. sepeda-balap racing bicycle. sepeda-jengki k.o. old-fashioned bicycle with a v-shaped bar connecting the seat and rear wheel with the handle-bars and front wheel. sepeda-kumbang/motor motorcycle. sepeda-tandem tandem bicycle.
sepekan	one week.
sepekerjaan	colleague.
sepel	(coll.) spell.
sepelan	spelling.
sepele	unimportant and trivial.
sepeling	see speling.
sepelontaran	a stone's throw away.
sepemakaian	complete set of clothes.
sepemeluk	of such circumference that it can just be embraced by a man's arms.
sepen	1 storage cupboard. 2 series of rooms in back used for storage, servants quarters, etc.
sepenanakan	the time needed to boil rice, about 20 minutes.
sepenggalah	see galah 1.
sepeninggal	1 upon or after the departure of. 2 after o.'s death.
seperah	see sufrah
seperai	/seperei/ see seprai.
sepercik	a splatter of.
seperjuangan	sharing in the same struggle.
sepersekian	such-and-such a percent.
seperti	like, as.
sepertiga	a third
sepertinya	1 as it should be, fittingly. 2 it seems that, it is as if.
sepesan	centipede.
sepesial	see spesial.
sepesusuan	of those who have suckled at the same breast.
sepet	see sepat 1.
sepetak	a piece of land.
sepi	1 quiet, still. 2 desolate, .onely. 3 slack (business market).
sepidol	see spidol.
sepih	see serpih.
sepihak	unilateral.
sepintar	as smart as.
sepintas	a second (of time).
sepion	see spion.
sepir	see sipir, spir.
sepit	1 pincer (of lobster, crab, etc.). 2 tongs, tweezers.
sepitan	tongs, pincers, etc.
sepoa	see sempoa.
sepoi	(lit.) sepoy, indian mercenary soldier of colonial period.
sepoi-sepoi	blow softly (of breeze).
sepon	see spon.
sepor	see sepur.
seporos	see poros.
seprai	/sepre, seprei/ 1 bedsheet. 2 coverlet.
seprit	see kue.
sept.	[september] september.
september	september.
sepuh	1. plating material. 2. 1) (java) old. 2) older person.
sepuhan	1. gilt. 2. (coll.) old.
sepulang	upon returning.
sepuluh	ten.
sepur	(r.r.) 1 rail, railroad. 2 train. 3 railway platform.
sepuran	(java) railway fare.
seput	(coll.) fast, quick.
seputar	1 around. 2 in the vicinity. 3 on the subject of.
ser-	see also entries with sr-.
serabi	/serabai/ k.o. rice flour pancake.
serabut	1 fiber. 2 fibrous, coarse.
serabutan	1 fibrous, coarse. 2 chaotic, mixed.
seragam	uniform, of one kind.
serah	(m) bright red.
serahi	k.o. long-necked flask.
serai	lemongrass, citronella.
serak	hoarse, husky (of voice).
serakah	greedy.
serakahisme	greedy mentality.
serakan	garbage scattered about.
serakit	serakit
seram	hair-raising.
serambi	1 front porch, veranda. 2 platform (in station).
serampang	1. trident. 2. (coll.) strike at random.
serampang-duabelas	k.o. traditional indonesian social dance.
serampangan	at random, any old way.
serampangisme	mentality marked by doing whatever o. likes to do without regard to societal norms.
seran	stripe.
seranah	(lit.) a curse.
serancak	a set.
serandang	trestle, sawhorse.
serandung	stumble.
serang	1. attack. 2. (naut.) boatswain's mate.
serangga	insect.
serangkai	connected, tied together.
serangkak	barbs used to prevent s.o. from climbing a (fruit) tree.
serangkap	a set of s.t.
serangkul	in o. embrace.
serangkum	an armful.
serani	1 (lit., ambon) christian. 2 (lit.) portuguese-speaking christians of pre-19th century jakarta.
seranta	(lit.) proclaim widely.
serap	reserve, spare.
serapah	curse.
serasah	1. manure, offal. 2. k.o. printed cotton fabric from india. 3 mountain rapids.
serasi	harmonious, matching, compatible.
serat	1.1) fibrous parts of fruit, etc. 2) fiber. 2. tight, jammed.
serata	1 everywhere. 2 flat, as even as.
seratus	100 (a hundred).
seraut	numerical classifier for faces and some surfaces (moon, etc.).
serawak	(chem.) antimony.
seraya	while.
serba	completely, very much so.
serban	turban.
serbaneka	all k.o., diverse.
serbat	1 sherbet. 2 k.o. ginger drink with spices. 3 (java) k.o. drink of shredded young coconut and syrup.
serbet	napkin.
serbuan	1 attacvk. 2 stampede, rush.
serbuk	1 dust. 2 (biol.) pollen. 3 powder.
serda	[sersan dua] (mil.) sergeant 2d class.
serdadu	1 soldier. 2 mercenary in foreign pay (during the colonial period).
serdak	fine dust.
serdawa	see sendawa 2.
serdih	protruding (of chest or belly).
sere	see serai.
seregang	see regang.
sereh	see serai.
serelak	k.o. lacquer.
serem	see seram.
serempak	see rempak.
serempeng	see srempeng.
serempetan	1 abrasion. 2 stumble over e.o.
sereng	(java) rocket (firecracker).
serenjang	(lit.) stand up straight.
serenta	(java) as soon as.
serentak	1. 1) all at once, suddenly. 2) together, in a body. 2. 1) jointly, together, at once. 2) all at once. 3) as soon as.
serep	see serap.
seret	1 dry (of throat) so that o. has difficulty swallowing. 2 (coll.) sluggish (of traffic, the movement of goods, business). /se`re`t/ 1. dragging, trailing behind. 2. the unadorned edge of a batik cloth.
sergah	say s.t. with a snarl.
sergahan	harsh words.
sergapan	attack, ambush.
seri	1. 1) honorific royal title. 2) shining splendor, gleam. 2. (sport) be a tie. 3 see sari. 4. see hilang. /se`ri/ series.
seriawan	(med.) sprue, oral ulceration.
seribu	see ribu.
serigala	jackal, wolf.
serigunting	k.o. bird with a forked tail.
serik	1. sore (of throat). 2. learn o.'s lesson, refuse to do s.t. because of a former bad experience.
serikat	1 united. 2 union, league, alliance.
serikaya	1. annona, the sweetsop fruit. 2 k.o. jam made of eggs, sugar, and coconut cream.
serimpet	/serimpat/ see serempet.
serindit	k.o. parakeet.
sering	1. often. 2. (m) slender. 3. firm and tight (of plaited or braided materials).
sering-sering	often, over and over.
seringai	1 a grin, grimace. 2 say with a grin or grimace.
seringnya	frequency.
seriosa	semiclassical and classical (of music).
serit	k.o. fine-toothed louse comb.
serius	1 serious, solemn. 2 wholehearted.
serkah	torn or broken off.
serkap	1. 1) cone-shaped fish trap that is thrust down on fish in shallow water. 2) cone-shaped bird cage. 2. see sergap.
serling	pitfall.
sero	1. (fin.) 1) a share (business). 2) have a share interest. 2. k.o. large stationary fish trap.
serobok	see sirobok.
serobotan	s.t. snatched.
serodok	see seruduk.
seroja	k.o. lotus.
serok	1. (lit.) bay, inlet. 2. (java) scoop, round spatula. 3. see sero 2.
serokan	drain, ditch.
serombong	1 hollow cylinder. 2 pipe, tube.
serondol	see sondol.
serondong	see sondong.
serong	1 askew, slanting. 2 unfaithful.
serong-menyerong	crisscross.
seronok	(lit., humorous) pleasant, agreeable.
serpih	1 splinter, flake, shard. serpih-kayu chips, wood shavings. 2 (geol.) shale.
serpihan	chip, piece, shard.
serpis	see servis 1,2.
sersan	(mil.) sergeant or naval petty officer, in address, esp. as san.
serse	see reserse.
sersi	1. see reserse. 2. serge.
serta	1 with, along with. 2 and, as well as. 3 as soon as.
sertarasa	see serta.
sertifikat	/sertipikat/ certificate.
sertu	1. (islam) ritual ablution after touching s.t. impure (e.g. pig, etc.). 2. [sersan satu] (mil.) first sergeant.
seru	1 utter a shout, yell s.t. 2 sharp, violent.
seru-alam	the universe.
serual	see seluar.
seruan	1 call, cry. 2 (ling.) exclamation. 3 appeal.
serudukan	attack, ramming.
serudung	k.o. monkey.
seruit	harpoon.
seruitan	a whistle.
seruling	k.o. flute.
serum	serum.
serumah	be under one roof.
serunai	1. a wind instrument with a reed. 2. k.o. flowering plant.
serundeng	/serunding/ relish of grated coconut and spices.
seruni	k.o. seashore flower.
serunting	k.o. vine.
serupa	1 similar, of o. kind, likewise. 2 be similar to s.t.
serut	(jakarta) k.o. carpentry tool, a plane.
serutan	shavings.
serutu	see cerutu.
servis	1. 1) service (in a hotel, etc.) 2) provide with repair or maintenance service. 2. set of crockery (for tea, desert, dinner, etc.0.
sesaat	a moment.
sesajen	/sesaji, sesajian/ (rel.) ritual offerings.
sesak	1 narrow, close. 2 crowded, tight.
sesal	regret, remorse, repentance.
sesama	fellow, peer.
sesanti	(java) slogan, motto.
sesap	(m) abandoned field.
sesapan	1 s.t. sucked, lapped up. 2 sucking.
sesar	1. (geol.) fault. 2. /se`sar/ (med.) cesarean.
sesat	1. lose o.'s way. 2 go astray, deviate.
sesawi	k.o. green vegetable.
sesdalopbang	see sekdalopbang.
sese	centimeter.
sesegera	as soon as.
sesekali	occasionally, now and then, once in a while.
sesembahan	(java, rel.) s.o. s.t worshiped.
sesempurna	as complete or perfect as.
sesenap	k.o. plant.
sesenggukan	in gasps, choking.
seseorang	1 anyone, someone or other. 2 a certain person.
sesepuh	(java) elders.
seser	k.o. fish net.
sesering	as often as.
seset	1. (java skinned, scraped. 2. dragonfly.
sesko	[sekolah staf komando] staff college of the armed forces.
seskogab	[sesko gabungan] joint staff college of the armed forces.
sespan	side-car (of motorcycle).
sesuai	1 appropriate. 2 agree with.
sesuatu	1 a certain, an unspecified. 2 a certain s.t.
sesudah	after.
sesuku	1 half a rupiah. 2 of the same ethnic groups.
sesumbar	boast, show off.
sesungguhnya	actually, in truth.
set	(tech.) set.
set-	see also entries with st-.
seta	(coll.) see hasta.
setabelan	(mil.) artillery.
setabil	see stabil.
setadion	see stadion.
setaf	see staf.
setagen	see stagen.
setahu	as far as o. knows.
setakar	of the same capacity.
setakat	up to (a point).
setakona	see astakona.
setala	see tala.
setalen	see talen.
setali	1. connected to e.o. 2. 25 cents, a quarter of a rupiah.
setamat	upon ending, as soon as it ended.
setambuk	see stambuk.
setambul	1. (jakarta) k.o. fez. 2. see stambul.
setan	1 (rel.) satan, devil. 2 s.o. evil.
setandar	see standar 1.
setanding	be equal to, be comparable to.
setang	see stang.
setangan	kerchief.
setangga	see tangga.
setanggi	incense, incense-stick.
setangkup	1 a cupped handful. 2 symmetrical.
setap	see staf.
setapak	1 a footstep. 2 o. palm's or sole's breadth.
setar	see star.
setara	1 be equal, equivalent. 2 made for e.o., suited.
setaraf	equal, equivalent, on a par.
setarter	see starter.
setasi	see stasi.
setasiun	/setasion/ 1 railway station, depot. 2 public transportation terminal.
setat	list, roll, statement.
setater	see starter.
setawar	k.o. medicinal plant.
seteger	1 (coll.) step-ladder. 2 scaffolding.
setek	cutting, slip of a plant.
seteker	see steker.
setel	1 set, suit (of clothes, cards, etc.). 2 match, be compatible. 3 (sl.) be stylish.
setelah	after.
setelan	1. set, suit of clothes. 2. radio dial, tuning knob, etc.
setelempap	as large as o.'s hand.
seteleng	exhibition.
seteling	see steling.
seteliti-telitinya	as careful as possible.
setem	1. vote. 2. tune, in tune.
seteman	voting.
setempat	1. local. 2 of the same place.
setempel	official stamp seal.
seten	(java) assistant to a district head.
setengah	1 half. setengah-jalan halfway. setengah-masak half-done. 2 some.
seter	see ster.
seterap	see setrap.
seterek	see sterek.
seterek-eser	(coll.) clothes iron.
setereng	see streng.
setereotip	see stereotip.
seteria	see kesatria.
seterik	see setrik 1.
seterika	iron, flatiron.
seterikaan	1 iron. 2 clothes for ironing.
seterimin	see strimin.
seterip	see setrip 1.
seterom	see setrum.
seteru	see setru.
seterum	see setrum.
seterup	see setrop.
setia	loyal, faithful. setia-kawan 1 solidarity. 2 be in solidarity with.
setiakawan	1 a loyal person. 2 faithful.
setiap	each and every.
setiar	(coll.) see ikhtiar.
setiba	upon arrival.
setidak-tidaknya	1 at the least. 2 in any case. 3 ignore. 4 abolish, cancel.
setik	stitch.
setikan	game of marbles.
setil	see stil.
setimbal	1 in balance, proportionate. 2 equitable, just.
setimbang	1 in balance. 2 in proportion.
setimpal	/setimbal/ 1 in balance, proportionate. 2 equitable, just.
setindak	one step. setindak-demi-setindak step by step.
setinggi-tinggi	no matter how high. setinggi-tingginya the highest possible.
setinggil	(java) audience hall.
setingkat	setingkat
setip	1. k.o. convulsive child disease. 2. eraser.
setir	steering wheel (of a motor-vehicle).
setiren	(coll.) drive a car.
setiwal	/setiwel/ leggings, puttee.
setolok	on the same footing.
setolop	see sentolop.
setonggok	a heap of.
setop	1. stop. 2. see setup.
setopan	stop (bus, streetcar).
setopeles	/setoples/ see stoples.
setor	deposited.
setoran	1 deposit. 2 rental fee (for taxi drivers, etc., who rent their vehicles). 3 stored commodity.
setori	1 (jakarta, coll.) quarrel, bicker. 2 (ambon) talk.
setoter	(coll.) stutter.
setrap	(coll.) punishment.
setrapan	1 punishment. 2 prisoner.
setrat	see strat.
setrek	see seterek-eser.
setrep	see setrip 1.
setrik	1. hair ribbon. 2. (coll.) strict.
setrika	see seterika.
setrip	1. 1) line. 2) decorative stripe. 3) stripe (insignia of rank). 4) slash (as a mark of punctuation). 5) (sport) straight (in golf). 2. (coll.) crazy.
setrop	fruit syrup for drinks.
setru	enemy, foe.
setrum	(elec.) electric current.
setu	(java) see restu.
setua	of the same age, as old as.
setubuh	1 (lit.) in harmony. 2 copulation.
setuden	see studen.
setuju	1 agree. 2 (coll.) like.
setujuan	1 of o. purpose. 2 having the same direction.
setulus-tulusnya	as sincerely as possible.
setum	steam.
setung	see restung.
setunggal	of o. k.o. quality.
setuntas-tuntasnya	as thoroughly as possible.
setup	k.o. fruit-stew.
seturi	see setori.
setyakawan	see setia.
seukur	in agreement.
seumbi	of one plant.
seumpama	1 like, equal. 2 supposing.
seumpamanya	for example, supposing.
seumur	of the same age. se-umur-an the same age.
seuntung-untungnya.	as profitable as possible.
seusai	after.
seusia	of the age of.
sewa	1 rent, hire. 2 rented.
sewah	see sewar.
sewajarnya	fittingly, properly.
sewaka	1. (lit.) tribute, homage. 2. see suaka 1.
sewaktu	when, at the time that.
sewaktu-waktu	1 from time to time. 2 at any time.
sewar	k.o. curved dagger.
sewenang-wenangnya	arbitraily, without compunction.
sewot	(java, jakarta) furious.
seyakin-yakinnya	absolutely convinced, as conviced as can be.
seyogyanya	properly, obviously.
seyot	see seok-seok.
sezarah	a bit.
sga	[sekolah guru atas] senior normal school.
sgb	[sekolah guru bawah] junior normal school.
sgkp	[sekolah guru kepandaian putri] school for training home economics teachers.
sh	[sarjana hukum] (acad.) master of law.
shalat	see solat.
shampo	see syampo.
she	/se/ see se.
shio	/sio, syo/ (china, zod.) any of the 12 astrological signs.
shodanco	/syodanco/ (japanese) section commander.
sholat	/solat/ see solat.
si	1.1) definite article used before the names of those with whom the speaker and interlocutor is intimate. 2) definite article used before a noun referring to a particular person in a category.
sia-sia	1 in vain, useless, without result. 2 meaningless.
siaga	1. ready, alert, prepared. 2. boy or girl scout (9-13 years old).
siah	siah-layah move from side to sidem oscillate.
siak	1. (islam) mosque caretaker. 2. see siah.
sial	1. be unlucky, unfortunate. 2 bad luck.
sialan	1 s.o. unfortunate, s.t. ill-fated. 2 s.o. or s.t. bringing bad luck. 3 damn it, exclamation of dissatisfaction.
sialang	1 beehive. 2 k.o. tree in which bees commonly build their nest.
sialat	see ciaklat.
siamang	1. gibbon. 2. (chem.) wolfram, tungsten.
siang	1. 1) day, daylight period. 2) period from about 11 a.m. to three p.m. 2. 1) weeded (of garden). 2) cleaned (of fish).
siangan	later in day (said before noon), earlier in afternoon (said at noon or later).
sianu	see si 1.
siap	1 ready, prepared. 2 finished, done. 3 (mil.) attention.
siap-siap	get ready.
siapa	who. siapa-saja 1 who all, name everyone who. 2 anyone at all.
siapa-siapa	whoever, just anyone.
siapuh	interjection expressing disappointment.
siar-siur	rustling sound.
siarah	1. see ziarah. 2. see bintang.
siaran	1 broadcast. 2 announcement 3 publication, issue. 4 circulation, spread.
siasat	1. 1) investigation. 2) tactics, strategy. 3) policy for achieving s.t. 2. (lit.) punishment.
sibak	part (in hair), a division.
siban	see si 2.
sibango	/siban-go/ see si 2.
sibar	1. 1) piece of cloth sewn as border. 2) porch or annex to house. 2 see sebar 2.
sibernetik	/sibernetika/ cybernetics.
sibir	(m) a small slice.
sibuk	busy.
sibur	ladle, scoop.
sibur-sibur	dragonfly.
sic	[surat ijin cetak] gvt. printing permit.
sicap	see si 2.
sice	complete set of living room fuirniture consisting of table and four chairs or table, settee, and some chairs.
siceng	see si 2.
sicerek	k.o. small shrub.
sidak	[inspeksi mendadak] surprise inspection (of gv.t. offices).
sidang	1 session, meeting. sidang-paripurna /pleno plenary session. sidang-gereja synod. 2 council, group. sidang-pembaca 1 the reading public. 2 the reader of a certain magazine, etc.
siddik	see fajar.
sidi	1 confirmation (protestant). 2 o. who has been confirmed.
sidik	1. investigation, examination. sidik-jari 1) finger print. 2) the study of finger prints. 2. see fajar.
sidomukti	(java) k.o. batik design of dark symmetrical patterns.
siduk	see cedok.
sifat	1 characteristic. 2 identifying feature. 3 nature, disposition. 4 (rel.) attribute (of god).
sifon	siphon.
sigai	(lit.) 1 pegs inserted in pole for climbing. 2 small ladder, peg ladder.
sigak	shoo ! exclamation used to drive away dogs.
sigap	efficient, always ready.
sigar	(java) a slice (of fruit that is split open).
sigi	1. torch. 2. pull out, pry out.
sigung	1. k.o. polecat. 2. see singgung.
sih	(coll.) 1 particle used to soften questions. 2 particle used to mark a topic. 3 you know ! particle to emphasize a reason given.
sihir	black magic, witchcraft.
sihiran	sorcery.
sihung	see siung 2.
siip	see sip.
siji	(jv) one.
sijil	certificate.
sijundai	magic charm that drives o. mad.
sik,siq	sikh.
sikap	1 attitude, demeanor. 2 posture.
sikat	1 brush. 2 (in some regions) comb. 3 rake out, harrow s.t. 4 (coll.) take away. 5 (coll.) wipe out, clean out. 6 (sport) defeat completely.
sikatan	stolen goods.
sikeras	see keras.
sikit	(coll.) see sedikit.
siklamat	cyclamate.
siklis	cyclical.
siklon	cyclone.
siklopedia	see ensiklopedi.
siklotron	cyclotron.
siklus	(tech.) cycle.
sikon	/si-kon/ [situasi dan kondisi] situation and conditions, circumstances.
sikongkol	see kongkol.
siksa	torture.
siksaan	torture, mistreatment.
siku	1 elbow. 2 (math.) right angle. 3 s.t. at right angles (carpenter's or draftman's square; curve in road, etc.).
siku-siku	1 (math.) having a 90-degree angle. 2 a piece of wood or s.t. else added to an irregular piece to square it off.
sikudidi	see kedidi.
sikut	(java) elbow.
sila	1. 1) cross-legged. 2) such a sitting posture. 2. moral principle, esp. of the pancasila.
silabus	syllabus.
silaf	see silap 1.
silah	1. see silap 1. 2 see mempersilakan.
silam	1. 1) set (of the sun). 2) ago, of the past. 2. see selam 1.
silancar	see lancar.
silang	crosswise, intersecting.
silap	1. wrong, false, mistaken. 2. see sulap 1.
silat	traditional self-defence arts.
silaturahim	/silaturahmi/ friendship, good relationship.
silau	dazzled, temporarily blinded by the glare.
silet	razor blade.
silhuet	silhouette.
silih-berganti	alternately, in turns.
silikat	silicate.
silikon	silicon.
silinder	cylinder.
silinderkop	(auto.) cylinder head.
silir	1. soft breeze. 2. (biol.) membrane.
siliran	the blowing (of a breeze).
siliwer	see seliwer.
silo	see sila 1.
silsilah	genealogy, family tree.
silu	1 twinge felt on hearing a grating sound (e.g. chalk drawn across a blackboard). 2 timid, modest.
siluman	1 a human who has taken the appearance of an animal for nefarious purposes. 2 invisible.
silungkang	k.o. woven cloth made in silungkang, west sumatra.
sim	[surat izin mengemudi] driver's license.
simaharajalela	see maharajalela.
simak-an	1. s.t. scrutinized. 2. gathering.
simalu	k.o. weed, sensitive plant (mimosa pudica).
simbang	k.o. children's game.
simbar	k.o. plant.
simbok	(java) see mbok 2.
simbol	symbol.
simbolik	/simbolis/ symbolic.
simbolisasi	symbolization.
simbul	see simbol.
simetris	symmetrical.
simfony	symphony.
simpai	1. fastening which encircles. 2. k.o. monkey.
simpanan	1 savings, goods laid away. 2 storage place. 3 mistress.
simpang	branch (of road, etc.), deviation.
simpangan	1 branching off. 2 byway, side route. 3 crossroads. 4 (math.) deviation.
simpanse	chimpanzee.
simpati	sympathy.
simpatik	congenial, likeable.
simpatisan	sympathizer (of a party, cause, etc.).
simpel	(coll.) simple, modest, small in amount.
simping	k.o. mollusc with a flat shell.
simplifikasi	simplification.
simpoa	see sempoa.
simponi	see simfoni.
simposium	/simposion/ symposium.
simpul	1. knot, node. 2. see senyum.
simpulan	1 knot, node. 2 act of buttoning.
simsalabim	/sim-sala-bim/ magical formula, abracadabra.
simultan	simultaneous.
sinaga	k.o. scute viral disease affecting the skin, shingles.
sinagoga	synagogue.
sinambung	continuous.
sinar	1 ray, beam. 2 gleam.
sinau	sparkle, shine.
sincia	(china) lunar new year.
sincunkionghi	(china) happy lunar new year.
sindap	dandruff.
sinden	see pesinden.
sinder	see opsinder.
sindikat	syndicate.
sindir	s.t. said by allusion in order to tease.
sindiran	1 teasing allusion. 2 satire.
sindroma	syndrome.
sinduk	see sendok.
sineas	film-maker.
sinematek	film library.
sinematografi	cinematography.
sinematografis	cinematographic.
siner	see opsinder.
sinerap	(tech.) absorbate.
sing	sound of buzzing.
singa	1 lion. singa-laut walrus. 2 (zod.) leo.
singapura	singapore.
singelar	(sport) single player.
singga	see sehingga.
singgah	stop by, stop in.
singgang	k.o. culinary method for cooking meats in coconut milk.
singgasana	throne.
singgatan	partition.
singgul	see senggol.
singit	1. (java) sacred, no trespassing. 2. see senget.
singkapan	1 s.t. folded back or drawn. 2 exposure.
singkat	1 brief, concise. 2 short in length. 3 short in time.
singkatan	1 abbreviation. 2 abstract, resume.
singkeh	/singkek/ (derog.) a china (immigrant) that is still very china in his ways.
singkong	cassava.
singkron	see sinkron.
singkup	shovel.
singlet	sleeveles undershirt.
singsat	tight.
singse	see sinse.
singset	see singsat.
singshe	see sinse.
sini	1 here. 2 there, where the recipient is (in letters only). 3 (coll.) i, we.
sinis	1 sarcastic, scornful. 2 cynical.
sinisme	1 sarcasm, scorn. 2 cynicism.
sinkretisme	syncretism.
sinkron	synchronous.
sinkronisasi	synchronization.
sinode	(rel.) synod.
sinom	ypung tamarind leaves.
sinonim	synonym.
sinopsis	synopsis.
sinoptik	synoptics.
sinse	/sinshe, sinsye/ china physician, purveyor of china herbal medicines. sinse-guamia/kuamia (china) fortune-teller. sinse-kuritan (china) kung fu master.
sintak	see sentak 2.
sintaksis	syntax.
sintal	well-fed, full, well rounded, having an attractive figure.
sintang	1 short. 2 weird, eccentric.
sinterklas	(coll.) santa claus.
sintese	synthesis.
sintetis	synthetic.
sinting	rather crazy.
sintir	1 dice. 2 dice game.
sintok	see sintuk 1,2.
sintuh	see sentuh.
sintuk	1. k.o. cinnamon tree the bark of which is used as a medicine. 2. (lit.) ber-sintuk rub o.s. with s.t.
sinu	nerve.
sinuhun	(java, sunda) term of address for a sovereign.
sinus	sine.
sinyal	1 signal. 2 railway crossing light.
sinyalemen	1 indication. 2 assumption, suspicion.
sinyo	1 (coll.) term of address and reference for european or westernized youth. 2 term of address used by servant to master's son.
sinyoklas	/sinyokolas/ (coll.) father christmas.
sio	1. (ambon alas !. 2. see shio.
siocia	(china) term of address and reference for unmarried woman.
siocu	k.o. distilled alcoholic beverage.
sioh	see shio.
siomai	(china) k.o. steamed ravioli filled with meat and open on the top.
sip	(coll.) 1 ok. 2 great, admirable.
sipai	see sepoi 1.
sipaku-gelang	(m) k.o. traditional bangle worn by brides.
sipat	1.mascara. 2. see sifat.
sipat-datar	device to ascertain whether s.t. is level.
sipat-kuping	(java) helter-skelter, frantically fast.
sipedas	(m) ginger.
sipek	see si 2.
sipenmaru	[seleksi penerimaan mahasiswa baru] entrance test to the state university system.
sipi	be just off the mark, a little off center, glancing (blow).
sipil	1 civil. 2 civilian.
sipilis	syphilis.
sipir	jailer.
sipit	1. slanting (of the eyes). 2. see sempit.
sipolan	see polan.
sipon	see sifon.
siponggang	echo.
sipulut	see pulut.
siput	snail.
sipva	[surat izin pembelian valuta asing] permit for purchase of foreign exchange.
sir	1. (lit.) mystical. 2. (coll.) 1) like s.t. or s.o., lust after. 2) fall in love with s.o. 3) aim, what o. is after. 3. sound of hissing.
sir-siran	fall in love.
sirafa	see jerapah.
sirah	see serah.
sirak	see serak.
siraman	1 a splash of water. 2 (java) ceremony of bathing a bride prior to the wedding.
sirap	1. slightly raised. 2. shingle. 3. see sirep.
sirat	mesh, network.
siratan	1 s.t. knotted or knitted. 2 implication.
siratulmustakim	(islam) path for believers on the last day.
sirene	siren.
sirep	1 (java) quiet, silent. 2 (java) fallen (of temperature). 3 magic formula to induce sleep.
siri	/siri`/ (sulawesi) suffer humiliation.
siria	see suriah.
sirih	1. k.o. plant, betel vine. 2 a quid us. consisting of betel leaf, areca nut, and lime (often with other ingredients, e.g. gambier, tobacco, etc.).
sirik	1. envious. 2. see syrik.
siring	1. k.o. shrimp net. 2. hem of cloth. 3. gutter, drain, ditch.
sirip	fish fin.
sirkam	k.o. small ornamental comb.
sirkaya	see serikaya 1.
sirkel	circle.
sirkit	/sirkuit/ circuit.
sirkol	sauerkraut
sirkulasi	circulation.
sirkuler	circular.
sirkus	circus.
sirlak	varnish.
sirna	disappeared.
sirop	see sirup.
sirsak	k.o. fruit, soursop.
sirup	fruit sirup concentrate for drinks.
sis	sound of hissing.
sisa	1 residue, remainder. 2 remnant.
sisal	sisal hemp.
sisi	side, flank.
sisihan	(java) spouse.
sisik	1 scales of fish, reptile, etc. 2 turtle shell, esp. as article of commerce.
sisipan	1 s.t. inserted. 2 s.t. implied. 3 (ling.) infix.
sisir	1. 1) comb. 2) harrow. 3) bunch (of bananas. 2. see susur 1.
siskamling	[sistem keamanan lingkungan] 1 neightborhood security system. 2 participate in this system.
sispan	see sespan.
sistem	system.
sistematik	1 systematic. 2 systematics.
sistematis	systematic.
sistematisasi	systematization.
sister	see suster.
sistim	see sistem.
sistol	(med.) systole.
sisurut	see surut.
siswa	1 student (at secondary school). 2 student (at academies, training institutes, but not at universities). 3 male student at such institutions.
siswi	female student at a secondary school or nonuniversity institutions of tertiary education.
sit	master sheet for mimeographing.
sita	seizure, confiscation.
sitaan	confiscated goods.
