popeyed	ks. terbeliak/berbelalak mata, tercengang.
popgun	kb. senapan mainan.
poplar	kb. semacam pohon.
poplin	kb. popelin.
poppy	kb. (j. -pies) apiun, bunga madat. p. seed benih pohon apiun.
poppycock	kb., kseru. inf.: omong kosong.
popsicle	kb. eskrim bertangkai, es loli.
populace	kb. rakyat, khalayak ramai, massa.
popular	ks. 1 populer, terkenal baik. 2 populer (songs). 3 murah (of prices). 4 bersifat umum/tidak ilmiah/populer. -popularly kk. terkenal (luas).
popularity	kb. kepopuleran, ketenaran.
popularization	kb. penyebaran dengan berpropaganda (agar digemari orang), popularisasi.
popularize	kkt. mempopulerkan.
populate	kkt. mendiami. that country is densely populated negeri itu penduduknya padat.
population	kb. jumlah penduduk. what's the p. of jakarta ? berapa penduduk jakarta ? p. explosion ledakan penduduk.
populous	ks. yang banyak/padat penduduknya. p. region daerah yang banyak penduduknya.
porcelain	kb. porselin.
porch	kb. serambi, beranda.
porcupine	kb. landak.
pore	kb. pori, lubang kulit. -kki. to over membaca dengan rajin.
pork	kb. daging babi. p. chop potongan daging babi.
pornography	kb. 1 kecabulan. 2 porno, gambar/bacaan cabul.
porosity	kb. (j. -ties) sifat menyerap/merembes.
porous	ks. menyerap, berliang renik, keropos
porpoise	kb. ikan lumba-lumba.
porridge	kb. bubur.
port	kb. 1 pelabuhan. river p. bandar/pelabuhan. 2 nav.: sisi kiri. 3 anggur port. -ks. kiri. on the p. side di sisi kiri.
port.	1[portugal] portugal. 2 [portuguese] portugis.
portable	kb. mesin yang mudah dibawa. -ks. dapat diangkut, mudah dibawa (typewriter, tape recorder, tv).
portage	kb. 1 (ongkos) pengangkutan. 2 pengangkutan perahu.
portal	kb. pintu gerbang. portal-to-portal ks. dari pintu ke pintu.
portend	kkt. menandakan, meramalkan.
portent	kb. tanda, isyarat.
porter	kb. 1 buruh (pengantar barang), kuli pengangkut barang. 2 penjaga pintu, portir.
porterhouse	kb. p. steak daging lembu diantara rusuk dan pinggang.
portfolio	kb. 1 tas surat, portepel. 2 jabatan (mentri). minister without p. menteri negara.
porthole	kb. tingkapan (di sisi kapal).
portico	kb. serambi yang bertiang-tiang.
portiere	kb. tirai pintu.
portion	kb. 1 porsi (of food). 2 bagian (of the profit, of the work). -kkt. to p. out membagi-bagikan.
portland	kb. p. cement semen biru (portland).
portly	ks. gemuk, degap.
portrait	kb. potret, gambar atau lukisan (orang).
portray	kkt. 1 melukiskan, menggambarkan. 2 memerankan, membawakan (the role, part).
portrayal	kb. 1 cara memerankan/membawakan (of hamlet). 2 pelukisan. 3 lukisan, gambar (of his mother).
portside	kb. sisi kiri, kiri kapal.
portuguese	kb. 1 bahasa portugis. 2 orang portugis. -ks. portugis.
pos.	[positive] positip.
pose	kb. 1 sikap (badan). 2 sikap, perlaga(k)-laga(k)an. -kkt. 1 mengajukan (a question). 2 merupakan. -kki. bersikap (badan), berpose.
posh	ks. inf.: indah, mewah.
position	kb. 1 kedudukan, posisi. 2 keadaan. 3 sikap (badan). 4 jabatan, pekerjaan. -kkt. menempatkan, mengatur posisi/tempat.
positive	kb. 1 (gambar) positip. 2 bentuk kata positip. -ks. 1 positip, tegas (of opinion, attitude). 2 pasti. 3 yang meyakinkan. --positively kk. 1 nyata-nyata. 2 sungguh-sungguh.
poss.	[possessive] yang menunjukkan kepunyaan.
posse	kb. sekelompok pembantu polisi, pagar betis.
possess	kkt. 1 memiliki (ability, a car). 2 mempunyai. -possessed ks. majenun, kesurupan, kemasukan setan.
possession	kb. 1 barang milik. 2 milik.
possessive	kb. gram.: kasus kepunyaan. -ks. orang yang suka menguasai miliknya. p. pronoun kata ganti empunya/kepunyaan/milik.
possessor	kb. pemilik, penguasa.
possibility	kb. (j.-ties) kemungkinan. there is p. of my going tidak ada kemungkinan bagi saya untuk pergi.
possible	ks. 1 mungkin. 2 tepat. -possibly kk. mungkin, barangkali, gerangan.
possum	= opossum. to play p. 1 berpura-pura tidak tahu. 2 berpura-pura sakit.
post	kb. 1 tonggak. 2 tempat tugas. 3 jabatan (of consul). 4 tempat, pusat. 5 sport : tempat semula. 6 surat kabar, majalah. -kkt. 1 menempatkan (sentry, guards). 2 memasang. 3 memasang tanda-tanda melarang masuk para pemburu (an area).
postage	kb. meterai, perangko. p. due perangko yang harus dibayar. p. stamp perangko.
postal	kb. kartupos. -ks. yang berhubungan dengan (kantor) pos. p. card kartupos.
postcard	kb. kartupos. picture p. kartupos bergambar.
postdate	kkt. mengundurkan tanggal (a check
postdoctoral	ks. tingkat setelah bergelar doktor (fellowship, studies).
poster	kb. plakat, surat tempelan.
posterior	kb. bokong, pantat. -ks. yang berikut, yang kemudian.
posterity	kb. anak-cucu, (ke)turunan.
postfree	kb. bebas bea.
postgraduate	kb. setelah tamat sarjana muda. p. work pelajaran pada tingkat sarjana atau doktoral.
posthaste	kb. secepat-cepatnya, secepat kilat.
posthole	kb. lubang untuk tiang.
posthumous	ks. anumerta (of an award). -posthumously kk. dengan anumerta.
postman	kb. (j. -men) tukang/upas pos, pengantar (surat) pos.
postmark	kb. kb. cap/stempel pos. -kkt. memberi cap pos. the letter was postmarked in new york surat itu bercap pos di new york.
postmaster	kb. kepala kantor pos. p. general direktur jendral pos.
postmistress	kb. kepala kantor pos wanita.
postnatal	ks. setelah kelahiran. p. care pemeliharaan setelah kelahiran.
postoperative	ks. sesudah pembedahan.
postpaid	ks. berperangko, bea pos sudah dibayar.
postpone	kkt. menunda, menangguhkan, membelakangkan, memundurkan.
postponement	kb. penundaan, penangguhan, pertangguhan, pemunduran.
postscript	kb. kata-kata/catatan tambahan. to add a p. (to'a letter) menambahkan kata-kata tambahan.
postulant	kb. rel.: pelamar, calon, kandidat.
postulate	kb. dalil. -kkt. mendalilkan, menerima sebagai dalil.
posture	kb. sikap badan pengawakan, perawakan. 2 sikap (towards a country). -kki. mengambil sikap, bergaya-gaya.
postwar	ks. sehabis perang. p. developments perkembangan-perkembangan sehabis perang.
posy	kb. (j. -sies) karangan bunga.
pot	kb. 1 pot (bunga), jambangan. 2 belanga. 3 (cooking) periuk, panci. 4 (coffee) cerek. 5 hasil taruhan (gambling). 6 sl.: meriwuana, ganja. 7 perut gendut. -kkt. (posted) menaruh (bunga-bunga) dalam pot. -potted ks. 1 ditaruh dalam jambangan. 2 sl.: mabuk
potable	ks. dapat diminum.
potash	kb. garam abu (kalium karbonat).
potassium	kb. kalium. p. sulfate kalium sulfat.
potato	kb. kentang. baked p. kentang panggang. boiled p. kentang rebus. p. chip keripik irisan kentang, serepih kentang yang digoreng.
potbellied	ks. gendut perutnya.
potbelly	kb. (j. -lies) perut gendut.
potboiler	kb. karangan picisan (sebagai mata pencaharian).
potency	kb. (j. -cies) 1 daya, potensi. the p. of alcohol daya alkohol. 2 kemampuan. 3 kekuatan.
potent	ks. keras, kuat, manjur. p. drink minuman yang keras. p. medicine obat kuat.
potentate	kb. raja.
potential	kb. 1 kesanggupan, tenaga. 2 kekuatan. -ks. mungkin. -potentially kk. kemungkinan besar.
potentiality	kb. (j. -ties) kemampuan.
potful	kb. (se)cerek penuh.
potholder	kb. lampin, lap/kain untuk memegang panci.
pothole	kb. lobang di jalan.
pothook	kb. sangkutan/gantungan/cantelan periuk.
potion	kb. minuman, obat. love p. minuman pembangkit cinta-berahi, obat pekasih.
potluck	kb. (makanan) seadanya. to take p. makan seadanya.
potpie	kb. gulai daging.
potpourri	kb. bunga rampai.
potsherd	kb. pecahan barang tanah.
potshot	kb. 1 tembakan kepada benda yang tidak bergerak. 2 tembakan dari jarak dekat. 3 jawaban yang ngawur.
potter	kb. pembuat barang-barang tembikar. potter's field tanah pekuburan orang-orang miskin. potter's wheel jentera pembuat tembikar.
pottery	kb. (j. -ries) barang tembikar, pecah-belah dari tanah. two pieces of p. dua buah/potong barang tembikar.
pouch	kb. kantong. 2 kantong perut (of kangaroo).
poultice	kb. tuam, tapal.
poultry	kb. unggas, ayam-itik. p. form peternakan ayam. p. husbandry perunggasan, peternakan unggas. p. market pasar ayam.
poultryman	kb. (j. -men) peternak unggas.
pounce	kki. 1 menerkam (on its prey). 2 menyambar. 3 mendamprat (on a mistake).
pound	pound
poundage	kb. perkiraan berat dalam pon.
pounder	pounder
pour	kkt. menuangkan (water). -kki. 1 turun. 2 mengalir, melimpah.
pout	kki. mencebik, mencebil.
poverty	kb. kemelaratan, kemiskinan. to live in p. hidup dalam kemiskinan. poverty-stricken ks. yang ditimpa kemiskinan, miskin.
pow, p.o.w.	[prisoner of war] kb. tawanan perang.
powder	kb. 1 pupur, bedak (for the face). 2 bubuk. 3 (gun) mesiu. -kkt. membedaki (o's face).
power	kb. 1 kekuasaan. 2 tenaga. 3 daya. 4 kekuatan. 5 negara besar. 6 kemampuan. 7 wewenang. 8 math.: pangkat. -powered ks. bertenaga mesin.
powerboat	kb. perahu (ber)motor.
powerful	ks. sangat kuat. a p. man seorang yang besar kekuatannya, seorang yang sangat kuat. -powerfully kk. dengan/secara kuat. he's a p. built man ia berbadan kuat.
powerhouse	kb. 1 pembangkit tenaga listrik. 2 inf.: tokoh atau kelompok pusat/besar.
powerless	ks. 1 tak berdaya, mati kutu. he was p. to do anything ia tidak berdaya berbuat sesuatu. 2 mati listrik (of a home).
powwow	kb. inf.: rapat, pertemuan.
pox	kb. lih chicken, smallpox.
pp.	[pages] halaman-halaman.
ppd.	1 [pospaid] telah berperangko. 2 [prepaid] telah dibayar terlebih dulu.
pr	[public relations] purel, humas.
pr.	1 [pair] pasang(an). 2 [present] hadir, sekarang. 3 [price] harga. 4 [printing] cetakan. 5 [pronoun] kataganti.
practicability	kb. (j. -ties) kepraktisan.
practicable	ks. dapat dipraktekkan. his proposal is not p. usulnya itu tak dapat dipraktekkan.
practical	ks. 1 praktis (objection, fountain pen). 2 mudah dilaksanakan. 3 berguna. -practically kk. hampir(-hampir).
practicality	kb. (j. -ties) kepraktisan, kegunaan.
practice	kb. 1 latihan. 2 praktek. 3 kebiasaan. 4 perbuatan. -kkt. 1 berlatih (the violin). 2 berpraktek sebagai (medicine, law). 3 menjalankan, mengamalkan, mempraktekkan. 4 berlatih, mempergunakan. 5 mengerjakan. practiced ks. berpengalaman.
practise	= practice.
practitioner	kb. pelaksana. general p. dokter praktek umum.
pragmatic	ks. pragmatis. to take a p. approach to s.t. memandang sesuatu menurut kegunaannya.
pragmatism	kb. aliran/faham pragmatis.
pragmatist	kb. seorang yang pragmatis.
prairie	kb. padang rumput yang luas sekali (tanpa pohon-pohon).
praise	kb. pujian. to speak in of s.o. berbicara memuji-muji seseorang. -kkt. memuji-muji.
praiseworthy	ks. patut dipuji.
prance	kki. berjingkrak-jingkrak.
prank	kb. kelakar, olok-olok, seloroh, sendagurau. to play a p. on s.o. menipu/mengibuli seseorang.
prankster	kb. orang yang suka berolok-olok.
pratfall	kb. sl.: jatuh pada pantat.
prattle	kb. kecek, ocehan. -kki. berkecek, mengoceh, merepet.
prawn	kb. semacam udang.
pray	kkt. 1 memohonkan. 2 mengharap. -kki. berdoa, bersembahyang.
prayer	kb. orang yang bersembahyang.
pre-christian	ks. sebelum masehi, pramasehi. the p. era jaman sebelum masehi.
pre-election	ks. pemilihan pendahuluan. p. predictions ramalan-ramalan tentang hasil pemilihan pendahuluan.
pre-eminence	kb. keunggulan, sifat ulung.
pre-eminent	ks. (sangat) unggul. he's p. in his specialty ia sangat ulung dalam keahliannya.
pre-empt	kkt. 1 menduduki lebih dulu. 2 memiliki lebih dulu.
preach	kkt. 1 mengajarkan (the gospel). 2 menasehati. -preaching kb. khotbah, pengajaran. 2 penyebaran kata-kata nasehat.
preacher	kb. khatib, pendeta.
preamble	kb. mukadimah.
prearrange	kkt. mengatur sebelumnya. prearranged agreement persetujuan yang telah diatur sebelumnya.
prec.	[preceding] yang mendahului, terdahulu.
precarious	ks. sulit, genting, berbahaya.
precaution	kb. tindakan pencegahan.
precautionary	ks. yang berhubungan dengan pencegahan. p. measure tindakan pencegahan.
precede	kkt. mendahului (s.o.). -preceding ks. yang terdahulu. the p. commercial was recorded iklan yang terdahulu adalah rekaman.
precedence	kb. hak lebih tinggi. to take p. over . 1 harus didahulukan daripada. 2 lebih diutamakan daripada.
precedent	kb. sesuatu yang bisa dijadikan teladan. to create/set a p. for others menetapkan sesuatu untuk ditiru lain orang.
precept	kb. 1 aturan, ajaran. 2 perintih.
preceptor	kb. guru, pendidik, pembimbing.
precinct	kb. 1 (election) daerah. 2 (police) seksi. 3 halaman. to leave the school precincts meninggalkan halaman sekolah.
precious	ks. 1 berharga (of time). 2 mulia, murni, adi (of metals, stones). 3 indah, agung (of style). -kk. inf.: sangat.
precipice	kb. ngarai, tebing yang curam.
precipitate	kb. lapisan endapan. -ks. 1 dengan cepat. 2 tergesa-gesa. -kkt. 1 menimbulkan (war). 2 mempercepat. -kki. mengendap (of moisture).
precipitation	kb. 1 hujan, salju. 2 timbulnya. 3 (peng)endapan.
precipitous	ks. 1 terjal (of a cliff). 2 tergesa-gesa. to make a p. exit keluar/berangkat cepat-cepat.
precis	kb. ringkasan, ikhtisar.
precise	ks. 1 tepat (statement). 2 saksama. -precisely kk. 1 tepat. 2 justru. 3 tepat sekali.
precision	kb. kesaksamaan, ketelitian. precision-engineered ks. dibuat dengan cermat, dengan presisi.
preclude	kkt. menghalangi, menghindarkan .
precocious	ks. terlalu cepat menjadi dewasa, dewasa sebelum waktunya.
precociousness	kb. hal dewasa sebelum waktunya, keadaan cepat matang/dewasa.
preconceive	kkt. mempertimbangkan sebelumnya. preconceived notion pendapat yang terbentuk sebelumnya.
preconception	kb. pendapat yang diambil sebelumnya, prasangka.
precondition	kb. prasyarat. -kkt. memelihara, mempersiapkan.
precursor	kb. 1 pendahuluan, tanda. 2 pelopor, perintis jalan.
predate	kkt. mendahului, lebih tua. this house predates the founding of the town rumah ini mendahului pembangunan kota itu.
predator	kb. yang mencari sesuatu sebagai mangsanya, binatang/organisme yang makan binatang lain.
predatory	ks. ganas, buas.
predawn	predawn
predecessor	kb. 1 pendahulu. he was my p. dialah yang mendahului saya. 2 leluhur.
predestination	kb. takdir.
predestine	kkt. mentakdirkan. he was predestined to be a leader ia telah ditakdirkan untuk menjadi pemimpin.
predetermine	kkt. menetapkan sebelumnya, mengkodratkan.
predicament	kb. 1 keadaan sulit. i'm in a p. saya dalam keadaan sulit. 2 keadaan berbahaya.
predicate	kb. sebutan, predikat. -ks. predikat. -kkt. 1 mengatakan sebagai suatu kebenaran. 2 mendasarkan (on atas).
predict	kkt. meramalkan.
predictability	kb. kemungkinan meramalkan, hal dapat meramalkan.
predictable	ks. dapat diramalkan.
prediction	kb. ramalan. weather p. for tomorrow ramalan cuaca untuk besok.
predilection	kb. kesukaan, kegemaran.
predispose	kkt. mempengaruhi, memberi kecenderungan. i was predisposed to like him aku menjadi cenderung untuk menyukainya.
predisposition	kb. kecenderungan. he has a p. to minor ailments ia mudah kena penyakit ringan.
predominance	kb. 1 keunggulan, keulungan (of a political party, sports team). 2 kelaziman.
predominant	ks. 1 utama. p. colors in batik warna-warna utama dari kain batik. 2 berkuasa. that party is p. here partai itu berkuasa disini.
predominate	kki. 1 menonjol (of a feature). 2 berkuasa.
preen	kkt. 1 bersolek (of a girl). 2 menjilat-jilat (of a cat).
pref.	[preface] kata pengantar, prawacana.
prefab	kb. inf.: rumah pabrikan/cetakan/ prafabrik.
prefabricate	kkt. membuat sehingga bagian-bagian tinggal dipasang saja. prefabricated house = prefab.
preface	kb. kata pengantar, prawacana. -kkt. mendahului. to p. o's remarks with... mendahului kata-kata dengan....
prefatory	ks. yang berhubungan dengan pembukaan. p. remarks ucapan-ucapan pembukaan.
prefer	kkt. (preferred) 1 lebih suka, melebihkan. 2 melebihkan.
preferable	ks. lebih baik (to daripada). -preferably kk. lebih disukai. p. one with a master's degree lebih disukai yang bergelar sarjana.
preference	kb. pilihan, preferensi. he was given p. over... ia lebih disukai daripada....
preferential	ks. istimewa (treatment perlakuan). p. right hak mendahulu.
preferment	kb. kenaikan pangkat, kedudukan yang lebih tinggi.
prefix	kb. awalan. -kkt. menaruh (sesuatu) didepan (of a title).
pregnancy	kb. (j. -cies) kehamilan.
pregnant	ks. 1 hamil, mengandung. 2 penuh (of a statement).
preheat	kkt. memanaskan (lebih) dulu.
prehensile	ks. yang dapat memegang (of tail, tongue).
prehistoric(al)	ks. yang berhubungan dengan prasejarah.
prehistory	kb. prasejarah.
prejudge	kkt. menghukum sebelum memeriksa.
prejudice	kb. prasangka, praanggapan, purbasangka. -kkt. merugikan (s.o's case). i'm perjudiced against... saya berprasangka terhadap...
prejudicial	ks. merugikan. p. to his interests merugikan kepentingan-kepentingannya.
prelate	kb. wali gereja, pendeta tinggi.
prelim	kb. inf.: ujian persiapan/pendahuluan.
prelim.	[preliminary] pendahuluan.
preliminary	kb. (j. -ries) persiapan. the preliminaries were over persiapan-persiapan selesai. -ks. 1 pendahuluan. p. examination pemeriksaan pendahuluan. 2 permulaan. p. training pendidikan permulaan.
prelude	kb. yang membuka/mendahului.
premature	ks. 1 gegabah (of on action). 2 sebelum waktunya, pradini (of a baby). 3 belum waktunya. -prematurely kk. sebelum waktunya.
premed	kb. inf.: pramahasiswa kedokteran. -ks. = premedical.
premedical	ks. sebelum masuk sekolah kedokteran.
premeditation	kb. pemikiran/perencanaan yang dilakukan/dipersiapkan terlebih dahulu.
premier	kb. perdana menteri.
premiere	kb. pertunjukan pertama/perdana. -kkt. mempertunjukkan perdana.
premiership	kb. jabatan perdana menteri.
premise	kb. dasar pikiran, alasan. on these premises di tempat ini.
premium	kb. 1 premi (hadiah). 2 premi, bayaran (kepada asuransi).
premonition	kb. alamat, pertanda.
prenatal	ks. sebelum melahirkan (care).
preoccupation	kb. keasyikan.
preoccupies	lih preoccupy.
preoccupy	kkt. (preoccupied) memenuhi, mengasyikkan, mengikat perhatian. -preoccupied ks. asyik, khusuk.
prep	ks. inf.: yang berhubungan dengan persiapan. p. school sekolah lanjutan swasta.
prep.	1 [preparatory] yang berhubungan dengan persiapan. 2 [proposition] kata depan. 3 [preparation] persiapan.
prepaid	lih prepay.
preparation	kb. 1 persiapan. to take a lot of p. memerlukan banyak persiapan. 2 pengolahan. 3 preparat, buatan, bikinan.
preparatory	ks. yang berhubungan dengan persiapan. p. work pekerjaan persiapan. p. school sekolah lanjutan swasta.
prepare	kkt. 1 mempersiapkan, menyiapkan, menyediakan (dinner). 2 mengolah. 3 membuat (medicine). -kki. to p. for s.t. bersiap-siap menghadapi sesuatu. -prepared ks. siap.
preparedness	kb. keadaan siap-sedia/siap-siaga.
prepay	kkt. (prepaid) membayar lebih dulu. the package was sent prepaid paket itu dikirim dengan membayar (ongkos) lebih dulu.
prepayment	kb. pembayaran sebelumnya.
preponderance	kb. jumlah lebih besar. a p. of snow in february salju yang turun berlebih-lebihan dalam bulan pebruari.
preponderant	ks. lebih besar. p. influence pengaruh yang lebih besar. in p. numbers dalam jumlah yang berlebih-lebihan.
preposition	kb. kata depan/perangkai, preposisi.
prepositional	ks. berpreposisi. p. phrase rangkaian kata yang berpreposisi.
prepossessing	ks. menawan hati.
preposterous	ks. gila-gilaan, tidak masuk akal.
prepuce	kb. kulup, kulit khatan.
prerecord	kkt. merekam sebelumnya.
prerequisite	kb. prasyarat.
prerogative	kb. hak istimewa.
pres.	1 [president] presiden. 2 [present] sekarang, hadir.
presage	kkt. menandai, memberi pertanda.
presb.	[presbyterian] presbiterian.
presbyterian	kb. orang prebiterian. -ks. presbiterian. p. church gereja presbiterian.
presbytery	kb. (j. -ries) majelis pengetua agama, pastoran.
preschool	ks. yang belum masuk sekolah (children, age).
prescience	kb. terus mata.
prescient	ks. mengetahui sebelumnya, mengetahui apa yang akan terjadi.
prescribe	kkt. 1 menulis resep obat. 2 menentukan. to do s.t. in the prescribed time mel;akukan sesuatu dalam waktu yang sudah ditentukan.
prescription	kb. med.: resep (dokter).
prescriptive	ks. memberikan petunjuk/ketentuan-ketentuan, bersifat menentukan.
presence	kb. kehadiran. she never seaks in his p. ia belum pernah berbicara bila ia hadir. your p. is requested at... diminta kehadiran saudara pada....
present	kb. 1 hadiah, pemberian. 2 sekarang ini. 3 kata-kata. -ks. 1 hadir (at pada). 2 sekarang. 3 waktu kini.
presentable	ks. tampan, rapi.
presentation	kb. 1 pemberian (of an award). 2 penyajian (of a speech). 3 perkenalan (of s.o. to s.o.). 4 penyajian/pertunjukan (of a play).
presentiment	kb. firasat.
preservation	kb. 1 pemeliharaan. in a state of good p. dalam keadaan terpelihara baik. 2 penjagaan. 3 pengawetan (of food).
preservative	kb. bahan pengawet, bahan pembuat tahan lama.
preserve	kb. 1 cagar. 2 sele. -preserves j. sele. -kkt. 1 memelihara (traditions). 2 mengawetkan, membuat yang tahan lama (fruits). 3 melindungi, menjaga (tree). 4 mempertahankan, memelihara. -kki. mengawetkan makanan. -preserved ks. yang diawetkan.
preshrank	lih preshrink.
preshrink	kkt. (preshrank, preshrunk) membuat (kemeja, dll) tidak dapat menyusut.
preshrunk	lih preshrink.
preside	kki. to p. at/over mengetuai, memimpin.
presidency	kb. (j. -cies) jabatan presiden, kepresidenan.
president	kb. 1 presiden (of a country). president-elect presiden terpilih. 2 ketua (of a club association). 3 direktur (of a firm). 4 rektor (of a university).
presidential	ks. mengenai presiden. p. decree keputusan presiden. p. election pemilihan presiden.
presidium	kb. presidium.
press	kb. 1 pers. 2 tekanan. 3 alat pemeras. 4 mesin pencetak. 5 pres (for a tennis racket). -kkt. 1 menyeterika (a suit). 2 menekan (a button). 3 memeras (fruit). 4 mencetak (records). 5 mendesak. 6 mendesakkan (o's point). 7 menekankan.
pressed	ks. yang ditekan/ditindih/diperas. p. flower bunga (kering) yang ditindih. -pressing kb. sesuatu untuk diseterika. ks. yang mendesak. p. business urusan yang mendesak.
pressure	kb. 1 tekanan. to bring p. to bear on s.o. memberi tekanan pada seseorang. 2 tekanan udara (in a space capsule). -kkt. memaksa.
pressurization	kb. tekanan udara.
pressurize	kkt. memberi tekanan udara. -pressurized ks. yang diberi tekanan udara (of a suit, cabin).
prestige	kb. gengsi, perbawa, wibawa, martabat.
prestigious	ks. bergengsi, bermartabat tinggi, berwibawa.
presto	kseru. tiba-tiba, dengan cepat.
prestressed	ks. pra-tekan. p. concrete beton pra-tekan.
presumably	kk. agaknya, kiranya, barangkali, rupanya.
presume	kkt. 1 mengira. i p. you are speaking to me kukira kau berbicara kepadaku. 2 menganggap. -kki. menduga, mengira.
presumption	kb. 1 anggapan. 2 kepongahan, kelancangan, kesombongan. forgive my p. maafkan kelancanganku.
presumptuous	ks. sombong, pongah, congkak, lancang.
presuppose	kkt. 1 mengisyaratkan. flying presupposes trained pilots penerbangan mensyaratkan adanya penerbang-penerbang yang terlatih. 2 memisalkan. let us p. that... marilah kita misalkan...
presupposition	kb. perkiraan, persangkaan.
pretend	kkt. 1 menganggap diri. 2 berpura-pura. 3 berlaku.
pretender	kb. 1 penuntut (to a throne). 2 orang yang suka berpura-pura.
pretense	kb. 1 berpura-pura. on the p. of dengan berdalih. i make no p. to any expertise sya tidak menganggap diriku sebagai ahli.
pretension	kb. keinginan, pretensi. he has pretensions to becoming the next president ia berkeinginan untuk menjadi presiden yang akan datang.
pretentious	ks. megah, mewah. a most p. home rumah yang sangat megah.
preterit	kb. gram.: bentuk katakerja masa lalu.
pretext	kb. dalih, helat. on the p. of illness dengan dalih sakit.
pretty	ks. cantik, molek, manis. she's a p. girl ia seorang gadis yang cantik. -kk. agak.
pretzel	kb. kue kering yang asin.
prevail	kki. berlaku, menang. the will of the people will p. kehendak rakyat akan berlaku. to p. (up)on membujuk. -prevailing ks. 1 umum. 2 besar, kuat (influence). 3 berlaku.
prevalence	kb. 1 meratanya (of colds, complaints). 2 kelaziman.
prevalent	ks. 1 umum, merata. 2 lazim.
prevaricate	kki. 1 berbohong. 2 berbicara putar-balik.
prevaricator	kb. orang yang plin-plan, pembohong.
prevent	kkt. 1 mencegah (an accident). 2 menghalangi. 3 menjaga.
preventable	ks. dapat dicegah.
preventative	= preventive kb.
prevention	kb. pencegahan. rust p. pencegahan supaya tidak berkarat.
preventive	kb., ks. pencegah. a p. against typhoid fever pencegah penyakit tipus.
preview	kb. 1 pra-pertunjukan. 2 peninjauan. -kkt. mengadakan pertunjukan (pendahuluan) dari sebuah film.
previous	ks. sebelum(nya). to have a p. engagement sudah ada janji. -previously kk. sebelum itu, sebelumnya.
prewar	ks. sebelum perang, pra-perang.
prexy	kb. (j. -xies) sl.: rektor (pada universitas).
prey	kb. 1 mangsa. the tiger pounced on its p. harimau itu menerkam mangsanya. 2 sasaran. -kki. to p. (up)on 1 merampasi (of pirates). 2 mencari sebagai mangsanya (of birds). 3 menyambar (of vultures, eagles). 4 menggerogoti, menyiksa.
price	kb. 1 harga. 2 hadiah. -kkt. 1 memberi harga, menetapkan harga. 2 inf.: menanyakan harga. -priced ks. yang diberi harga.
priceless	ks. tak ternilai.
pricewise	kk. mengingat harganya.
prick	kb. tusukan (of pin, needle). p. of conscience gangguan kata hati. -kkt. 1 menusuk (o's finger). 2 mencakar (of a cat). -kki. to p. up o's ears memasang telinga.
prickly	ks. berduri, banyak durinya. p. heat biang keringat, biring peluh, keringat buntat.
pride	kb. 1 kebanggaan. 2 rasa harga diri. 3 kegagahan. -kkt. to p. o.s. on membanggakan diri karena.
pried	lih pry.
priest	kb. 1 (islam) kiyai, imam. 2 chr.: pendeta.
priestess	kb. pendeta wanita.
priesthood	kb. kependetaan. to enter the p. menjadi pendeta.
priestly	ks. seperti pendeta.
prig	kb. orang yang lupa daratan.
priggish	ks. angkuh, lantam.
prim	ks. rapih, formil, teliti.
prim.	1 [primitive] primitip. 2 [primary] yang pertama, primer.
primacy	kb. (j. -cies) keunggulan.
primadonna	kb. sripanggung. she's a p. in behavior tingkahlakunya sebagai seorang sripanggung.
primafacie	ks., kk. yang utama/kuat (of evidence).
primary	kb. (j. -ries) pemilihan pendahuluan untuk memilih calon dari masing-masing partai. -ks. 1 utama (couse of stress). 2 sangat. 3 primer, utama (of colors). 4 pokok. 5 dasar. -primarily kk. terutama.
primate	kb. 1 rel.: uskup tertinggi. 2 binatang menyusui tingkat utama.
prime	kb. usia yang sebaik-baiknya. -ks. 1 utama. 2 yang terbaik. -kkt. 1 memancing (mesin). 2 memberi cat dasar. 3 memberi keterangan. 4 memperlengkapi. -priming kb. 1 pemberian cat dasar. 2 cat dasar.
primer	kb. 1 (point) cat dasar. 2 kep.
primeval	ks. yang mula-mula, dari jaman purba. p. forest hutan dari jaman purba.
primitive	ks. 1 primitip. p. conditions keadaan-keadaan yang primitip. 2 sederhana, bersahaja. p. surroundings keadaan yang sederhana sekali.
primitiveness	kb. keadaan primitif/bersahaja, keprimitipan.
primness	kb. ketidakwajaran, tingkahlaku yang dibuat-buat.
primogeniture	kb. hak anak yang sulung.
primordial	ks. purba, yang mula-mula. p. man manusia purba.
primp	kki. bersolek, berdandan.
primrose	kb. sejenis bunga mawar. the p. path hidup bersenang-senang diri.
primus	kb. p. stove (kompor) primus, kompor minyak tanah.
prin.	1 [principle] prinsip. 2 [principal] kb. kepala sekolah. ks. yang utama
prince	kb. 1 pangeran. p. charles pangeran charles. 2 tokoh. merchant p. tokoh pedagang besar. p. consort suami ratu. p. of darkness syaitan. p. of peace isa al-masih.
princeling	kb. putera/pangeran yang muda.
princely	ks. seperti/mirip bangsawan. p. manners tingkahlaku seperti bangsawan.
princess	kb. puteri.
principal	kb. 1 acad.: kepala sekolah. 2 uang pokok. 3 pelaku, peserta (in a duel). -ks. utama, pokok, yang terpenting. -principally kk. terutama.
principality	kb. (j. -ties) kerajaan, kepangeran.
principle	kb. 1 asas, dasar. 2 prinsip. 3 pendirian. high-principled ks. mempunyai dasar-dasar/prinsip-prinsip yang kuat.
print	kb. 1 cetakan. 2 phot.: potret, afdruk. 3 cloth.: pakaian dari cita cap. -kkt. 1 mencetak (a book). 2 menulis dengan huruf cetak (o's name). 3 mengafdruk, membuat (a copy). print-out kb. mencetak. kkt. mencetak.
printable	ks. sopan, beradab.
printer	kb. pencetak.
printing	kb. 1 pencetakan (of s.t.). 2 percetakan (as a trade). p. ink tinta cetak. p. office/shop percetakan. p. press mesin cetak. 3 cetakan. 2nd p. cetakan ke-2.
prior	kb. kepala biara. -ks. lebih dahulu, sebelumnya. p. approval persetujuan lebih dahulu. -kk. sebelum. p. to coming to... sebelum datang ke...
priority	kb. (j. -ties) priorita(s). this has p. over that ini harus didahulukan daripada itu.
prism	kb. prisma.
prison	kb. penjara, terungku. to commit/send s.o. to p. memasukkan seseorang ke penjara. to be in p. meringkuk/mendekam didalam penjara.
prisoner	kb. 1 orang hukuman. he was taken p. ia ditawan/dipenjarakan. 2 tawanan. p. of war tawanan perang.
prissy	ks. inf.: terlalu sopan, manis sekali.
pristine	ks. murni, asli. in p. condition dalam keadaan asli.
privacy	kb. (j. -cies) 1 kebebasan/keleluasan pribadi. 2 rahasia, pribadi.
private	kb. mil.: tamtama, prajurit biasa. -privates j. kemaluan. -ks. 1 pribadi. 2 tersendiri, dibawah empat mata. 3 partikelir, swasta. -privately kk. sendirian.
privation	kb.kekurangan, tiadanya. to live in p. hidup melarat.
privilege	kb. hak (istimewa). -privileged ks. yang mempunyai hak-hak istimewa. a p. person seorang yang mempunyai hak-hak istimewa.
privy	kb. (j. -vies) kakus umum. -ks. mengetahui rahasia. i was not p. to... aku tak diikut-sertakan dalam....
prize	kb. hadiah. p. ribbon pita hadiah kejuaraan. -kkt. 1 menghargai, menjunjung. 2 mengungkit. -prized ks. yang paling berharga. p. possession harta milik yang berharga.
prizewinner	kb. pemenang hadiah.
prizewinning	ks. yang memenangkan hadiah (play, dog).
pro	kb. sl.: 1 ahli. he's a golf p. ia seorang ahli main golf. 2 pro, professional. 3 yang setuju. five pro's and three con's lima yang setuju dan tiga yang tak setuju. -kk. setuju.
probability	kb. (j. -ties) kemungkinan. the p. of snow is great kemungkinan jatuhnya salju adalah besar.
probable	ks. mungkin. it's p. that we'll... mungkin kita akan... a mechanical foult was the p. couse kerusakan mekanik mungkin merupakan sebab. -probably kk. mungkin. he'll p. be late dia mungkin akan terlambat.
probate	kb. surat pengesahan hakim. p. of a will surat pengesahan hakim dari wasiat. p. court balai harta peninggalan. -kkt. mengesahkan secara resmi (a will).
probation	kb. 1 masa percobaan to place an offender on p. menghukum seorang yang bersalah dalam masa percobaan. 2 percobaan (of a student). p. officer pengawas orang jahat.
probationary	ks. yang berhubungan dengan percobaan. p. period masa percobaan.
probe	kb. 1 pemeriksaan, penyelidikan (surgical, congressional). 2 satelit. -kkt. memeriksa (a wound). -kki. menggali (for oil). to p. into menyelidiki. -probing kb. penyelidikan, pemeriksaan.
prober	kb. alat/orang penyelidik/penguji.
probity	kb. kejujuran, ketulusan/kebersihan hati.
problem	kb. 1 soal, masalh. 2 persoalan. the housing p. persoalan perumahan. p. child anak yang menyusahkan.
problematic(al)	ks. merupakan persoalan. it is highly p. whether ... masih sangat diragukan apakah....
proboscis	kb. belalai.
proc.	1 [process] proses. 2 [proceedings] acara kerja.
procedural	ks. acara, cara. it's a p. matter soalnya mengenai pelaksanaannya.
procedure	kb. 1 cara, jalan. what p. did you follow ? cara bagaimana yang kau ambil ? 2 prosedure. 3 tatacara. the correct p. tatacara yang tepat.
proceed	kb. kb. proceeds j. hasil, pendapatan. -kki. 1 meneruskan. 2 maju. 3 memulai. 4 beralih. 5 berjalan. -proceedings kb., j. 1 cara bekerja. 2 laporan rapat (of a congress, association). 3 acara berjalan teratur.
process	kb. 1 cara. 2 proses. -kkt. 1 menyiapkan, menyelesaikan (an application). 2 mengolah (food). -processing kb. pengolahan.
procession	kb. 1 arak-arakan, pawai, prosesi. to march in p. berarak. 2 defile. p. of cars iring-iringan mobil-mobilan.
processional	kb. yang berhubungan dengan arak-arakan.
proclaim	kkt. 1 menyatakan (a holiday). to p. o.s. king menyatakan dirinya raja. 2 memproklamirkan (independence).
proclamation	kb. 1 proklamasi. p. of independence proklamasi kemerdekaan. 2 pernyataan (of martial law). 3 pengumuman. to issue a p. mengeluarkan pengumuman.
proclivity	kb. (j. -ties) kecenderungan, kecondongan (to untuk). he has a p. to laziness ia mudah kebangkitan penyakit malas.
procrastinate	kki. menangguh-nangguhkan.
procrastination	kb. penangguhan, penundaan.
procrastinator	kb. orang yang suka menangguh-nangguhkan.
procreate	kkt. 1 menjadi ayah. 2 menghasilkan.
procreation	kb. 1 hal menjadi ayah. 2 penghasilan.
proctor	kb. acad.: (pegawai) pengawas mahasiswa.
procurable	ks. dapat diperoleh, bisa didapat.
procure	kkt. memperoleh, mendapat(kan).
procurement	kb. usaha mendapatkan/memperoleh. p. of supplies usaha mendapatkan perbekalan.
procurer	kb. 1 jaruman, alku, muncikari. 2 orang yang mendapatkan (of supplies).
procuress	kb. germo, mak jomblang.
prod	kb. 1 lecutan, pecutan (into side of a horse). 2 jolokan. 3 dorongan. 4 tusukan. -kkt. (prodded 1 memecut (a horse). 2 (urge) mendorong. 3 mendesak/mendorong seseorang.
prodigal	ks. boros, royal. p. son anak yang boros.
prodigious	ks. 1 sangat banyak. p. quantities luar biasa bbanyaknya. 2 luar biasa. p. accomplishment prestasi yang luar biasa.
prodigy	kb. (j. -gies) keajaiaban. child p. orang/anak yang luar biasa kepandaiannya.
produce	kb. hasil, hasil bumi. -kkt. 1 menghasilkan. 2 membuat. 3 menciptakan (a play). 4 memperlihatkan (o's passport). 5 menimbulkan (a sensation. 6 menerbitkan. 7 mengeluarkan. 8 memberikan, menyediakan (documents).
producer	kb. 1 produsen, penghasil (of wheat). 2 pengusaha sandiwara/film.
product	kb. 1 hasil. farm products hasil-jasil pertanian. 2 tanaman. what products are grown in this climate ? tanaman-tanaman apa yang ditanam dalam iklim ini ? 3 math.: hasil kali.
production	kb. 1 peoduksi, penghasilan. p. figures angka-angka produksi. 2 pembuatan. 3 hasil.
productive	ks. produktip.
productivity	kb. keproduktipan, daya produksi.
prof	kb. inf.: guru besar.
prof.	[professor] gurubesar, propesor.
profane	ks. 1 kototr, tidak senonoh, tidak sopan (language). 2 duniawi, biasa (of literature; lawan sacred). -kkt. mencemarkan (church, the sabbath).
profanity	kb. (j. -ties) kb. kata-kata tidak senonoh, carut-marut. to utter profanities mengucapkan kata-kata kotor.
profess	kkt. 1 menyatakan. to p. adminration for menyatakan kekaguman terhadap. 2 mengakui. -professed ks. terkenal, dikenal. -professedly kk. kelihatannya, diakui.
profession	kb. 1 pekerjaan. what is your p.? apakah pekerjaanmu ? 2 pernyataan (of faith).
professional	kb. 1 ahli. 2 sport.: pemain bayaran. -ks. ahli. a p. man seorang tenaga ahli. p.army tentara bayaran. p. career jabatan ahli. -professionally kk. berdasar jabatan.
professionalism	kb. sifat profesional.
professor	kb. gurubesar, profesor. p. brown profesor brown.
professorial	ks. sebagai gurubesar. p. rank pangkat sebagai gurubesar
professorship	kb. jabatan gurubesar.
proffer	kkt. 1 mengajukan (an apology). 2 mengulurkan (o's hand).
proficiency	kb. (j. -cies) kecakapan, keahlian.
proficient	ks. pandai, cakap.
profile	kb. 1 tampang/raut muka. 2 riwayat.
profit	kb. 1 untung. 2 keuntungan. 3 laba. 4 guna. -kki. 1 mendapat keuntungan. 2 mengambil pelajaran (by o's mistakes). profit-making ks. menghasilkan keuntungan.
profitable	ks. menguntungkan.
profiteer	kb. tukang catut, pencatut. -kki. mencatut, melintah darah. -profiteering kb. pencatutan, pengambilan untung berlebih-lebihan.
profligacy	kb. kejangakan.
profligate	kb. orang cendala. -ks. jangak.
profound	ks. dalam, amat sangat besar.
profuse	ks. sebesar-besarnya, sedalam-dalamnya. -profusely kk. sedalam-dalamnya, sebanyak-banyaknya.
profusion	kb. kelimpahan. flowers in p. bunga-bunga dalam jumlah sangat banyak.
progenitor	kb. leluhur, datuk, nenek moyang.
progeny	kb. (j. -nies) 1 anak-anak. 2 keturunan. 3 anak cucu.
prognosis	kb. ramalan (of disease, weather).
program	kb. 1 acara, program. 2 buku acara. 3 rencana. 4 kode (for a computer). -kkt. (programmed) membubuhi kode pada mesin hitung. -programming kb. 1 pembubuhan kode (of computer). 2 penyusunan acara (radio, tv).
programmatic	ks. yang bersifat sebagai rencana (statement).
progress	kb. 1 kemajuan. 2 sedang bermain (of a concert). -kki. 1 maju (of development, of a snail). 2 berkembang (of development).
progression	kb. 1 gerak maju. 2 deret. geometrical p. deret ukur.
progressive	kb. orang yang progresip. -ks. progresip (of political party, education). gram.: p. form bentuk progresip (katakaerja). to be p. in o's thinking berfikir sangat maju/progresip. -progressively kk. makin... makin.
progressiveness	kb. keprogresifan.
prohibit	kkt. 1 melarang. smoking prohibit! dilarang merokok! 2 menghalangi. bad weather prohibited flying cuaca buruk menghalang-halangi penerbangan. 3 mencegah. to p. s.o. from going mencegah seseorang pergi.
prohibition	kb. 1 larangan. p. against smoking larangan terhadap merokok. 2 masa larangan minuman keras. 3 undang-undang larangan perdagangan minuman keras.
prohibitive	ks. menjadi penghalang (of cost, price).
project	kb. 1 proyek. 2 pembangunan. 3 rancangan. -kkt. 1 memproyeksikan (a film). 2 mengeraskan (o's voice). 3 memperhitungkan (an increase). -projected ks. yang sudah diperhitungkan (of enrollment).
projectile	kb. proyektil.
projection	kb. 1 proyeksi, penyorotan. p. room kamar proyeksi. p. screen layar proyeksi. 2 penonjolan (of a balcony). 3 pengerasan (suara).
projectionist	kb. pelayan proyektor gambar hidup.
projector	kb. proyektor.
prolegomena	kb., j. pendahuluan dalam buku. p. to a study of history pengantar pelajaran sejarah.
proletarian	ks. proletar.
proletariat	kb. proletariat, kaum murba/marhaen.
proliferate	kki. berkembangbiak.
proliferation	kb. perkembangbiakan.
prolific	1 banyak hasil. p. writer pengarang yang banyak karyanya. 2 subur, mudah berkembangbiak (of animals).
prolix	ks. bertele-tele, panjang lebar (of speech).
prolog(ue)	kb. 1 kata pendahuluan. 2 kata perkenalan.
prolong	kkt. memperpanjang, memanjangkan.
prolongation	kb. perpanjangan.
prom	kb. inf.: pesta dansa.
promenade	kb. 1 tempat berjalan. to take a p. berjalan-jalan. p. deck geladak (kapal) tempat berjalan-jalan. 2 perjalanan. -kki. berjalan-jalan.
prominence	kb. 1 keulungan, keadaan terkemuka (of s.o.). to come into p. menjadi seorang yang menonjol/terkemuka. 2 ketinggian.
prominent	ks. 1 terkemuka. p. citizen penduduk yang terkemuka. 2 menyolok, menonjol. -prominently kk. secara jelas/menyolok/menonjol. p. displayed dipamerkan secara jelas.
promiscuity	kb. (j. -ties) 1 persetubuhan dengan siapa saja. 2 percampuran.
promiscuous	ks. tidak memilih-milih. p. intercourse a) persetubuhan dengan siapa saja. b) pergaulan dengan siapa saja. -promiscuously kk. bercampur-aduk, kacau-balau, tak membeda-bedakan.
promiscuousness	= promiscuity.
promise	kb. 1 janji.to break o's p. melanggar janjinya. 2 bakat. 3 harap. -kkt. 1 berjanji. 2 menjanjikan. -promising ks. memberi harapan. p. dramatist dramawan yang memberi harapan.
promissory	ks. p. note surat kesanggupan/pinjaman, promes.
promontory	kb. (j. -ries) tanjung.
promote	kkt. 1 menaikkan (to another grade or class). 2 memajukan (tourism, good relations). 3 mempertimbangkan (the arts).
promoter	kb. 1 penyelenggara (of boxing). 2 penganjur, promotor.
promotion	kb. 1 kenaikan (pangkat, kelas). to get a p. to captain memperoleh kenaikan pangkat menjadi kapten. 2 kemajuan. advertising p. kemajuan melalui periklanan.
promotional	ks. yang berhubungan dengan hal memajukan. p. advertising iklan untuk memperkenalkan sesuatu barang.
prompt	ks. 1 cepat. 2 tepat. -kkt. 1 mendorong. 2 menganjurkan, mendesak. 3 membisiki (an actor). 4 menyarankan. -promptly kk. 1 tepat. 2 pada waktunya. 3 cepat. i p. forgot saya cepat lupa.
prompter	kb. pembisik, juru bisik.
promptness	kb. ketetapan waktu.
promulgate	kkt. 1 mengumumkan dengan resmi (a regulation). 2 mengajarkan. 3 menyebarluaskan.
promulgation	kb. 1 pengumuman. 2 penyebaran.
pron.	1 [pronoun] kataganti. 2 [pronunciation] lafal (kata), (peng)ucapan.
prone	ks. 1 mudah mendapat (kecelakaan). 2 mudah, cenderung. p. to be hasty mudah tergesa-gesa. to lie p. bertiarap, meniarap.
prong	kb. 1 gigi garpu. 2 cabang (of antler).
pronoun	kb. kataganti.
pronounce	kkt. 1 mengucapkan, melafalkan (a name, word). 2 law.: menjatuhkan (hukuman). 3 menyatakan. -pronounced ks. 1 berat. 2 nyata, tegas. pronouncing dictionary kamus yang memuat ucapan kata-kata.
pronounceable	ks. dapat diucapkan.
pronouncement	kb. 1 pengumuman, pernyataan. 2 keputusan.
pronto	kk. inf.: segera, seketika itu juga.
pronunciation	kb. 1 lafal, pelafalan, pengucapan. 2 cara mengucapkan, ucapan.
proof	kb. 1 bukti. to furnish/give/produce p. memberikan bukti (of tentang). 2 tulen. 3 cetakan percobaan. -ks. sanggup, tahan.
proofread	kkt. mengoreksi cetakan percobaan. -proofreading kb. koreksi cetakan percobaan.
proofreader	kb. korektor (pada percetakan), pembaca pruf.
prop	kb. 1 sangga, tiang. 2 alat-alat atau barang-barang yang diperlukan diatas pentas. 3 ar.: sl.: baling-baling pesawat udara. -kkt. (propped) memberi sandaran, menopang, menyangga.
propaganda	kb. 1 propaganda. 2 (islam) da'iyah, da'wah.
propagandist	kb. 1 propagandis. 2 (islam) da'i(yah)
propagandistic	ks. yang berkenaan dengan propaganda atau dengan orang yang melakukan propaganda, secara propaganda.
propagandize	kkt. mempropagandakan.
propagate	kkt. 1 menyebarkan (faith, news, ideas). 2 memperbanyak (plants).
propagation	kb. 1 perkembang-biakan. 2 perambatan (of the faith).
propagator	kb. muallim.
propane	kb. sejenis metan (c3h8). p. gas gas yang mengandung sejenis metan.
propel	kkt. (propelled) 1 mendorong. to p. a raft down stream mendorong rakit ke hilir. 2 menggerakkan. to p. by steam menggerakkan dengan uap.
propellant	kb. bahan pembakar.
propeller	kb. 1 baling-baling. 2 kitiran, titiran. p. shaft poros/as baling-baling, sumbu baling-baling.
propensity	kb. (j. -ties) kecondongan, kecenderungan (for akan).
proper	ks. 1 pantas. 2 tepat. 3 patut. 4 sopan. 5 yang sebenarnya. 6 baik, sebaiknya. -properly kk. 1 dengan pantas. 2 sebagaimana (se)mestinya. 3 secara tepat. 4 sebaik-baiknya.
property	kb. (j. -ties) 1 tanah milik. 2 milik. 3 sifat. 4 khasiat (of a drug, herb). p. tax pajak kekayaan.
prophecy	kb. (j. -cies) ramalan, nujuman.
prophesied	lih prophesy.
prophesies	lih prophesy.
prophesy	kkt. (prophesied) meramalkan, menujumkan.
prophet	kb. 1 nabi. the p. nabi mohammad s.a.w. 2 rasul. 3 (weather) peramal.
prophetic	ks. bersifat ramalan.
prophylactic	kb. 1 alat pencegah penyakit. 2 alat pencegah kehamilan. -ks. yang berkaitan dengan pencegah penyakit.
propinquity	kb. keadaan dekat, keakraban.
propitiate	kkt. 1 mengambil hati (gods dewa-dewa). 2 mendamaikan.
propitiation	kb. 1 pengambilan hati. 2 perdamaian.
propitious	ks. menguntungkan, mujur, baik, tepat.
propjet	kb. pesawat jet berbaling-baling.
proponent	kb. penganjur, pendukung, penyokong.
proportion	kb. 1 bagian. 2 proporsi, ukuran. 3 perbandingan. -proportioned ks. berpotongan. she is well-p. potongan badannya baik.
proportional	ks. sebanding, sepadan. not p. to tak sebanding dengan. -proportionally kk. secara/menurut perbandingan.
proportionate	ks. yang sebanding. the p. amount of time spent waktu sebanding yang digunakan.
proposal	kb. 1 usul. to make a p. mengemukakan sebuah usul/tawaran. 2 lamaran, pinangan (of marriage). 3 anjuran, saran(an).
propose	kkt. 1 mengusulakan. i p. this change saya usulkan perubahan ini. 2 bermaksud, berniat. 3 mengemukakan (s.o's name as). 4 menganjurkan (a toast). 5 menawarkan. -kki. melamar.
proposer	kb. pengusul.
proposition	kb. 1 dalil (in logic, math). 2 usul, saran. 3 rencana, masalah. 4 hal, soal.
propound	kkt. mengemukakan, mengajukan (on idea, a thesis).
proprietary	ks. (sebagai) pemilik. p. rights hak-hak pemilik. to have a p. interest in... mempunyai kepentingan sebagai pemilik dalam...
proprietor	kb. pemilik.
propriety	kb. (j. -ties) kesopanan. breach of p. pelanggaran susila.
propulsion	kb. 1 dorongan. 2 tenaga pendorong/penggerak.
prorate	kkt. membagi rata.
prosaic	ks. 1 membosankan, menjenukan. 2 lazim, biasa.
proscribe	kkt. melarang, mengharamkan.
proscription	kb. pengasingan, pembuangan, pengutukan, (pe)larangan.
prose	kb. prosa.
prosecute	kkt. 1 menuntut, mengusut (hukum). 2 meneruskan, melaksanakan (a war, enterprise). prosecuting attorney penuntut umum, jaksa, oditur.
prosecution	kb. 1 penuntutan. 2 pihak penuntut. the p. rests its case pihak penuntut tak meneruskan pendakwaannya. 3 usaha (of o's studies).
prosecutor	kb. jaksa, penuntut, oditur. public p. penuntut umum.
proselyte	kb. pengikut baru, pemeluk agama baru.
proselytize	kkt. menarik masuk.
prosody	kb. ilmu persajakan.
prospect	kb. 1 kemungkinan. the p. of success is slight kemungkinan berhasil sedikit. 2 bakal calon. 3 harapan (of a harvest, as a lawyer). 4 (view) pemandangan. -prospects j. harapan, kemungkinan. -kki. menyelidiki tanah. -prospecting kb. pencarian (bijih).
prospective	ks. calon, bakal. p. buyer bakal pembeli. p. mother calon ibu.
prospector	kb. pencari, penyelidik untuk mencari emas, perak, minyak dsb.
prospectus	kb. prospektus, bahan iklan, buku sebaran.
prosper	kki. 1 berhasil baik. 2 menjadi makmur. the country is prospering negeri itu menjadi makmur.
prosperity	kb. (j. -ties) kemakmuran.
prosperous	ks. makmur. a p. businessman seorang pengusaha yang terang bintangnya.
prostate	kb. anat.: prostata.
prostitute	kb. pelacur, wanita p, lonte, sundal, cabo, tuna-(su)sila. wts, kembang latar. -kkt. melacurkan, menyalahgunakan (o's profession). to p. o.s. melacurkan diri.
prostitution	kb. pelacuran, persundalan, ketuna-susilaan.
prostrate	ks. letih-lesu, tak berdaya (with karena). -kkt. melemahkan.
prostration	kb. 1 sujud. 2 kelemahan. heat p. kelesuan oleh hawa panas.
protagonist	kb. 1 pelaku utama. 2 pendukung, penyokong.
protect	kkt. 1 membela (kepentingan-kepentingannya). 2 melindungi (s.o.) (from dari). 3 menjaga.
protection	kb. 1 perlindungan. p. against/from the weather perlindungan dari cuaca. 2 pembelaan. 3 penjagaan. police p. penjagaan polisi. 4 proteksi.
protective	ks. 1 bersifat melindungi. 2 pencegah.
protector	kb. 1 pelindung, pembela (of the faith). 2 penjaga.
protectorate	kb. protektorat, daerah perlindungan.
protege	kb. anak didik, yang dilindungi.
protein	kb. protein.
protest	kb. 1 protes, sanggahan. 2 (pem)bangkangan. -kkt. 1 memprotes, menyanggah. 2 membangkang. 3 menyatakan (o's loyality) (to kepada).
protestant	kb. seorang protestan. -ks. protestan. p. church gereja protestan.
protestantism	kb. aliran protestan.
protestation	kb. pernyataan (of loyalty).
protester	kb. pembangkang, penyangga, pemrotes.
protocol	kb. protokol.
protoplasm	kb. protoplasma.
prototype	kb. bentuk asli, bentuk dasar, purwa-rupa.
protract	kkt. memperpanjang. -protracted ks. berlarut-larut. p. conflict sengketa yang berlarut-larut.
protractor	kb. busur derajat.
protrude	kki. menonjol keluar (of a roof, teeth). -protruding ks. yang menonjol. p. chin dagu yang menonjol.
protrusion	kb. tonjolon keluar (of a broken bone).
protuberance	kb. jendul, bengkak tonjol, jenggul.
protuberant	ks. menjulang, menonjol, bengkak, menggelembung.
proud	ks. 1 bangga. 2 angkuh. 3 membanggakan hati. -proudly kk. dengan bangga.
prov.	[province] propinsi.
provable	ks. dapat dibuktikan.
prove	kkt. (proved, proved atau proven). membuktikan. -kki. ternyata. -proven ks. yang terjamin.
proven	lih prove.
provenance	= provenience.
provender	kb. 1 makanan hewan yang kering. 2 makanan.
provenience	kb. asal, sumber.
proverb	kb. pepatah, peribahasa. -proverbs bible.: surat amsal sulaiman.
proverbial	ks. 1 yang jadi pepatah. p. expression ucapan yang jadi pepatah. 2 terkenal. the p. smog of los angeles asbut los angeles yang terkenal.
provide	kkt. 1 menyediakan (funds, an education). 2 memberikan (vows). 3 mengadakan (transportation, shelter). 4 menetapkan. -kki. memperlengkapi. -provided, providing ksamb. asal saja, asal(kan).
providence	kb. pemeliharaan baik. p. tuhan, allah.
provident	ks. hemat-cermat, ingat akan hari esok.
providential	ks. sudah ditakdirkan tuhan, bernasib baik/mujur.
provider	kb. pemberi nafkah.
province	kb. 1 propinsi, daerah. 2 bidang wewenang.
provincial	ks. yang berhubungan dengan propinsi, kedaerahan. p. government pemerintahan propinsi. 2 kedesa-desaan, kedaerahan, udik. p. ways tingkah laku yang kedesa-desaan. 3 picik. p.outlook pandangan picik.
provision	kb. ketetapan, ketentuan, syarat. 2 persediaan. -provisions j. perbekalan, perlengkapan.
provisional	ks. sementara. p.constituation undang-undang dasar sementara. -provisionally kk. untuk sementara waktu.
proviso	kb. syarat, ketentuan.
provocation	kb. peng(h)asutan, provokasi, pancingan. to act under p. melakukan sesuatu karena dihasut, digertak-gertak.
provocative	ks. propokatip, yang merangsang untuk bertindak. p. act teguran yang propokatip.
provoke	kkt. 1 menggusarkan. 2 memancing (criticism). 3 menimbulkan, membangkitkan (a reply). 4 menghasut. -provoking ks. bersifat merangsang.
provost	kb. pembantu rektor.
prow	kb. haluan (kapal).
prowess	prowess
prowl	kb. on the p. sedang mencari (-cari). p. car mobil patroli. -kki. berkeliling mencari mangsa (of animals).
prowler	kb. 1 pencari mangsa (dengan diam-diam dan pelan-pelan). 2 (thief) perampas.
proximate	ks. 1 yang terdekat. 2 kira-kira, kurang lebih.
proximity	kb. dekatnya (to dengan).
proxy	kb. (j. -xies) 1 wakil. by p. secara berwakil, dengan mandat. 2 wali.
prs	[pairs] berpasang-pasang, beberapa pasang.
prude	kb. pemalu.
prudence	prudence
prudent	ks. bijaksana, hati-hati. -prudently kk. hati-hati, dengan bjaksana.
prudery	kb. (j. -ries) kekenesan, tingkah-laku yang dibuat-buat.
prudish	ks. sangat sopan santun.
prudishness	kb. kesopanan, kesopan-santunan.
prune	kb. buah prem yang dikeringkan. p. juice air prem. -kkt. 1 memangkas, menutuh, menunasi (pohon, dll). 2 memendekkan (an article). -pruning kb. pembabatan, pemangkasan. p. shears gunting pemangkas (tanam-tanaman, pohon).
prurience	kb. kecabulan, kegasangan.
prurient	ks. cabul, penuh hawa nafsu, gasang, amat berahi.
pry	kkt. (pried) membongkar, membuka dengan keras, mengumpil (top off a box). -kki. to p. into 1 mencampur-campuri (other's affairs). 2 menyelidiki (a matter). 3 pengintip, mengintai.
ps.	[psalm(s)] mazmur.
psalm	kb. mazmur. j. psalms mazmur, kitab zabur.
psalmbook	kb. kitab mazmur.
pseud.	[pseudonym] nama samaran.
pseudo-	kb. palsu, lancung, gadungan. pseudo-scholar sarjana gadungan.
pseudonym	kb. nama samaran.
pshaw	kseru. cih, bah.
psoriasis	kb. semacam penyakit kulit yang kronis.
psyche	kb. jiwa, hati.
psychedelic	ks. ketenangan jiwa yang terpengaruh rasa birahi dan seni cinta perasaan serupa itu akibat obat bius.
psychiatric	ks. yang berhubungan dengan penyakit jiwa. p. treatment perawatan oleh seorang dokter penyakit jiwa.
psychiatrist	kb. dokter penyakit jiwa, psikiater.
psychiatry	kb. ilmu penyakit jiwa, psikiatri.
psychic	psychic
psychoanalysis	psychoanalysis
psychoanalyst	kb. ahli analisa/jiwa, pengurai jiwa.
psychoanalyze	kkt. mengurai/menganalisa jiwa.
psychological	ks. psikologis, kejiwaan. p. study penyelidikan kejiwaan. -psychologically kk. menurut/secara ilmu jiwa.
psychologist	kb. ahli ilmu jiwa.
psychology	kb. (j. -gies) ilmu jiwa, psikologi. one needs to know the p. of the person perlu mengetahui keadaan jiwa orang.
psychoneurosis	kb. ketidakseimbangan mental disertai gangguan badaniah.
psychoneurotic	kb. penderita sakit jiwa. -ks. sakit jiwa,.
psychopath	kb. orang yang sakit jiwa, penderita sakit jiwa.
psychopathic	ks. yang berkaiatan dengan sakit jiwa.
psychosis	kb. 1 kesakitan jiwa, penyakit kejiwaan. 2 kegilaan.
psychosomatic	ks. yang berkaitan dengan penggunaan dasar-dasar ilmu jiwa. p. medicine ilmu pengobatan yang menggunakan dasar-dasar ilmu jiwa untuk pengobatan penyakit-penyakit badan.
psychotheraphy	kb. pengobatan penyakit dengan cara kebatinan.
psychotic	kb. orang gila. -ks. gila.
psywar	kb. inf.: perang urat syaraf.
pt.	1 [part] bagian. 2 [point] titik. 3 [pint] 0.568 liter. 4 [preterit] bentuk katakerja untuk waktu yang telah lampau.
ptboat	kapal motor torpedo.
ptomain	kb. p. poisoning keracunan zat lemas.
pts.	1 [parts] bagian-bagian. 2 [points] titik-titik. 3 [pints] 0,568 liter.
pub.	1 [public] umum. 2 [publication] terbitan. 3 [publishing] penerbitan.
puberty	kb. masa remaja/pubertas.
pubic	ks. yang berkaitan dengan pinggang. p. hair jembut. p. region bagian pinggang.
publ.	1 [publisher] penerbit. 2 [publication] terbitan. 3 [published] diterbitkan.
public	kb. 1 (masyarakat] umum. the general p. rakyat umum, orang banyak, masyarakat ramai. 2 rakyat. an informed p. rakyat yang memperoleh penerangan-penerangan. public-spirited ks. bersifat sosial. -publicly kk. didepan umum.
publication	kb. 1 penerbitan (of s.t.). 2 terbitan (issued by an organization). 3 pengumuman (of news).
publicist	kb. wartawan.
publicity	kb. publisitas. to get good p. mendapat pemberitaan yang baik. p. department bagian humas. p. man tukang reklame, penghubung masyarakat.
publicize	kkt. mengumumkan, memperkenalkan kepada umum.
publish	kkt. 1 menerbitkan (a book). 2 mengumumkan (o's personal affairs). -kki. terbit. -publishing kb. penerbitan. p. house (perusahaan) penerbitan.
publishable	ks. patut diterbitkan.
publisher	kb. penerbit.
pucker	kb. kerutan, lipatan. -kkt. mengerutkan (o's lips). -kki. mengerut.
pudding	kb. puding, podeng. rice p. (kue) poding dari tepung beras.
puddle	kb. genangan (of water air). mud p. balong, kubangan.
pudendum	kb. (j. -da) kemaluan wanita.
pudginess	kb. keadaan gemuk/tembam.
pudgy	ks. gemuk-pendek, tembam. p. cheeks pipi-pipi yang tembam.
puerperal	ks. p. fever demam panas karena baru melahirkan.
puertorican	kb.seorang porto rico.
puff	kb. 1 tiupan (of air, wind). 2 isapan. 3 embusan (of smoke). 4 gumpal. -kkt. 1 menggembungkan (out o's cheeks). 2 menghisap (rokok). -kki. 1 mengepul (of smoke). 2 terengah-engah.
puffed-up	ks. 1 bengkak, gembung. 2 sombong, congkak, angkuh.
puffiness	kb. keadaan bengkak.
puffy	ks. bengkak, gembung.
pug	kb. semacam anjing kecil. p. nose hidung pesek. pug-nosed ks. berhidung pesek.
pugilist	kb. petinju.
pugnacious	kb. suka berkelahi.
pugnacity	kb. kesukaan berkelahi.
puke	kki. vulg.: muntah.
pulchritude	kb. kecantikan, kemolekan.
pule	kki. merengek.
pull	kb. 1 renggutan, tarikan, penghelaan (on a rope, wire). 2 tali. 3 perjalanan. 4 isapan, hirupan (on a cigar). 5 sl.: pengaruh, untung. 6 tarikan/daya tarik (of a magnet). -kkt. 1 menarik (rope, a cart, trigger, hair, a crowd). 3 memetik (flowers).
pullet	kb. anak ayam betina, ayam dara.
pulley	kb. kere(kan). p. black kapi, takal, katrol.
pullman	kb. p. (car) kereta tidur.
pullout	kb. 1 mil.: penarikan (tentara). 2 kepergian (of a firm).
pullover	kb. pulover, sweater yang dipakai lewat kepala. p. dress baju yang dipakai lewat kepala.
pulmonary	ks. yang berkaitan dengan paru-paru. p. disease sakit/penyakit paru-paru. p. tuberculosis tebese paru-paru.
pulp	kb. 1 semacam bubur. wood p. bubur kayu. p. mill paberik bubur kayu. 2 daging buah (orange). 3 ampas (sugar cane). -kkt. 1 menjadikan bubur. 2 membuang ampas. p. magazine majalah murah/picisan.
pulpit	kb. mimbar. to ascend the p. menaiki atau naik keatas mimbar khotbah.
pulpwood	kb. kayu bubur/bubuk.
pulpy	ks. seperti bubur empuk sekali.
pulsate	kki. 1 berdenyut, berdebar-debar. 2 bergetar, menggetar.
pulsation	kb. 1 debaran, denyutan. 2 getaran.
pulse	kb. (urat) nadi. 2 sentimen perasaan (of a nation). 3 bunyi yang teratur (of an engine). 4 agri.: kacang-kacangan. -kki. 1 berdenyut, berdebar. 2 bergetar.
pulverize	kkt. 1 memipis, menghancurlumatkan, membubuk. 2 menghancur-leburkan (an opponent).
pumice	kb. batu apung/kambang/timbul.
pummel	kkt. memukul, meninju. to give s.o. a good pummeling menghajar seseorang dengan pukulan tinju yang bertubi-tubi.
pump	kb. 1 pompa. water p. pompa air. 2 cloth.: sepatu rendah. -kkt. 1 memompa(kan) (air, water, gas). 2 memperoleh keterangan, memancing. 3 melemparkan (shells into the enemy). 4 berjabatan tangan.
pumpkin	kb. semacam labu.
pun	kb. permainan kata-kata. -kki. (punned) mempermainkan kata-kata.
punch	kb. 1 pukulan. 2 (drink) minuman campuran. 3 kekuatan. 4 pons, mesin membuat lobang. -kkt. 1 meninju, menghantam (s.o.). 2 melubangi, memotong (karcis). punch-drunk ks. mabuk bertinju, pusing kena tinju.
punctilious	ks. 1 terlalu teliti, terlalu berpegang teguh pada sesuatu (mis. adat, peraturan). 2 cermat.
punctual	ks. tepat pada waktunya.
punctuality	kb. ketetapan waktu.
punctuate	kkt. 1 memberi/membubuhkan tanda-tanda baca. 2 menjelaskan. 3 menyela.
punctuation	kb. pemberian tanda-tanda baca. p. mark tanda baca.
puncture	kb. 1 auto.: kebocoran (ban). 2 tusukan (of eardrum). -kkt. 1 menusuk (eardrum). 2 membocorkan. the tire was punctured by a nail ban itu ditembus oleh paku.
