multifarious	ks. bermacam-ragam.
multigraph	kb. mesin pencetak. -kkt. mencetak dalam jumlah yang banyak.
multilateral	ks. lebih-pihak, multilateral.
multilevel	ks. bersusun, bertingkat-tingkat.
multilingual	ks. berbagai bahasa.
multimillionaire	kb. jutawan besar.
multinational	ks. berbagai bangsa.
multiple	kb. perkalian. lowest common m. kelipatan persekutuan terkecil.
multiplication	kb. perkalian. m. sign tanda kali. m. table daftar darab/perkalian.
multiplicity	kb. (j. -ties) keserbaragaman.
multiplied	lih multiply.
multiplier	kb. pengali.
multiplies	lih multiply.
multiply	kkt. (multiplied) 1 mengalikan (two numbers). 2 melipatgandakan. -kki. membiak, berbiak.
multipurpose	ks. serbaguna.
multiracial	ks. bersuku banyak.
multitude	kb. 1 banyak. to receive a m. of offers mendapat bertumpuk-tumpuk tawaran. 2 orang banyak.
mum	kb. inf.: bunga krisan. -ks. diam. to keep m. about s.t. tetap bungkam mengenai sesuatu.
mumble	kkt. berkomat-kamit. -kki. mengomel.
mumbo-jumbo	kb. birit-biritan/ucapan-ucapan kosong, upacara yang tiada berarti, omong-kosong.
mummy	kb. (j. -mies) 1 inf.: bu. 2 mumia.
mumps	kb., j. beguk, penyakit gondok/gondong.
mun.	[municipal] kota, kotapraja.
munch	kkt., kki. mengunyah.
mundane	ks. 1 keduniaan. 2 biasa.
municipal	ks. yang berkaitan dengan kota. m. government pemerintahan kota praja.
municipality	kb. (j. -ties) kotapraja, kotamadya.
munificence	kb. kemurahan hati.
munificent	ks. banyak sekali (of a gift).
munition(s)	kb. munisi, mesiu. m. dump gudang mesiu. m. plant paberik mesiu.
mural	kb. lukisan dinding.
murder	kb. pembunuhan. m. will out bangkai itu, bagaimana baik membungkusnya, akhirnya akan tercium juga. -kkt. 1 membunuh. 2 merusak (the king's english).
murderer	kb. pembunuh.
murderess	kb. pembunuh wanita.
murderous	ks. 1 kejam. 2 inf.: meletihkan (of work).
murkiness	kb. kegelapan, kemuraman, kesuraman.
murky	ks. kelam kabut, suram.
murmur	kb. 1 bisikan (of voice). 2 bunyi desioran yang abnormal (of heart). -kkt. membisikkan. -kki. berbisik.
mus.	1 (music) musik. 2 (museum) yang bersifat music). 3 (museum) musium).
muscle	kb. otot, urat. he didn't move a m. dia samasekali tak bergerak. -kki. sl.: to m. in masuk dengan kekerasan (on ke).
muscular	ks. berotot (tegap). m. strain ketegangan otot. m. dystrophy penyakit otot menyusut.
muse	kki. merenungkan, memikirkan. -musing kb. renungan.
museum	kb. musium.
mush	kb. 1 bubur. 2 inf.: omongan yang tolol.
mushroom	kb. jamur, cendawan. m. cloud awan bentuk cendawan dari ledakan bom nuklir. -kki. berkembang/tumbuh dengan cepat.
mushy	ks. 1 inf.: cengeng, sentimentil. 2 seperti bubur.
music	kb. 1 musik. m. lover penggemar musik. 2 buku musik. inf.: to face the m. menghadapi kesulitan dengan berani. to put to m. melagui.
musical	kb. komidi musik. -ks. berbakat musik. m. chairs permainan rebutan kursi dengan diiringi musik. -musically kk. dalam bidang musik.
musician	kb. pemain musik, pemusik, musikus. -musicians j. musisi, para pemain musik.
musicology	kb. ilmu musik.
muskrat	kb. tikus air.
muslim	kb. muslim, orang islam. lih moslem.
muslin	kb. kain tipis untuk gorden, tirai dll. kain kasa.
muss	kkt. 1 mengobrak-abrik (a room). 2 mengotorkan (the hands). 3 mengusutkan. her dress is mussed pakaiannya kusut.
mussel	kb. remis, kepah.
mussy	ks. berantakan, kacau, kusut.
must	kb. 1 keharusan. 2 lapuk. -ks. wajib, yang dimestikan. m. book buku wajib. -kkb. harus, mesti.
mustache	lih moustache.
mustard	mustard
muster	kb. apel, pengumpulan. to pass m. dapat diterima (setelah diperiksa), cukup baik. -kkt. mengumpulkan, mengerahkan. to m. out mengeluarkan.
mustiness	kb. keapakan, kelapukan.
mustn's	[must not]. lih must.
musty	ks. (berbau) apak, pengap.
mutation	kb. mutasi.
mute	kb. orang bisu. -ks. 1 bisu. to stand m. with embarrassment berdiri dengan tidak berkata apa-apa karena malunya. 2 mati (of a letter).
mutilate	kkt. 1 memuntungkan, mengudungkan (a person). 2 merusakkan (a toy, story).
mutilation	kb. 1 pemotongan, pengudungan (of a person). 2 perusakan (of an object)
mutineer	kb. pemberontak, pendurhaka.
mutinous	ks. yang memberontak.
mutiny	kb. (j. -nies) pemberontakan. -kki. memberontak.
mutt	kb. sl.: anjing bastar/kampung.
mutter	kkt., kki. berkomat-kamit, memberengut.
mutton	kb. daging domba. m. chop potongan daging domba.
mutual	ks. saling, bersama. m. understanding saling pengertian. m. assistance gotong royong, tolong-menolong. -mutually kk. atau satu sama lain, saling.
muzzle	kb. 1 berangus. 2 mulut senjata api. 3 moncong. -kkt. memberangus (a dog, the press).
my	kg. 1 saya, kepunyaan saya. my watch arloji saya. 2 -ku. my book bukuku. -kseru. m.! astaga !
mycology	kb. ilmu jamur/cendawan.
myopia	kb. lamur. intellectual m. pandangan yang dangkal.
myopic	ks. lamur, cadok, rabun.
myriad	kb., ks. banyak sekali. myriads of insects beribu-ribu serangga.
myself	lih self.
mysterious	ks. 1 aneh, pelik (of an illness). 2 gaib. m. smile senyuman yang penuh teka-teki.
mystery	kb. (j. -ries) 1 kegaiban (of the universe). 2 misteri. it's a m. to me adalah suatu misteri unutkku. 3 inf.: buku penuh sensasi. his actions are cloaked in m. tindakan-tindakannya diselubungi tabir rahasia.
mystic	kb. mistik, penganut ilmu kebatinan.
mystical	ks. 1 gaib (of a umber). 2 ajaib, penuh rahasia(of style). 3 kebatinan, mistik (of a religion).
mysticism	kb. ilmu tasawuf/kebatinan/klenik.
mystified	lih mystify.
mystifies	lih mystify.
mystify	kkt. (mystified) 1 membingungkan. 2 menakjubkan, mempesonakan (of a magician).
mystique	kb. sifat yang penuh rahasia, kekuasaan berdasar takhyul.
myth	kb. 1 dongeng. 2 isapan jempol. 3 cerita yang dibuat-buat.
mythical	ks. dongengan. m. character tokoh dongengan.
mythological	ks. yang berhubungan dengan mitologi. m. character tokoh dalam mitologi.
mythology	kb. (j. -gies) mitologi.
n	1 [north] utara. 2 [nitrogen] nitrogen, zat lemas.
n, n	kb. huruf yang keempat belas dari abjad inggeris.
n.	1 [neuter] netral. 2 [nominative] nominatip. 3 [north(ern)] (sebelah) utara. 4 [noun] katabenda. 5 [number] nomor, kata bilangan. 6 [new] baru. 7 [note] catatan. 8 [normal] normal.
n.c.	[north carolina] nagarabagian a.s.
n.c.o.	[non commissioned officer] bintara.
n.d.	[no date] tak bertanggal.
n.e.	[northeast] timur laut.
n.e.i.	[netherlands east indies] hindia timur belanda.
n.f.	[newfoundland] nama pulau dekat pantai timur kanada.
n.g.	[no good] kb. tidak becus.
n.h.	[new hampshire] negarabagian a.s.
n.j.	[new jersey] negarabagian a.s.
n.m(ex).	[new mexico] negarabagian a.s.
n.r.o.t.c.	[naval reserve officer training corps] korp/kesatuan latihan cadangan angkatan laut.
n.s.	[nova scotia] nama propinsi di kanada selatan.
n.y.	[new york] 1 negarabagian a.s. 2 kota new york.
n.y.c.	[new york city] kota new york.
n.z.	[new zealand] selandia baru.
nab	kkt. sl.: (nabbed) menangkap (basah).
nadir	kb. titik terendah, nadir.
nag	kb. kuda tua. -kkt. (nagged) mengomeli, membengkengi. -kki. mengomel (at pada).
nail	kb. 1 paku. to hit the n. on the head tepat. to pay on the n. membayar kontan. 2 anat.: kuku. n. clippers gunting kuku. -kkt. 1 memaku. 2 mengajak. to n. down memakukan. to n. up 1 memakukan tutup (a box). 2 memasang (a picture, diploma).
naive	ks. naif, tak dibuat-buat.
naivete	kb. kenaifan.
naked	ks. 1 telanjang (of body). n. to the waist separuh telanjang. 2 yang sebenarnya (of truth). 3 terhunus (of sword). n. eye mata biasa.
nakedness	kb. ketelanjangan, keadaan telanjang.
namby-pamby	ks. (berlaku) lemah.
name	kb. 1 nama. first n. nama sebutan/kecil. 2 tokoh. 3 reputasi.4 istilah, sebutan. -kkt. 1 memberi nama (pada), menamai. 2 menyebut(kan). 3 mengatakan. -name-calling kb. saling mengata-ngatai.
nameless	ks. tak dikenal. n. grave kuburan tanpa nama. a lady who shall remain n. seorang wanita yang tak mau disebut namanya.
namely	kk. yaitu, yakni.
nameplate	kb. papan/pelat nama.
namesake	kb. senama (of dengan).
nanny	kb. (j. -nies). n. goat kambing betina.
nap	kb. 1 tidur sebentar (di siang hari). 2 bulu-bulu halus dan pendek pada permukaan kain. -kki. (napped) tidur sebentar. to catch s.o. napping menangkap seseorang selagi ia lengah.
napalm	kb. 1 bahan kimia untuk membuat bensin kental. 2 mil.: bensin kental untuk bom pembakar.
nape	kb. kuduk, tengkuk.
naphtha	kb. nafta.
napkin	kb. serbet (dari kain/kertas).
narcissism	kb. kecintaan pada diri sendiri.
narcissus	kb. semacam bunga bakung.
narcosis	kb. pembiusan, narkosis.
narcotic	kb. bahan-bahan pembina, obat bius. n. addict seorang yang ketagihan obat bius.
narrate	kkt. menceritakan.
narration	kb. 1 penceritaan, pengisahan. 2 cerita, kisah.
narrative	kb. cerita. n. style gaya cerita.
narrator	kb. 1 pembawa cerita. 2 orang yang bercerita.
narrow	kb. narrows j. bagian sempit (dari sungai, selat). -ks. 1 sempit (of a road, path, house, room). 2 terbatas. 3 seksama. 4 tipis. -kkt. 1 membatasi (a subject, time). 2 memperkecil (the number of s.t.). -kki. menyempit (of a road). -narrowly kk. nyaris.
nasa	[national aeronautics and space administration] kb. biro penerbangan dan ruang angkasa nasional.
nasal	kb. bunyi sengau. -ks. 1 sengau. his voice has a n. twang ia bersuara sengau. 2 yang berhubungan dengan hidung. n. cavity rongga hidung.
nasalization	kb. persengauan.
nascent	ks. mulai timbul/lahir.
nastiness	kb. 1 kemesuman (of o's mind). 2 keburukan, kejahatan.
nasty	ks. 1 buruk (of weather). 2 sangat tidak menyenangkan (of a situation). 3 mesum (of a thought). 4 keji (of remark). 5 yang menjijikkan (of medicine). 6 kotor (of a room). 7 parah.
nat.	1 [national] nasional. 2 [natural] alamiah.
natal	ks. yang berhubungan dengan kelahiran. n. home tempat kelahiran.
natch	kk. sl.: tentu saja.
nation	kb. bangsa. nation-state negara berbangsa tunggal.
national	kb. warganegara. -ks. 1 nasional. n. debt hutang nasional. 2 kebangsaan. n. anthem lagu kebangsaan. -nationally kk. mengenai seluruh negara.
nationalism	kb. nasionalisme.
nationalist	kb. seorang nasionalis. -ks. nasionalis. the n. party partai nasional (is). n. china tiongkok/cina kuomintang.
nationalistic	ks. kebangsaan.
nationality	kb. (j. -ties) kebangsaan.
nationalization	kb. nasionalisasi.
nationalize	kkt. menasionalisasikan.
nationhood	kb. kedudukan sebagai negara merdeka.
nationwide	ks. nasional, untuk seluruh negara.
native	kb. penduduk asli, orang pribumi. -the natives j. orang-orang pribumi, penduduk asli. -ks. 1 asli. 2 asli, ibu. 3 alam (iyah). 4 asal. 5 (pem) bawaan dari lahir. to go n. hidup sebagai penduduk asli. native-born ks. kelahiran asli.
nativity	kb. (j. -ties) the n. kelahiran kristus.
natl.	[national] nasional, kebangsaan.
nato, n.a.t.o	[north atlantic treaty organization] organisasi pertahanan atlantik utara.
natty	ks. rapi. -nattily kk. dengan rapi, necis. n. dressed berdandan rapi.
natural	kb. kelaziman, kebiasaan. -ks. 1 alam. 2 alamiah. 3 dasar. 4 wajar (death, right). n. manner tingkah laku yang tidak dibuat-buat. natural-born ks. dilahirkan dengan bakat. -naturally kk. 1 tentu saja. 2 asli. n. curly lahir keriting rambut yang asli.
naturalist	kb. penyelidik alam.
naturalization	kb. naturalisasi, pewarganegaraan.
naturalize	kkt. memperwarganegarakan, menaturalisasikan. naturalized citizen warganegara (asing) yang telah menerima kewraganegaraan.
naturalness	kb. kewajaran, sifat yang bersahaja, lugunya.
nature	kb. 1 sifat (of a problem). 2 alam(raya). 3 sifat-dasar. by n. pada dasarnya.
naught	kb. = nought.
naughtiness	naughtiness
naughty	ks. nakal. -naughtily kk. dengan nakalnya.
nausea	kb. muak, kemuakan.
nauseate	kkt. memuakkan. -nauseating ks. yang memuakkan.
nauseous	ks. memuakkan.
nautical	ks. yang berhubungan dengan laut, nautika. n. chart peta laut.
naval	ks. yang berhubungan dengan laut. n. academy akademi angkatan laut.
nave	kb. bagian tengah dari ruang gereja.
navel	kb. pusat, puser.
navigable	ks. 1 dapat dilayari (of a river). 2 dapat dikemudikan (of a ship).
navigate	kkt. melayari. -kki. mengemudikan.
navigation	kb. ilmu pelayaran/bahari, navigasi. inland n. pelayaran dalam negeri.
navigational	ks. yang berhubungan dengan pelayaran. n. aids alat-alat pembantu navigasi.
navigator	kb. pengemudi kapal, muallim, ahli navigasi.
navy	kb. (j. -vies) angkatan laut. n. blue biru laut. n. yard penataran al.
nay	kb. suara tidak setuju.
nbc	[national broadcasting company] maskapai penyiaran nasional.
ne'er	= never. ne'er-do-well kb. orang yang gagal dalam segala-galanya.
neap	ks. n. tide air perbani.
near	ks. dekat. -kk. to get n. mendekati. to come n. mendekati. -kd. dekat. -kkt. mendekati. -kki. mendekat, menjelang. n. miss hampir kena. near-sighted ks. mata ayam. -nearly kk. hampir.
nearby	ks. dekat. n. area daerah dekat. -kk. dekat. to live n. tinggal dekat. -kd. dekat. to live n. the park tinggal dekat taman.
nearness	kb. dekatnya.
neat	ks. 1 rapi. n. job pekerjaan yang rapi. 2 murni. n. gin sopi murni. -neatly kk. dengan rapi. to be n. dressed berpakaian rapi.
neatness	kb. 1 kerapian. 2 kebersihan.
neb.	[nebraska] negarabagian a.s.
nebula	kb. (j. -lae, las) sekelompok bintang di langit yang nampak seperti kabut bercahaya.
nebulous	ks. samar-samar, remang-remang.
necessary	kb. (j. -ries) kebutuhan, keperluan. -ks. 1 perlu. 2 penting, perlu. 3 seperlunya. -necessarily kk. perlu.
necessitate	kkt. mengharuskan.
necessity	kb. (j. -ties) 1 keperluan. 2 kebutuhan, keperluan. in case of n. kalau perlu. of n. karena terpaksa.
neck	kb. leher (of the body, of a bottle). 2 lajuran (of land). -kki. sl.: berpeluk-pelukan. neck-breaking ks. kegila-gilaan. -necking kb. berpeluk-pelukan.
neckband	neckband
necklace	kb. kalung.
neckline	kb. garis leher.
necktie	kb. dasi.
neckwear	kb. dasi, kerah dll.
necrology	kb. (j. gies) 1 berita kematian. 2 daftar kematian.
necromancer	kb. ahli nujum (dengan bantuan arwah-arwah).
nectar	kb. 1 minuman sangat lezat. 2 minuman para dewa.
nee	ks. nama keluarga waktu gadisnya.
need	kb. keperluan, kebutuhan. her needs are few kebutuhannya sedikit. to have n. of perlu, memerlukan. if n. be kalau pelu. -kkt. memerlukan, membutuhkan. -kki. harus.
needful	kb. barang yang diperlukan. to do the n. membuat yang diperlukan saja.
needle	kb. (sewing, hypodermic, phonograph) jarum. inf.: to give s.o. the n. mendorong/mendesak seseorang. -kkt. mengganggu, menggoda.
needless	ks. tiada gunanya. n. to say, i... tiada gunanya kukatakan....
needlework	kb. 1 pekerjaan jahit-menjahit. 2 jahit-jahitan.
needn't	[need not] lih need.
needs	kk. i must n. (or n. must) stay aku terpaksa harus tinggal.
needy	needy
nefarious	ks. jahat, keji.
neg.	[negative] negatip.
negate	kkt. meniadakan.
negation	kb. 1 peniadaan (of o's freedom). 2 gram.: kata ingkar. 3 (denial) sangkalan.
negative	kb. 1 negatip. 2 phot.: gambar negatip. to answer in the n. menjawab tidak. -ks. negatip.
neglect	kb. penyia-nyiaan, penggabaian, kelalaian, kealpaan. -kkt. melalaikan, mengabaikan. -neglected ks. dilalaikan, dilupakan, tak dipelihara. he feels n. ia merasa dilalaikan.
neglectful	ks. lalai, alpa, sembrono.
negligee	kb. semacam pakaian rumah untuk wanita.
negligence	kb. kealpaan, kelalaian, kesembronoan.
negligent	ks. lalai, alpa, sembrono.
negligible	ks. tak berarti, dapat ditiadakan, sepele, dapat diabaikan.
negotiate	kkt. 1 memperundingkan, merundingkan (a treaty). 2 mengatasi, menjalani (a road). 3 mengadakan (a contract, loan). -kki. berunding, berembuk.
negotiation	kb. perundingan. under n. sedang dalam perundingan
negotiator	kb. perunding, pemusyawarat.
negress	kb. wanita negro.
negro	kb. orang negro. -ks. negro.
neigh	kb. ringkik(an). -kki. meringkik.
neighbor	kb. tetangga. n. republic republik tetangga. love thy n. cintailah sesamamu.
neighborhood	kb. lingkungan. in the n. of 1 didekat, disekitar. 2 kira-kira, kurang lebih.
neighboring	ks. yang berdekatan. n. city kota yang berdekatan.
neighborliness	kb. keramah-tamahan.
neighborly	ks. ramah, baik hati.
neither	ks. tak ada. -kg. tiada seorangpun. -ksamb. baik.. maupun.
nemesis	kb. (j. -eses) pembalasan keadilan.
neologism	kb. 1 pembentukan kata baru. 2 kata baru.
neon	kb. neon, tl. n. light lampu neon/tl.
neophyte	kb. orang baru.
nepalese	kb. orang nepal. -ks. yang berhubungan dengan nepal.
nepali	kb. bahasa nepal.
nephew	kb. kemenakan laki-laki.
nephritis	kb. radang buah pinggang.
nepotism	kb. mendahulukan sanak saudaranya sendiri khususnya dalam pemberian jabatan.
nerve	kb. 1 (urat) syaraf. 2 keberanian. 3 kelancangan. -nerves j.: 1 kegelisahan. 2 gangguan urat syaraf. -kkt. to n. o.s. memberanikan/meneguhkan hatinya. nerve-wracking ks. yang mengganggu urat syaraf, yang mengerikan, menggelisahkan.
nervous	ks. 1 gelisah, gugup. 2 takut. to be n. about staying alone takut untuk tinggal sendirian.
nervy	ks. 1 kasar, kurang sopan. 2 berani.
nest	kb. 1 sarang, petarangan. 2 sekumpulan (of tables). -kki. bersarang. to feather o's n. mendapatkan/menggunakan kesempatan untuk menjadi kaya. n. egg simpanan, tabungan, cadangan.
nestle	kkt. mendekapkan, memperdekapkan (a child/kitten in o's arms). -kki. 1 mendekap (in s.o's arms). 2 membaringkan diri (under the bed covers).
net	kb. 1 (fish, lifesaving) jala. 2 (tennis, butterflay) jaring-jaring. 3 rajut-rambut. 4 jaringan (spread by police). 5 keuntungan. -ks. bersih. netto. -kkt. (netted) 1 menerima bersih. 2 (catch) menangkap. 3 tenn.: memukul bola tenis ke jaring- jaring.
neth.	[netherlands] negeri belanda.
nether	ks. bawah.
netherlander	kb. orang belanda.
netherlands	kb. negeri belanda.
nettle	kb. jelatang. -kkt. membakar/melukai hati.
network	kb. jaringan. n. of roads jaring-jaring, jaringan jalan-jalan. jalanan.
neuralgia	kb. sakit syaraf.
neuritis	kb. radang urat syaraf.
neurologist	kb. ahli syaraf.
neurology	kb. ilmu sakit syaraf.
neurosis	kb. sakit syaraf.
neurosurgery	kb. pembedahan urat syaraf.
neurotic	kb. penderita sakit urat syaraf. -ks. yang menderita gangguan emosi/perasaan.
neut.	[neuter] netral.
neuter	kb. kata yang bersifat netral. -ks. netral. n. pronoun kata pengganti yang netral. n. gender jenis netral.
neutral	kb. 1 orang yang netral. 2 negeri yang netral. -ks. 1 netral. n. stand pendirian netral. 2 murni, netral (of color).
neutralism	kb. netralisme.
neutralist	kb. netralis, penganut poitik bebas.
neutrality	kb. kenetralan.
neutralize	kkt. 1 menetralkan. 2 menawarkan (an acid).
never	kk. tak pernah. he n. said a word about leaving ia tak mengatakan suatu apapun bahwa ia akan pergi. n. again tak pernah lagi. n. yet belum pernah.
nevermore	kk. tak lagi.
nevertheless	kk. namun, meskipun begitu/demikian.
new	kb. yang baru. -ks. baru. n. person orang baru. -newly kk. baru.
newborn	ks. baru lahir.
newcastle	kb. to carry coals to n. membuang garam ke laut.
newcomer	kb. pendatang baru, orang yang baru datang.
newf.	[newfoundland] nama pulau dekat pantai timur kanada.
newfangled	ks. model atau buatan baru.
newlywed	kb. pengantin baru. -newlyweds j. jodoh yang baru kawin.
newness	kb. sifat/corak baru.
news	kb. kabar, berita, warta. n. gets around fast berita cepat tersiar. n. conference konperensi pers.
newsboy	newsboy
newscast	kb. siaran warta-berita.
newscaster	kb. penyiar warta-berita.
newshawk	kb. inf.: wartawan.
newshen	kb. inf.: wartawati.
newsletter	kb. laporan berkala.
newspaper	kb. koran, surat kabar, harian.
newspaperman	kb. (j. -men) wartawan.
newspaperwoman	kb. (j. -woman) wartawati.
newsprint	kb. kertas koran.
newsreel	kb. pilem wartaberita.
newsroom	kb. ruang wartawan.
newsstand	kb. kios (koran, majalah).
newsworthy	ks. patut dijadikan berita.
newsy	ks. penuh dengan bermacam-macam berita (letter).
newt	kb. semacam kadal liar.
next	ks. 1 yang berikutnya. 2 lain. -kk. who comes n. ? giliran siapa sekarang ? -kd. disamping, disebelah. next-door ks. sebelah. n. of kin keluarga terdekat. n. year tahun depan y.a.d.
nibble	kb. 1 (a bite) gigit. 2 sambutan (from an ad). -kki. menggigit, mengungsi, menggerumis.
nice	ks. 1 baik. 2 baik/enak (of a meal). 3 senang. 4 menyenangkan. 5 bagus. 6 halus, renik (distinction). -nicely kk. baik, bagus.
nicety	kb. (j. -ties) hal yang tak menyenangkan. the niceties of civilization hal-hal yang menyenangkan dari peradaban.
niche	kb. 1 ceruk, relung. 2 tempat (in society).
nick	kb. taktik, toreh(an) (pada kayu). in the n. of time tepat pada waktunya. kkt. menakik.
nickel	kb. nikel,nekel. n. plate lembaran nekel.
nickname	kb. nama panggilan. -kk. memberi nama panggilan.
nicotine	kb. nikotin.
niece	kb. kemenakan perempuan.
nifty	ks. inf.: bagus, pesolek.
niggardly	ks. kikir, pelit.
nigh	kd., kk. dekat.
night	kb. malam. at n. pada malam hari, pada waktu malam. n. blindness buta ayam. n. clothes pakaian tidur. n. watch jaga malam. n. watchman (pen)jaga malam.
nightcap	kb. pici tidur. 2 inf.: minuman keras diminum sebelum tidur.
nightfall	kb. senjakala, waktu matahari terbenam.
nightgown	kb. gaun/baju tidur.
nighthawk	kb. inf.: orang yang tidur pada siang hari dan bekerja pada waktu malam.
nightie	kb.: pakaian tidur wanita atau anak-anak.
nightingale	kb. (burung) bulbul.
nightlong	ks. yang berlangsung sepanjang malam.
nightly	ks. tiap malam.
nightmare	kb. mimpi buruk, khayal yang mengganggu orang tidur. 2 penngalaman yang mengerikan.
nightmarish	ks. seperti mimpi buruk, mengerikan.
nightshirt	kb. baju tidur laki-laki.
nightstick	kb. tongkat polisi.
nightwear	kb. pakaian tidur.
nil	kb. nol, tiada artinya.
nimble	ks. cepat, cekatan, gesit. he has a n. mind pikirannya cepat. -nimbly kk. dengan genitnya.
nincompoop	kb. orang tolol.
nine	nine
nineteen	kb. sembilan belas.
nineteenth	ks. kesembilan belas.
ninetieth	ks. kesembilan puluh.
ninety	kb. (j. -ties) sembilan puluh. she's in her nities umurnya sembilan puluhan.
ninth	kb. persembilan. a n. sepersembilan. -ks. kesembilan.
nip	kb. 1 (bite) igigit. 2 sedikit minuman keras. -kkt. (nipped) 1 menggigit. 2 merusak (flowers). to n. off menggentas (flower, branch).
nipple	kb. 1 puting susu. 2 pentil, dot (of bottle).
nippy	ks. dingin.
nitpicking	kb. inf.: banyak rewel.
nitrate	kb. nitrat, garam asam sendawa.
nitric	ks. n. acid asam sendawa.
nitrogen	kb. zat lemas, nitrogen.
nitroglycerin	kb. nitrogliserin.
nitty-gritty	kb. sl.: kebenaran yang baru. 2 intisari.
nitwit	kb. inf.: orang dungu.
nix	kb. sl.: tidak apa-apa.
no	kb. jawaban tidak. -ks. 1 tidak. 2 bukan. -kk. tidak, enggak. -kg. no one tak seorangpun. inf.: no-account, no-good ks. tak berguna. sl.: no-no kb. tabu. no-nonsense ks. sungguh-sungguh, serius. no-trump kb., ks. san, tanpa kartu truf.
no.	[number] nomor.
nobility	kb. (j. -ties) kaum ningrat/bangsawan.
noble	kb. orang bangsawan. ks. 1 mulia. n. dead perbuatan yang mulia. 2 ningrat. of n. birth keturunan ningrat. -nobly kk. mulia, tinggi budi.
nobleman	kb. (j. -men) orang bangsawan.
nobody	kb. (j. -dies) seorang yang tak berarti. i knew him when he was n. saya kenal dia waktu waktu ia belum jadi apa-apa. -kg. tak seorangpun.
noctural	ks. pada malam hari.
nod	kb. angguk(an), tanda setuju. -kkt. (nodded) menganggukkan(o's head). -kki. 1 menggangguk. 2 mengantuk (from drowsiness). to n. to memberi isyarat kepada, mengangguk.
noise	kb. 1 gaduh, riuh. 2kegaduhan (in the transmission). 3 bunyi. -kkt. menyiarkan.
noiseless	ks. tak bersuara/berbunyi.
noisy	ks. 1 ribut, gaduh (ofchildren). 2 sangat ramai (of a street). the engine in my car is unusually n. berisik/ramai benar mesin mobil saya ini.
nomad	kb. pengembara (dari suku pengembara).
nomadic	ks. sebagai pengembara. n. life hidup mengembara.
nomenclature	kb. tatanama.
nominal	kb. kata benda. -ks. 1 nominal. n. price harga yang nominal. 2 pada namanya saja.
nominate	kkt. 1mencalonkan (for the presidency). 2 menunjuk, mengangkat.
nomination	kb. 1 pencalonan. 2 pengangkatan, penunjukan.
nominative	kb. kasus nominatif. -ks. nominatif.
nominee	kb. calon.
nonaggression	kb. non-agresi, tidak menyerang. n. pact persetujuan non-agresi.
nonalcoholic	ks. tanpa alkohol (of a drink).
nonaligned	ks. non-blok, tak berpihak.
nonalignment	kb. hal tak berpihak, non-blok. n. policy politik tidak berpihak.
nonarrival	kb. ketidakdatangan.
nonce	kb. for the n. untuk kali/kesempatan ini. n. word sebuah kata yang hanya sekali dipakai.
nonchalance	kb. sikap tak ambil pusing, keteledoran.
nonchalant	ks. tak perduli, tak ambil pusing, teledor, acuh-tak-acuh.
noncom	kb. inf.: bintara.
noncombatant	kb. orang yang tak ikut berperang.
noncombustible	ks. tahan api.
noncommissioned	ks. n. officer bintara.
noncommittal	ks. tidak menyatakan pendapat.
nonconformist	kb. yang tak suka menuruti adat, yang tak patuh pada norma-norma sosial.
nondescript	ks. tak termasuk sesuatu jenis tertentu.
none	kg. 1 tak seorangpun. 2 tak satupun. 3 tak samasekali. -kk. samasekali tidak.
nonentity	kb. (j. -ties) seorang yang tak berarti.
nonessential	ks. yang tak perlu/penting.
nonetheless	kk. 1 meskipun demikian/begitu. 2 namun. he was n. a good player namun ia seorang pemain yang baik.
nonexistent	ks. hampa, kosong, khayali.
nonfiction	kb. cerita nyata, cerita yang sesungguhnya.
nonflammable	ks. yang tidak dapat menyala.
nonglare	ks. anti-silau (of headlihgts).
nonintervention	kb. non-intervensi, tak campur tangan.
nonliving	ks. tidak hidup.
nonmember	kb. bukan anggauta.
nonnegotiable	ks. tak dapat diperbincangkan (of demands).
nonpartisan	ks. 1 tak memihak. 2 tak berpartai.
nonpayment	kb. tak membayar.
nonplus	kkt. membuat heran, tercengang. he was nonplused for an answer ia tercengang tak dapat menjawab apa-apa.
nonproductive	ks. tak produktip.
nonprofit	ks. yang tak mencari keuntungan (of an organization).
nonprofitmaking	ks. yang tak mencari keuntungan (of an organization).
nonresident	kb., ks. yang tidak bertempat tinggal.
nonscheduled	ks. diluar acara, tak masuk acara (stop). n. airline lin penerbangan tanpa jadwal waktu.
nonsectarian	ks. yang tidak mengikuti suatu aliran agama.
nonsense	kb. omong kosong. to talk n. bercakap omong kosong (belaka).
nonsensical	ks. yang bukan-bukan. n. question pertanyaan yang bukan-bukan.
nonskid	ks. anti-selip (of tires).
nonsmoker	kb. orang yang tidak merokok.
nonstop	ks. tanpa berhenti, nonstop. n. flight penerbangan tanpa berhenti. -kk. terus-menerus. to fly n. terbang terus- menerus.
nonsupport	kb. tak memberi jaminan penghidupan.
nontoxic	ks. yang tak beracun.
nonunion	ks. tidak mengakui serikat buruh.
nonviolence	kb. tanpa kekerasan.
nonwhite	kb. orang yang bukan kulit putih.
noodle	kb. ba(k)mi, mi. 2 sl.: kapala.
nook	kb. sudut. nooks and crannies sudut dan celah. 2 tempat kesukaan. shady n. tempat bersembunyi yang naung/rindang.
noon	kb. tengah hari. at n. pada tengah hari.
noontime	kb. waktu tengah hari.
noose	kb. jerat, simpul.
nope	kk. inf.: nggak, ndak, kagak.
nor	ks. 1...maupun,...tidak. 2 pun. he has never been there, n. can i get him to go ia belum pernah kesana, dan akupun tak mengajaknya pergi. lih neither.
norm	kb. norma.
normal	ks. normal. 2 biasa. n. school sekolah guru. -normally kk. biasanya.
north	kb. utara. -ks. utara. n. wind angin dari utara. -kk. ke utara. to go n. pergi ke utara. n. of disebelah utara dari.
northeast	ks. timurlaut.
northeasterly	ks. dari timurlaut.
northerly	ks. dari utara.
northern	ks. utara, yang di utara. n. lights cahaya (dari arah) utara.
northerner	kb. orang dari utara.
northernmost	ks. paling utara.
northward	ks. ke utara.
northwest	ks. baratlaut.
northwesterly	ks. dari baratlaut.
nortw.	[norway] norwegia. 2 [norwegian] yang berhubungan dengan norwegia.
norwegian	kb. orang norwegia. 2 bahasa norwegia. -ks. yang berhubungan dengan norwegia.
nose	kb. hidung (person, plane). -kkt. 1 mendorong. 2 membelai (of a cat). -kki. maju perlahan-lahan. to n. out 1 mengalahkan dengan tipis. 2 mencari-cari, menemukan. n. cone kerucut hidung, moncong roket (pada peluru kendali).
nosebleed	kb. mimisan.
nosey	ks. = nosy.
nostalgia	kb. rasa rindu, keibuan (hati), nostalgi.
nostalgic	ks. rindu, rawan, kangen.
nostril	kb. lubang/cuping hidung.
nostrum	kb. obat ajaib.
nosy	ks. 1 ingin tahu. 2 ingin mencampuri.
not	kk. (kep. -n't) 1 tidak, tak. i'm n. going saya tak akan pergi. 2 bukan. 3 jangan. he asked me n. to go ia meminta saya supaya jangan pergi. n. at all sama sekali tidak, sekali-kali tidak. n. yet belum. n. including belum termasuk.
notable	kb. orang terkemuka, tokoh. -ks. terkemuka. -notably kk. khususnys.
notarize	kkt. mensyahkan (oleh notaris).
notary	kb. (j. -ries) notaris. n. public notaris.
notation	kb. 1 angka-angka. 2 cara menulis. 3 catatan.
notch	kb. 1 taktik. 2 derajad. set the thermostat a n. higher pasanglah alat pengimbang panas itu sederajat lebih tinggi. -kkt. 1 menakik, membuat takik. 2 mencatat.
note	kb. 1 catatan. 2 surat. 3 fin.: surat hutang (at the bank). 4 nada. 5 fin.: uang kertas. 6 nota. 7 surat pendek, katabelece. of n. penting, terkemuka. to take n. of memperhatikan. -kkt. 1 memperhatikan. 2 melihat. n. paper kertas tulis.
notebook.	kb. buku agenda/catatan/notes.
noteworthy	ks. penting, patut diperhatikan.
nothing	kb. tidak ada apa-apa. n. but tak lain hanya. n. less than tak kurang dari n. like tak ada lagi (seperti, serupa). n. more than tak lain hanya. to think n. of menganggap tidak penting.
notice	kb. 1 pembentukan, maklumat, pengumuman. 2 (review) ulasan. 3 perhatian. 4 peringatan. to give n. memberitahu, memperingatkan. -kkt. memperhatikan, melihat.
noticeable	ks. nyata, kelihatan. -noticeably kk. nyata, tampak, kelihatan dengan jelas.
notification	kb. pemberitahuan, pengumuman.
notified	lih notify.
notifies	lih notify.
notify	kkt. (notified) memberitahu(kan).
notion	kb. 1 dugaan. 2 ide, gagasan. 3 pikiran. 4 pikiran, maksud. -nations j. barang kelontong.
notoriety	kb. (j. -ties) kemasyhuran (karena sesuatu yang kurang baik).
notorious	ks. terkenal karena nama buruk. -notoriously kk. terkenal. n. cruel towards terkenal kejamnya terhadap.
notwithstanding	kd. meskipun. he went n. the cold ia berangkat juga meskipun dingin. -kk. sekalipun demikian.
nought	kb. nol (0). all my work was for n. seluruh pekerjaanku adalah sia-sia.
noun	noun
nourish	kkt. 1 memberi makan(an). 2 memelihara (the hope). -nourishing ks. mengandung makanan bergizi.
nourishment	kb. makanan.
nouveau riche	orang kaya baru, okabe.
nov.	[november] bulan nopember.
novel	kb. (cerita) roman. -ks. baru (idea).
novelist	kb. pengarang cerita roman.
novelty	kb. (j. -ties) 1 sesuatu yang baru. 2 kesenangan baru (of helping mother)
november	kb. bulan nopember.
novice	kb. orang baru.
novitiate	kb. 1 rel.: calon biarawan/biarawati. 2 masa percobaan.
now	kb. waktu sekarang/ini. -kk. 1 sekarang, kini. 2 adapun. 3 nah. n. again sekali-sekali, kadang-kadang. -ksam. n. that sejak.
nowadays	kk. pada waktu sekarang.
nowhere	kb. tidak dimanapun juga. -kk. tidak... dimanapun juga.
nowise	kk. bagaimanapun tidak, sekali-kali tidak.
noxious	ks. berbahaya, berbisa (gas, fumes).
nozzle	kb. 1 mulut pipa. 2 pipa semprot, alat pemercik.
nt. wt.	[net weight] berat bersih/netto.
nth	ks. sehabis-habis. to the n. degree tidak terbatas angkanya.
nuance	kb. perbedaan yang sangat sedikit, nuansa.
nub	kb. inti(sari) (persoalan).
nubile	ks. yang sudah boleh kawin (anak perempuan).
nuclear	ks. nuklir. n. reactor. reaktor nuklir.
nucleus	kb. 1 permulaan. 2 dasar, inti, pangkal.
nude	kb. orang telanjang. in the n. dengan telanjang bulat. -ks. telanjang.
nudge	kb. sentuhan, dorongan. -kkt. 1 menyentuh, menyinggung. 2 membangkitkan (memory ingatan).
nudist	kb. anggauta perkumpulan hidup telanjang.
nudity	kb. (j. -ties) ketelanjangan.
nugget	kb. 1 gumpal (emas). 2 bungkah, bungkal (wisdom ilmu).
nuisance	kb. gangguan, susah. ties are a n. dasi menyusahkan.
null	ks. 1 batal. the marrieage was legally n. perkawinan itu secara hukum batal. 2 tidak ada. the effect was n. hasilnya tak ada.
nullify	kkt. (nullified) menghapuskan, meniadakan.
num.	1 [number] nomor. 2 [numeral] angka.
numb	ks. 1 mati rasa, kebas (of hands). 2 kaku. n. with fear kaku karena takut.
number	kb. 1 nomor, bilangan. 2 eceran, terbitan (of a periodical). 3 hidangan, lagu. -numbers j. 1 ilmu berhitung. 2 banyak. -kkt. 1 menomori. 2 berjumlah. 3 menganggap.
numbness	kb. kematian rasa.
numeral	kb. 1 angka. arabic n. angka arab. 2 sport : tanda nomor.
numerator	kb. 1 penghitung. 2 math.: pembilang.
numerical	ks. menurut angka. in n. order menurut urutan angka.
numerous	ks. banyak.
numismatics	kb. pengetahuan atau cara-cara pengumpulan mata uang.
numskull	kb. inf.: orang tolol.
nun	nun
nuptial	ks. yang berhubungan dengan perkawinan. n. party iringan perkawinan. -nuptials kb., j. upacara perkawinan.
nurse	nurse
nursemaid	kb. babu anak.
nursery	kb. (j. -ries) 1 kamar anak-anak. n. rhyme sajak kanak-kanak. n, school taman kanak-kanak/inderia. 2 agry.: kebun bibit.
nurture	kb. pengasuhan, pemeliharaan. -kkt. 1 menaruh (resentment). 2 memelihara, mengasuh.
nut	kb. 1 kacang-kacangan, biji-bijian. 2 mur (for a bolt). 3 orang aneh/gila. he's a real n.! ia betul-betul sinting. to be nuts about a) kegila-gilaan tentang. b) suka benar pada.
nutcracker	kb. alat pemecah biji-bijian yang keras.
nutmeg	kb. pala.
nutrient	kb. bahan gizi.
nutritionist	kb. ahli (ilmu) gizi.
nutritious	ks. bergizi.
nutritive	ks. bergizi.
nutshell	kb. kulit kacang. in a n. singkatnya.
nutty	ks. 1 yang mengandung kacang-kacang. 2 sl.: yang merasa seperti kacang-kacangan. he does the nuttiest things ia berlaku sangat kegila-gilaan.
nuzzle	kki.,kki. menyondol, menyerodok (up against, up to pada).
nw	[northwest] barat laut.
nylon	kb. nilon. -nylons j. kauskaki. nilon.
nymph	kb. bidadari, peri.
o	kseru. he, hai, wahai.
o'clock	jam, pukul. at 7 o. pukul tujuh.
o'er	= over.
o, o	kb. 1 huruf kelimabelas dari abjad inggeris. 2 nol.
o.	1 [ohio] negarabagian a.s. 2 [ocean] lautan, samudra. 3 [ontario] propinsi di kanada selatan.
o.k.	kb. inf.: persetujuan, kebenaran. to put o's o.k. on s.t. memberi acece kepada sesuatu. -ks. it's o.k. with me saya setuju. saya tak apa-apa. -kkt. menyetujui, meng-oke-kan. -kseru. baiklah, oke, jadi.
o.t.	[old testament] perjanjian lama, taurat.
oak	kb. (pohon) ek.
oaken	ks. dibuat dari kayu ek.
oar	kb. dayung, kayuh. to put o's o. in mencampuri urusan orang lain.
oarsman	kb. (j. -men) pendayung, pengayuh, tukang satang.
oas	[organization of american state] organisasi negara-negara amerika.
oasis	kb. (j. -ses) 1 geog.: wahah. 2 sumber ketenangan.
oat	kb. sejenis gandum. inf.: to feel o's oats mulai bersemangant. to sow o's (wild) oats berfoya-foya, main ugal-ugalan.
oath	kb. 1 sumpah. to take an o. bersumpah, mengangkat sumpah. 2 kata umpatan (curse).
oatmeal	kb. 1 makanan gandum. 2 bubur gandum.
obdurate	ks. keras kepala, bandel.
obedience	kb. kepatuhan, ketaatan.
obedient	ks. patuh, taat, penurut. to be o. to s.o. patuh kepada seseorang.
obeisance	kb. hormat (dengan membungkukkan badan, sembah. to make/pay o. to s.o. menyembah kepada seseorang.
obelisk	kb. tugu.
obese	ks. gemuk sekali, gendut.
obesity	kb. kegemukan, kegendutan.
obey	kkt. mematuhi, mentaati, menurutkan. to o. the instructions taat kepada perintah itu. -kki. penuh, taat.
obituary	kb. (j. -ries) berita kamatian.
obj.	[object] 1 obyek. 2 barang.
object	kb. 1 benda, obyek, barang. 2 sasaran, tujuan. 3 maksud (of a conversation). 4 gram.: pelengkap. -kki. menolak, keberatan.
objection	kb. keberatan. do you have any o. ? apa saudara berkeberatan ?
objectionable	ks. tidak dapat disetujui. an o. person seorang yang tidak nmenyenangkan. he uses o. language tata-bahasanya kasar.
objective	kb. tujuan, sasaran. -ks. obyektif, tidak berat-sebelah. -objectively kk. secara obyektif.
objectivity	kb. keobyektifan.
objector	kb. seorang yang menolak. lih conscientious.
obligate	kkt. wajib, harus. he is obligated to help dia berkewajiban membantu.
obligation	kb. kewajiban. you are under no o. saudara tak ada kewajiban apa-apa.
obligatory	ks. wajib. o. attendance kehadiran wajib.
oblige	kkt. 1 mengharuskan. 2 membantu. -kki. membantu, melayani. -obliging ks. bersedia membantu, menurut.
oblique	ks. 1 miring, mencong. o. angle sudut miring. 2 tak langsung.
obliterate	kkt. menghapuskan, melenyapkan.
obliteration	kb. kehilangan, kemusnahan.
oblivion	kb. pelupaan. to sink into o. dilupakan.
oblivious	ks. terlupa. o. to o's surroundings terlupa akan sekitarnya.
oblong	ks. bujur.
obnoxious	ks. menjengkelkan, buruk, menjijikkan.
oboe	kb. obo (semacam suling).
obscene	ks. cabul, carut. o. literature pembacaan cabul.
obscenity	kb. (j. -ties) kecabulan, kecarutan.
obscure	ks. 1 tak jelas (of plans, style). 2 tak dikenal (of birth, family). -kkt. 1 menggelapkan (o's view). 2 mengaburkan (the meaning).
obscurity	kb. (j. -ties) 1 ketidak-jelasan (of a passage). 2 keadaan tidak dikenal. to go into o. menjadi tak dikenal.
obsequies	kb. j. (upacara) pemakaman, penguburan.
observable	ks. kelihatan, tampak.
observance	kb. 1 ketaatan (of the law). 2 ibadat (of lent).
observant	ks. 1 suka memperhatikan. 2 taat, setia.
observation	kb. 1 pengamatan, observasi. 2 pandangan. 3 pengawasan. o. station tempat peninjauan/pemandangan.
observatory	kb. (j. ries) observatorium.
observe	kkt. 1 mengamati (a patient). 2 melihat. 3 meninjau (a class). 4 menjalankan (lent). 5 mematuhi. 6 memperhatikan. 7 menghormat.
observer	kb. 1 peninjau. 2 pemerhati, orang yang memperhatikan. 3 pengamat.
obsess	kkt. 1 menghantui, menggoda (pikiran). 2 memasuki (of a spirit).
obsession	kb. 1 godaan, gangguan pikiran, obsesi. 2 kesurupan/kemasukan setan.
obsolescence	kb. keusangan, kekunoan.
obsolescent	ks. usang, sudah tidak terpakai lagi.
obsolete	ks. usang, tidak terpakai, kuno.
obstacle	kb. rintangan, halangan, penghambat. to put obstacles in s.o.'s way memasang/menempatkan rintangan di jalan seseorang.
obstetrician	kb. dokter perbidanan/melahirkan, dokter dalam ilmu kebidanan.
obstetrics	kb. ilmu kebidanan.
obstinacy	kb. (j. -cies) ketegaran, sifat membandel, sifat keras kepala.
obstinate	ks. keras kepala, tegal, kepala batu, bandel, menekat. 2 terus-menerus (of a cold).
obstreperous	ks. ribut, bising.
obstruct	kkt. menghalangi, merintangi (a view, a street, traffic).
obstruction	kb. 1 halangan. 2 gangguan. o. of the bowels sembelit, kesukaran membuang air besar, kesukaran berberak.
obtain	kkt. 1 mendapat(kan), memperoleh. 2 menghasilkan. -kki. berlaku.
obtainable	ks. dapat diperoleh/dibeli. are tomatoes o. at this time ? apakah ada tomat pada waktu ini ?
obtrude	kkt. mendesakkan (pendapatnya) (on kepada). to o. o.s. menonjolkan diri.
obtrusion	kb. penonjolan diri.
obtrusive	ks. yang menonjolkan.
obtuse	ks. 1 bodoh. 2 tumpul (of an angle).
obverse	ks. bagian depan, sebelah muka.
obviate	kkt. menyingkirkan, meniadakan (necessity keharusan).
obvious	ks. jelas, nyata, ternyata. o.remark perkataan yang wajar sekali. -obviously kk. dengan nyata, dengan jelas, tak pelak lagi.
occasion	kb. saat (for rejoicing). 2 kesempatan. 3 upacara. 4 peristiwa. 5 kejadian. 6 alasan. -kkt. menyebabkan, mendatangkan.
occasional	ks. 1 sekali-sekali, kadang-kadang. o. headaches sakit kepala sekali-sekali. 2 berkala. o. paper terbitan takberkala. -occasionally kk. adakalanya, kadang-kadang.
occident	kb. negeri barat.
occidental	occidental
occlusion	kb. keadaan kemacetan/macet. coronary a. kemacetan dalam urat nadi.
occult	ks. gaib. the o. sciences ilmu gaib/klenik.
occupancy	kb. (j.-cies) 1 pemilikan. 2 tindakan menginap. ready for immediate o. untuk segera ditempati.
occupant	kb. 1 penghuni. 2 penumpang. none of the cars occupants was hurt tiada seorangpun dari penumpang-penumpang mobil itu (mendapat) cedera.
occupation	kb. 1 pekerjaan, jabatan. 2 pendudukan (of a country). 3 okupasi, kesibukan.
occupational	ks. yang berhubungan dengan jabatan atau pekerjaan. o. hazard bahaya/risiko dalam pekerjaan.
occupied	lih occupy.
occupies	lih occupy.
occupy	kkt. (occupied) 1 menempati, mendiami (a hous, apartment). 2 menduduki (a country, seat of honor). 3 tinggal dalam (a single room). 4 memakan waktu. 5 mengisi ( o's leisure time). 6 mempergunakan (time, energy). 7 mengambil tempat. occupied ks. sibuk.
occur	kki. (occurred) 1 terjadi (of an accident). 2 terpikir oleh. 3 teringat. 4 terdapat 5 menjadi, datang.
occurrence	kb. kejadian, peristiwa storms are a frequent o. here angin ribut sering terjadi disini.
ocean	kb. lautan, samudera. o. bed/floor dasar laut. ocean-going vessel kapal laut.
oceanfront	kb. pantai, tanah sepanjang lautan.
oceanic	ks. 1 yang berhubungan dengan lautan. 2 yang berhubungan dengan oceania.
oceanography	kb. ilmu samudera.
ochre	kb. hartal, warna kuning tua, oker, warna boreh.
oct.	[october] bulan oktober.
octagon	octagon
octagonal	ks. bersegi delapan.
octane	kb. oktan.
octave	kb. oktaf.
october	kb. bulan oktober.
octogenarian	kb. seorang yang berusia 80 tahun.
octopus	kb. ikan gurita/mangsi.
oculist	kb. dokter/ahli mata.
odd	ks. aneh. 2 gasal, ganjil (number). 3 ekstra, smbilan, taktetap... 4 lebih dari. 5 terasing. 0dd-numbered ks. bernomor gasal. -oddly kk. aneh(nya).
oddball	kb. sl.: yang aneh, yang lain dari lainnya.
oddity	kb. (j. -ties) keanehan, sifat yang aneh.
odds	kb., j. rintangan. at o. bertengkar, berselisih. by all o.a) pasti, tanpa ragu-ragu. b). bagaimanapun. odds-on ks. yang mampunyai kemungkinan besar.
ode	kb. syair lyris/pujian.
odious	ks. membencikan, menjijikkan.
odium	kb. kebencian, kejijikan.
odor	kb. bau (busuk), hawa daba. to he in bad o. mendapat nama buruk.
odyssey	kb. pengembaraan, perjalanan penuh dengan petualangan.
oesophagus	= esophagus.
of	kd. 1 a glass of milk segelas susu. 2 dari. 3 kurang. 4 akan. 5 untuk. 6 karena. 7 diantara.
off	kb. mati (of a swich). -ks. 1 salah. 2 mati, putus (of electricity, water. 3 inf.: gila, miring. -kk. lagi. off-and-on ks. tak begitu tetap. off-balance ks., kk. jadi bingung, dalam keadaan terhuyung-huyung
off.	1 [officer] opsir, perwira. 2 [official] resmi. 3 [office] pejabat.
offal	kb. sampah, kotoran.
offbeat	kb. irama iringan. -ks. luar biasa, aneh, tak biasa.
offend	kkt. 1 menyakitkan hati, melukai hati/perasaan (a friend). 2 mengganggu (by smoking). -kki. melakukan kesalahan. -offending ks. yang bersalah.
offender	kb. 1 pelanggar. 2 orang yang bersalah, orang yang berdosa. the chief o. is smog pelanggaran utama adalah asbut (asap campur kabut dari paberik-paberik)
offense	kb. 1 luka perasaan, keadaan sakit hati. 2 serangan (army, sports). 3 pelanggaran. 4 kejahatan. to give o. menyakiti hati. to take o. merasa dihina (at karena).
offensive	kb. serangan. to take the o. menyerang, melakukan serangan. -ks. 1 menyakitkan hati, menghina (vulgar, insulting). 2 menusuk hidung. 3 tak sopan. 4 menjijikkan (of odor).
offer	kb. 1 tawaran, penawaran. 2 saran, usul. -kkt. 1 memberikan (a chair, money) (to kepada). 2 menawari, menawarkan. 3 memajukan (an opinion). 4 memanjatkan (a prayer).-kki. ada. -offering kb. 1 sumbangan. 2 (musical) persembahan.
offhand	ks., kk. begitu saja. o., i'd say... tanpa pikir panjang, saya dapat mengatakan....
office	kb. 1 kantor. the whole o. agreed with him segenap pegawai menyetujuinya. 2 jabatan. public o. jabatan pemerintah. 3 jasa. the good/kind offices jasa-jasa baik. o. hours jam kerja.
officeholder	kb. penjabat negeri.
officer	kb. 1 mil.: opsir, perwira. 2 police o. (agen) polisi. 3 pak (cara menegur anggota polisi). 4 pegawai negeri. 5 petugas.
official	kb. pegawai negeri. 2 (bank) pejabat. high officials pejabat-pejabat tinggi. -ks. resmi, opisi(i)l. -officially kk. secara resmi.
officialdom	kb. 1 staf pegawai. 2 administrasi.
officiate	kki. memimpin (at a meeting, ceremony).
officious	ks. suka mencampuri urusan orang.
offing	kb. in the o. dekat, sebentar lagi.
offprint	offprint
offset	kb. pengganti kerugian. o. process cetakan offset. -kkt. 1 menutup kerugian. 2 mengimbangi, memperseimbangi.
offshoot	kb. cabang. 2 bagian.
offshore	ks. jauh dari pantai, (di) lepas pantai. o. drilling pengeboran jauh dari pantai. o. breeze angin pantai.
offspring	kb. keturunan, anak-cucu.
often	kk. sering (kali), kerapkali, acapkali.
oftentimes	= often.
ogle	kkt. mengerling kepada, menjeling.
ogre	kb. gergasi, raksasa.
oh	kseru . o, aduh ! ah, masa ! oh my ! astaga ! to oh and ah over mengeluarkan kata-kata senang.
oil	kb. minyak, oli. -kkt. 1 memainyaki. 2 mengisi (a tannker). -oiled ks. sl.: mabuk.
oilcloth	kb. taplak yang dilapisi minyak atau cat.
oiler	kb. 1 kapal tangki. 2 tukang minyak mesin.
oilman	kb. (j. -men) karyawan dalam perusahaan tambang paberik atau penjualan minyak.
oilskin	kb. o. coat jas kain minyak.
oily	ks. 1 berminyak. o. rag lap yang berminyak. 2 licik, manis mulut.
oinment	kb. obat salep, urap.
okay	kb., ks., kseru. inf.: baik, jadi. -kkt. menyetujui.
okla.	[oklahoma] negarabagian a.s.
okra	kb. semacam kacang-kacangan.
old	kb. dahulu kala. -the old j. kaum tua. -ks. 1 tua. 2 lama. 3 kuno. old- timer kb. orang lama, pegawai kawakan. o. woman 1 perempuan tua. 2 isteri. 3 ibu. old-world ks. masa lampau.
olden	ks. kuno, dahulu. in o. days di zaman kuno.
oldie	kb. inf.: yang sudah lama dan terkenal.
oldster	kb. orang tua.
oleo	= oleomargarine.
oleomargarine	kb. margarine, mentega tiruan.
olfactory	ks. pencium. o. organ alat pencium.
oligarchy	kb. (j. -chies) oligarki, pemerintahan oleh kelompok kecil.
olive	kb. buah zaitun. o. oil minyak zaitun. o. baranch tanda damai.
olympiad	kd. olimpiade.
olympic	olympics kb., j. pertandingan olympiade. -ks. olympiade. the o. games pertandingan olympiade.
omelet(te)	kb. telur dadar. cheese o. telur dadar pakai keju.
omen	kb. pertanda, alamat. good o. pertanda yang baik.
ominous	ks. tak menyenangkan. the outlook is o. apa yang akan terjadi tampaknya tak menyenangkan.
omission	kb. penghilangan, kelalaian, tak dicantumkan. o. of the title was a mistake tidak dicantumkannya judul itu merupakan kesalahan.
omit	kkt. (omitted) 1 menghilangkan (a chapter, word). 2 mengabaikan. to o. to state o's reasons mengabaikan untuk menyatakan alasan-alasannya.
omnibus	kb. 1 (vehicle) bis penumpang. 2 kumpulan karangan. -ks. yang meliputi berbagai hal. o. bill rencana undang-undang yang meliputi berbagai hal.
omnipotence	kb. kemahakuasaan.
omnipotent	ks. mahakuasa.
omnipresent	ks. ada/hadir dimana-mana.
omniscient	ks. mahatahu, mahamengetahui.
omnivorous	ks. yang makan segala macam makanan. o. reader seorang yang membaca segala macam bahan bacaan.
on	ks. sedang berlangsung. -kd. 1 diatas. 2 di. 3 pada. 4 mengenai. 5 atas.6 tentang. 7 dengan. 8 dalam. 9 unutk. 10 demi. 11 disebelah 12 akan.
once	kb. suatu kejadian/waktu. -kk. 1 sekali. 2 pernah. -ksam. segera sesudah. once-over kb. pandangan sekilas-lintas, periksa sepintas-lalu.
oncoming	ks. yang mendekat (train, traffic, storm).
one	kb. 1 satu. sama. 2 orangnya. -ks. 1 se-. 3 satu. 4 suatu. -kg. seorang. one-armed ks. seorang yang hanya bertangan satu. one-eyed ks. bermata sebelah, bermata satu. one-horse ks. berkuda seekor. one- legged ks. yang berkaki-satu. one-man ks. seorang.
oneness	kb. keesaan, keutuhan. o. of god tauhid.
onerous	ks. berat, sukar.
oneself	lih self.
onetime	ks. dulu, dahulu. he is a o. actor dulu dia seorang pemain.
ongoing	ks. terus-menerus, tanpa berhenti. an o. operation aktivitas yang dilakukan terus-menerus.
onion	kb. bawang, bakung.
onionskin	kb. kertas dorslah/kaca/minyak.
onlooker	kb. penonton.
only	ks. 1 satu-satunya. 2 tunggal. -kk. hanya. if o. seandainya.
onomatopoeia	kb. bentuk kata menirukan sesuatu bunyi, pembentukan kata yang meniru suara.
onrush	kb. deru laju, gerak deras suatu arus.
onrushing	ks. bergerak maju dengan cepat.
onset	kb. 1 serangan, serbuan. 2 permulaan. at the o. pada mulanya.
onslaught	kb. serangan gencar.
onstage	ks., kk. diatas pentas/panggung.
ont.	[ontario] suatu propinsi di negeri kanada.
onto	kd. (di)atas. to get o. a camel naik (ke) unta.
onus	kb. beban, tanggungjawab.
onward	ks. maju, kedepan. o. march baris yang menuju kedepan. -kk. = onwards.
onwards	maju, kedepan. from that time o. sejak itu (dan seterusnya).
onyx	kb. semacam batu akik.
oo	kseru. = ooh.
oodles	kb., inf.: banyak sekali. o. of money uang bertimbun-timbun.
ooh	kseru. o ! wah ! aduh ! o., that's hot ! aduh, benar-benar panas !
oomph	kb. sl.: semangat, keuletan, kegembiraan.
ooze	kb. lumpur, selut. -kkt. mengeluarkan (blood darah). -kki. keluar, menetas.
opal	kb. (baru) baiduri, mata kucing.
