cio	(congress of industrial organization) kongres organisasi industri
cipher	kb. 1 nol. 2 sandi rahasia. -kkt. inf.: memecahkan.
cir.	(circa) kira-kira. cir. 1964 kira-kira tahun 1964.
circle	kb. 1 lingkaran, bundaran. 2 lingkungan. 3 perkumpulan. -kkt. mengedari (the earth). -kki. berputar-putar. the plane circledfor an hour kapal terbang itu berputar-putar selama sejam.
circuit	kb. 1 perjalanan keliling. 2 kontak broken c. kontak putus.
circuitous	ks. yang memutar, tidak langsung. c. route jalan yang tidak langsung.
circular	kb. surat edaran, sirkuler. c. letter surat edaran, sirkuler. c. reasoning cara berfikir yang tak berujung pangkal. -ks. bundar. c. saw gergaji bundar.
circularity	kb. (j. -ties) bentuk bundar. there is some c. in his argument dalam mengemukakan alasannya terdapat sifat berputar-putar.
circularize	kkt. mengirimkan surat edaran. to c. the club members mengirimkan surat edaran kepada anggota perkumpulan.
circulate	kkt. mengedarkan (s.t.). -kki. 1 beredar. 2 bersebar. 3 berkunjung. circulating library perpustakaan yang meminjamkan buku-bukunya.
circulation	kb. 1 peredaran. c.of the blood peredaran darah. 2 oplah. this magazine has a tremendous c. majalah ini oplahnya besar sekali. 3 sirkulasi. c. of money sirkulasi uang.
circulatory	ks. yang berhubungan dengan peredaran c. system sistim/ susunan peredaran darah.
circumcision	kb. penyunatan, sunatan, khitanan.
circumcize	kkt. menyunat, mengkhitan, mengislamkan.
circumference	kb. lingkar, bundara, keliling. what is the c. of the earth? berapa panjang keliling bumi? c. of a circle keliling sebuah lingkaran.
circumflex	kb. sirkompleks. c. accent tanda sirkompleks ( ^ )
circumlocution	kb. pemakaian kata-kata yang terlampau banyak dan tidak perlu.
circumnavigate	kkt. mengelilingi (the earth).
circumnavigation	kb. pelayaran mengelilingi.
circumscribe	kkt. membatasi. opportunities in the job are circumscribed kesempatan-kesempatan maju dalam pekerjaan ini terbatas.
circumspect	ks. sangat berhati-hati. he's c. in this matter ia sangat berhati-hati dalam hal ini.
circumspection.	kb. kehati-hatian.
circumstance	kb. keadaan (sekitar) he's in good circumstances keadaannya baik. under no circumstance bagaimanapun juga (tidak). under the circumstances dalam keadaan itu.
circumstantial	kb. tidak langsung, sambil lalu.
circumvent	kkt. mengelakkan (regulations).
circus	kb. sirkus.
cirrhosis	kb. sirosis. c of the liver sirosis hati.
cistern	kb. waduk, bak/tangki air (biasanya dibawah tanah).
citadel	kb. benteng (biasanya untuk penjagaan dan pertahanan kota).
citation	kb. 1 surat pujian, surat/tanda penghargaan. 2 penggilan. 3 tanda/surat penghargaan. 4 kutipan, sitiran, sebutan (from s.t.).
cite	kkt. 1 menyebut(kan). 2 memuji.
citizen	kb. warganegara, wargakota.
citizenry	kb. (j -ries) rakyat (jelata), penduduk.
citizenship	kb. kewarganegaraan.
citrate	kb. garam/asam sitrat.
citric	ks. c. acid asam sitrat/limau.
citronella	kb. serai. c. oil minyak serai.
citrus	kb. pohon jeruk. c. fruit buah jeruk.
city	kb. (j. -ties) kota (besar) c. editor redaksi kota. city-wide ks. yang meliputi seluruh kota.
civet	kb. c. cat musang (kesturi).
civic	ks. bersifat kewarganegaraan. civic-minded ks. yang memikirkan kepentingan umum.
civics	kb. ilmu kewarganegaraan.
civies	kb. inf.: baju preman, pakaian sipil.
civil	ks. 1 sipil, perdata. 2 berhubungan dengan pemerintah. 3 penduduk. 4 sopan. c. code/law hukum perdat. c. liberty kebebasan perseorangan, hak penduduk. c. service pamong praja. c. war perang saudara. c. wedding kawin kantor.
civilian	kb. orang sipil/preman. c. clothes pakaian preman. c. goverment pemerintahan sipil. in c. life dalam kehidupan sipil.
civility	kb. (j. -ties) kesopanan.
civilization	kb. sivilisasi, peradaban.
civilize	kkt. membudayakan, memberi peradaban kepada. -civilized ks. 1 sopan. 2 beradab.
cl.	1 (class) kelas. 2 (clerk) kerani, kornis.
clabber	kb. susu kental dan kecut.
clack	kki. berkeletak-keletak (of shoes).
clad	lih clothe.
claim	kb. 1 tuntutan. 2 tagihan. 3 hak. -kkt. 1 menuntut. 2 meminta. -kki. menegaskan, menyatakan.
claimant	kb. penuntut.
clairvoyance	kb. terus mata/pandang, kewaskitaan.
clairvoyant	kb. orang yang bersifat terus mata, ahli tenung. -ks. bersifat waskita, terus mata.
clam	kb. remis besar, semacam kijing. -kki. (clammed) sl.: to c. up bungkam.
clambake	kb. 1 bertamasya di pantai (sambil makan-makan masakan kerang, kijing). 2 sl.: pertemuan, pesta, malam gembira, kongres, dsb.
clamber	kki. naik dengan merangkak. to c. up the narrow stairs naik tangga rumah yang sempit dengan merangkak.
clammy	ks. lembab, basah. c. hands tangan basah keringat.
clamor	kb. kegegeran, teriakan. 2 tuntutan. -kki. menuntut dengan ramai the audience clamored for more para penonton berteriak-teriak minta pertunjukan diulangi.
clamp	kb. kempa, apitan, kepitan, kelem. the c. on the box is broken apitan peti itu patah. -kkt. mengepit, mengelem. inf.: to c. down mengawasi keras. the sensors c. down on pornography panitia sensor mengawasi keras kecabulan.
clamshell	kb. kulit kerang.
clan	kb. kaum, suku, marga.
clandestine	ks. gelap, sembunyi klandestin. c. activities kegiatan-kegiatan yang gelap.
clang	kb. gemerincing (of a bell). -kkt. membunyikan (a bell).
clannish	ks. suka berkelompok-kelompok, bersatu erat.
clap	kb. 1 sambaran, bunyi. 2 tepuk. -kkt. (clapped) 1 bertepuk tangan. 2 menepuk-nepuk. 3 menjebloskan. 4 mengepakkan.
clapboard	kb. papan yang tebal pada satu sisi dan disusun berlapis-lapis.
clapper	kb. anak genta/lonceng.
claptrap	kb. omong kosong, cakap angin. his speech was nothing but c. pidatonya hanyalah omong kosong belaka.
claret	kb. anggur perancis berwarna merah. c. red merah anggur.
clarification	kb. penjelasan, uraian.
clarifies	lih. clarify.
clarify	kkt. (clarified) 1 menjelaskan. to c. a matter menjelaskan hal. 2 menjernihkan, membeningkan (a liquid).
clarinet	kb. klarinet.
clarinetist	kb. pemain klarinet.
clarion	kb. bunyi keras, nyaring. c. call panggilan yang keras bunyinya.
clarity	kb. 1 kejernihan, kemurnian, kecerahan. 2 kejelasan.
clash	kb. 1 bunyi berdentum/kerdum-kerdam. 2 perselisihan (of interest, date). 3 bentrokan. 4 ketidak cocokan, ketidakserasian. (of color warna) -kki. 1 bertentangan. 2 tidak cocok.
clasp	kb. jepitan, gesper. 2 anting-anting jepitan (on earings). 2 pegangan. -kkt. 1 menjabat, menggengam. 2 mendekap. -kki. mengunci.
class	kb. 1 kelas. 2 golongan. 3 pelajaran, kelas, sekolah. 4 jam. -kkt. menggolongkan. class-conscious ks. sadar berkelas, sadar tergolong kedalam suatu golongan. class-consciousness kb. kesadaran berkelas.
classic	kb. 1 klasik. 2 keunggulan. -the classics j. sastera yunani dan romawi kuno sebagai lapangan pelajaran juga termasuk bahasa-bahasa sastra itu. -ks. 1 (model) klasik. c. design motif model klasik. 2 terbaik. c. example contoh terbaik.
classical	ks. klasik. c. music musik klasik.
classicist	kb. ahli klasik, sarjana yang mempelajari sastra dan seni yunani-rom kuno.
classification	kb. 1 penggolongan (menurut jenis). klasifikasi. 2 pembagian.
classified	lih classify.
classifier	kb. 1 penggolong. 2 alat penggolong dalam kimia, alat pemisah. 3 gram.: penolong bilangan.
classifies	lih classify.
classify	kkt. (classified) membagi-bagi(kan), menggolongkan. -classified ks. 1 disusun menurut golongan. 2 rahasia. c. information bahan-bahan keterangan yang rahasia.
classmate	kb. teman sekelas.
classroom	kb. 1 ruangan kelas. 2 seluruh kelas. the c. will go to an assembly seluruh kelas akan pergi ke suatu pertemuan.
classy	ks. sl.: 1 mentereng, bagus sekali. that's a pretty c. car mobil itu benar mentereng. 2 tinggi nilainya/mutunya.
clatter	kb. berisik ramai, bising, gemerincing(an). -kki. bergerak atau jatuh dengan bunyi yang ramai.
clause	kb. 1 gram.: (anak) kalimat. 2 ketentuan, klausule. c. in a contract ketentuan didalam perjanjian.
claustrophobia	kb. penyakit rasa takut akan ruangan yang sempit-sempit dan tertutup.
clavicle	kb. tulang selangka.
clavicord	kb. semacam piano (model zaman dulu)
claw	kb. cakar, kuku. c. hammer palu cakar. -kkt., kki. mencakar. the tiger clowed the deer harimau itu mencakar rusa itu. the cat clowed at the chair kucing mencakar kursi itu.
clay	kb. tanah liat/pekat, lempung.
clean	ks. 1 bersih. 2 halal, tidak haram. 3 yang tidakmenimbulkan debu. 4 bentuk. 5 senonoh. sl.: sama sekali. -kkt. membersihkan. -cleanly kk. dengan rapi/tepat, baik, bagus. -cleaning kb. pembersihan, perapian.
cleaner	kb. 1 obat gosok. 2 tukang bersih-bersih di rumah, gedung dsb.). 3 (tukang) obat gosok, binatu.
cleanliness	kb. kebersihan. c. is next to godliness kebersihan adalah hal yang mulia.
cleanness	kb. kebersihan, kerapian.
cleanse	kkt. membersihkan, mencuci to be cleansed of o's sins disucikan dari dosa. -cleansing ks. yang membersihkan c. cream krem pembersih(an)/pencucian.
cleanser	kb. obat/ bahan pembersih.soap is a c. sabun adalah obat pembersih.
cleaptomaniac	=cleaptomaniac.
clear	kb. to be in the c. 1 tak berdosa. 2 dalam perkataan biasa saja. (of the massage). -ks. 1 terang, cerah, gamblang. 2 jelas. 3 encer. 4 bersih. 5 kosong. 6 bebas. -clearing kb. tanah terbuka atau yang baru dibuka, pembukaan hutan.
clearance	kb. 1 jarak ruangan. 2 izin. c. sale (penjualan) obral.
cleat	kb. paku pada sepatu supaya tidak licin.
cleavage	kb. 1 perpecahan. 2 pembelahan. 3 inf.: potongan leher baju yang dalam/rendah (of a dress).
cleave	kkt. (clove, cleft atau cleaved atau cloven) 1 membelah, memotong. 2 memecah. -kki. (cleaved) menggantungkan diri, memegang erat-erat.
cleaver	kb. pisau daging besar, golok.
clef	kb. kunci musik.
cleft	lih cleave.
clematis	ks. semacam tumbuh-tumbuhan menjalar.
clemency	kb. (j. -ties) grasi, perampokan, pengampunan, klemensi.
clench	kb. pegangan, genggaman, cengkeraman, kepalan. -kkt. mengepalkan (o's fists).
cleptomania	= kleptomania
clergy	kb. (j. -gies) kependetaan.
clergyman	kb. (j. -men) pendeta, pastor.
cleric	kb. anggota golongan pendeta.
clerical	kb. 1 yang berhubungan dengan pekerjaan juru tulis. c. work pekerjaan juru tulis, pekerjaan di bagian administrasi. 2 kependetaan. c. dress pakaian kependetaan.
clerk	kb. 1 pegawai toko, pramuniaga. 2 juru tulis. -kki. menjadi pelayan. she clerks in store ia menjadi di toko.
clever	ks. 1 pandai. c. girl gadis yang pandai. 2 cakap, cekatan. 3 cerdik. 4 pandai, pintar.
cleverness	kb. 1 kepandaian. 2 kepintaran. 3 kecerdikan. 4 kecekatan. 5 ketrampilan.
cliche	kb. kata klise. "time-worn" is ac. "time-worn" adalah kata klise. 2 phot.: klise percetakan.
click	kb. 1 bunyi ceklekan. 2 ling.: bunyi kenyutan. -kkt. membunyikan. -kki. 1 berbunyi klik. 2 sl.: berhasil.
clickety-clack	kb. keletak-keletuk. his shoes went c. on the floor sepatunya berkeletak-keletuk ketika berjalan di lantai papan.
client	kb. 1 langganan, nasabah, klien. 2 orang yang dibela oleh (pengacara).
clientele	kb. para pelanggan.
cliff	kb. jurang, karang yang terjal. 2 orang yang tinggal di pencakar langit atau di gedung flat yang besar.
cliffhanger	kb. sl.: pilem, cerpen, situasi atau sandiwara yang menegangkan.
climacteric	kb. 1 masa penting/bersejarah. 2 med.: haid.
climate	kb. 1 iklim. tropical c. iklim tropis. 2 suasana. an unhealthy c. for anti-government statements suasananya yang tidak sehat buat pernyataan-pernyataan anti-pemerintah.
climatic	ks. yang berhubungan dengan iklim. c. conditions keadaan iklim.
climatology	kb. ilmu iklim.
climax	kb. klimaks, puncak. -kkt. menjadi puncak kegembiraan.
climb	kb. 1 pendakian, tanjakan. 2 meningkat. -kkt. 1 mendaki. 2 naik, menaiki. 3 menempuh. -climbing kb. pendakian, penanjakan.
climber	kb. 1 pendaki. 2 orang yang ingin naik pangkat.
clime	kb. iklim. in a warm c. di daerah yang iklimnya panas.
clinch	kb. box.: pagutan. -kkt. 1 mengeling (paku-paku). 2 membereskan. (an argumen) 3 merebut (victory). 4 menutup. -kki. berpiting-pitingan.
clincher	kb. hal yang menentukan. his argument provided the c. pemberian argumentasinya merupakan hal yang menentukan.
cling	kki. (clung) 1 berpegang teguh. 2 melengket, melekat. clinging vine seorang wanita yang tidak bisa berdiri sendiri.
clingstone	kb. biji buah persik yang melekat pada daging buahnya.
clinic	kb. klinik, balai pengobatan. maternity c. klinik bersalin.
clinical	ks. klinis. c. medicine ilmu pengobatan klinik. c. psychology ilmu jiwa klinik.
clinician	kb. dokter yang mengajar atau memakai pengobatan klinik.
clink	kb. 1 denting. 2 inf.: penjara. -kkt. mempertemukan, menyentuhkan. to c. glasses and drink mempertemukan gelas lalu minum.
clinker	kb. arang/kerak besi, tahi arang.
clip	kb. 1 jepitan. 2 potongan (dalam filem). 3 inf.: pukulan. 4 inf.: kecepatan. -kkt.(clipped) 1 menggunting. 2 memangkas, memotong. -clipping kb. guntingan. clippings j. guntingan, pangkasan, potongan.
clip-clop	kb. bunyi keletak-keletuk (of wooden sandals). -kkt. (clip-clopped) berjalan keletak-keletuk. she clip-clopped along ia berjalan berkeletak-keletuk.
clipper	kb. alat pemotong. clippers j. gunting. shali i use the clippers on the sides? apakah rambut-rambut di pinggir itu akan dipotong ?
clique	kb. klik, kelompok, golongan kecil. military c. kelompok kecil yang terdiri dari perwira-perwira, klik tentara.
cliquish	ks. (selalu) bergerombol. that group of young people is very c. kelompok pemuda-pemuda itu selalu bergerombol diantara mereka.
clitoris	kb. kelentit, itil.
cloak	kb. mantel, jubah, jas (panjang). -kkt. menyelubungi.
cloakroom	kb. tempat penggantungan jas, topi dsb.
clobber	kkt. sl.: memukul berkali-kali. in his rage clobbered him dalam kemarahannya dia memukulnya berkali-kali.
clock	kb. jam, lonceng. grandfather c. jam besar yang berdiri. -kkt. mengambil waktu (a runner). to c. in/out mendaftarkan jam masuk kerja, jam pulang dari pekerjaan.
clockmaker	kb. tukang arloji.
clockwatcher	kb. pegawai yang sebentar-sebentar melihat jam menunggu saat pulang.
clockwise	kk. menurut jalan jam. turn your key c. to open the trunk putarlah kunci koper itu menurut jalan jam untuk membukanya.
clockwork	kb. mesin jam. the program went off like c. acara itu berjalan dengan lancar.
clod	kb. gumpalan, bungkah, bongkah. c. of earth gumpalan tanah. to break up the clods menghancurkan bungkal-bungkal.
clodhopper	kb. seorang tolol.
clog	kb. tekelek, bakiak. -kkt. (clogged) menyumbat. -kki. mampat, tersumbat. clogged drain saluran yang tersumbat.
cloister	kb. 1 beranda, serambi sepanjang rumah yang beratap. 2 rel.: biara. -kkt. menyendiri. to lead a cloistered life hidup tersendiri/terpisah/tertutup.
clop	kb. derap. the of marching feet derap kaki berbaris. -kki. (clopped) menderap. the horses clopped along the street kuda-kuda menderap di jalan.
close	kb. akhir. -kkt. menutup. -kki. 1 berakhir. 2 (di) tutup. -closed ks. (ter)tutup. "road c." jalan ditutup. closed-door ks. tertutup, tidak umum. -closing kb. tutupan.
closeness	kb. kedekatan. the c. of the resemblance is striking kemiripan yang begitu dekat sungguh menyolok. the c. of you to me hubungan yang dekat antara saudara dengan saya.
closet	kb. 1 lemari dinding. 2 w.c., kakus. -kkt. mengadakan rapat tertutup. the judge was closeted with the lauyers hakim mengadakan rapat tertutup dengan para pengacara.
closure	kb. penutupan, pengakhiran. to invoke c. mengadakan/meminta penutupan.
clot	kb. bekuan, gumpalan beku. -kki. (clotted) membeku. -clotting kb. penggumpalan (darah).
cloth	kb. cita, kain. 2 = tablecloth. 3 lap. 4 rel.: (kaum) pendeta.
clothe	kkt. (clothed atau clad) 1 membeli sandang. 2 membajui (a child). 3 mengungkapkan. -clad ks. berpakaian. -clothing kb. pakaian, sandang.
clothes	kb. pakaian, baju. to put on o's c. mengenakan pakaian.
clothesbrush	kb. sikat baju/pakaian bundar.
clotheshook	kb. cantelan pakaian.
clotheshorse	kb. jemuran pakaian. he's a regular c. horse ia seorang pesolek.
clothesline	kb. tali jemuran, penjemuran.
clothespin	kb. jepitan baju.
clothier	kb. 1 penjual pakaian. 2 pembuat pakaian.
clothing	lih clothe.
cloture	kb. penutupan singkat dengan pemungutan suara.
cloud	kb. awan, mega. to be in the clouds 1 melayang-layang bahagia sekali. 2 ngelamun. -kkt. 1 meredupkan. 2 menutupi. 3 memperkeruh. -clouded ks. mendung, gelap.
cloudburst	kb. hujan keras/lebat/deras.
cloudiness	kb. keadaan mendung/berawan, kegelapan, kesuraman.
cloudy	ks. 1 mendung, berawan. c. sky langit mendung. 2 suram. c. look pandangan yang suram. 3 kabur. c. arguments alasan-alasan yang kabur. 4 keruh (of water).
clout	kb. inf.: pengaruh, kekuasaan, kekuatan.
clove	kb. 1 cengkeh. 2 butir. a c. of garlic sebutir bawang putih. lih cleave.
cloven	lih cleave.
clover	kb. semanggi. four-leaf c. daun semanggi berhelai empat. to live in c. bagai ayam bertelur di padi.
cloverleaf	kb. daun semanggi. c. intersection jembatan semanggi.
clown	kb. 1 pelawak, badut (in circus, fairs) 2 pej.: orang udik. -kki. membadut.
cloy	kki. menjemukan, memualkan, membosankan (karena kebanyakan). her attitude was cloying sikapnya menjemukan.
club	kb. 1 pentung, alat pemukul, tongkat getokan. 2 perkumpulan, klab, klub. 3 bridge : klawar, klaver. 4 gedung perkumpulan. -kkt. (clubbed) memukul, mementung (s.o.). -kki. berkumpul, mengumpulkan.
clubfoot	kb. kaki pekuk.
clubfooted	clubfooted
clubhouse	kb. rumah bola, gedung perkumpulan.
clubwoman	kb. (j. -women). wanita yang aktif dalam perkumpulan.
cluck	kb. ketokan (of a hen). -kki. berketok(of a hen).
clue	kb. penunjuk, petunjuk, gelagat (untuk memecahkan sesuatu soal). -kki. inf.: memberi petunjuk-petunjuk.
clump	kb. 1 rumpun. a c. of trees serumpun pohon-pohon. 2 gumpal. a c. of earth segumpal tanah. -kkt. menjadi serumpun. to c. (along, about) berjalan gedebak-gedebuk.
clumpsiness	kb. kekakuan, kejanggalan, kacanggungan.
clumsy	ks. 1 janggal, kagok, kikuk. at this age he's so c. pada umur ini ia kagok betul. clumsily kk. dengan janggal/canggung/kikuk.
clung	lih cling.
clunk	kb. bunyi debam/dengkang. the metal object landed with a c. barang logam itu jatuh berdebam.
cluster	kb. 1 tandan. a c. of grapes setandan buah anggur. 2 kelompok. a small c. people sekelompok kecil orang-orang. -kki. berkerumun. the crowd clustered around the injured man orang banyak berkerumun di sekeliling orang yang luka itu.
clutch	kb. 1 auto.: kopling. 2 sarang. 3 genggaman, cengkeraman. in the c. dalam keadaan kritis/genting. clutches j. genggaman. -kkt. 1 menggenggam (s.t.). 2 mengepit. -kki. berpegang pada.
clutter	kb. kekusutan, kekacauan. -kkt. mengusutkan, mengacaukan.
cm.	(centimeter) senti(meter).
cmdg.	(commanding) yang menjadi komandan.
cmdr.	(commander) komandan.
cno	(chief of naval operation) komandan operasi al.
co	(commanding officer) perwira komandan.
co-author	kb. penulis bersama, kawan penulis. -kkt. mengarang,/menulis bersama.
co-chairman	kb. (j. -men). ketua bersama, sesama ketua.
co-op	kb. inf.: toko koperasi. she shop at the c. ia berbelanja di toko koperasi. -ks. inf.: koperatip, koperasi. he lives in a c. apartment ia tinggal di suatu apartemen koperatip.
co-op.,  coop.	1 (co-operation) kerja sama. 2 (co- operative) koperasi.
co-opt	kkt. memilih. the government co-opted my car pemerintah telah memilih mobilku. we have co-opted your help kami memutuskan bersama untuk meminta pertolonganmu.
co-respondent	kb. orang yang tertuduh berzina dengan suami atau isteri yang sedang dituntut bercerai.
co-worker	kb. teman sekerja.
co.	1 (company) maskapai. 2 (county) kabupaten.
coach	coach
coagulant	kb. zat pembeku/pengental
coagulate	kkt. membekukan, mengentalkan (the white of an egg). -kki. membeku, mengental. the blood coagulated darah membeku.
coagulation	kb. pembekuan, pengentalan.
coal	kb. batu bara. -kki. mengisi batu bara. coal- black ks. hitam pekat. c. scuttle ember (untuk) batu bara. c. tar belangkin, pelangkin, ter. coaling station tempat mengisi batu bara.
coalesce	kki. bersatu, bergabung. it is hoped that these small countries will c. into a united country diharapkan bahwa negara-negara kecil ini akan bergabung menjadi suatu negara bersatu.
coalescence	kb. pergabungan, perpaduan, jerepetan.
coalition	kb. pergabungan, persatuan, koalisi. c. party partai koalisi.
coarse	ks. 1 kasar. c. hair rambut kasar. 2 kesat. c. skin kulit kesat. 3 mentah. c. metal logam mentah. coarse-grained ks. tidak halus. c.-grained cloth cita yang tidak halus, kain kasar.
coarseness	kb. kekasaran.
coast	kb. pantai, pesisir. he lives on the c. ia hidup di daerah pantai lautan pasifik. -kki. 1 meluncur. to c. down a snowbank meluncur kebawah diatas timbunan salju. 2 lulus dengan mudah.
coastal	coastal
coaster	ko. 1 alas . place a c. under the glass taruh alas dibawah gelas. 2 alas beroda. the mechanic uses a c. while he works under a car montir mempergunakan alas beroda selagi ia bekerja. 3 ship.: kapal pantai. 4 peluncur.
coastline	kb. garis pantai.
coastwise	ks., kk. sepanjang pantai. c. trade perdagangan sepanjang pantai.
coat	kb. 1 jas. 2 mantel. 3 lapisan. -kki. 1 menutupi, melapisi. 2 melapisi. 3membedaki. coating kb. 1 lapisan. 2 helai kain untuk membuat jas.
coattail	kb. ekor/buntut jas.
coax	kkt. membujuk i coaxed her into doing her homework saya membujuknya agar membuat pekerjaan rumahnya. -coaxing kb. bujukan.
coaxial	ks. mempergunakan jaringan atau mempunyai sumbu yang sama. c. cable kawat koaksial.
cob	kb. tongkol. corn on the c. jagung di tongkol.
cobalt	kb. kobalt. c. blue biru kobalt. c bomb bom kobalt.
cobbler	kb. tukang sepatu.
cobblestone	kb. batu bulat untuk pembuatan jalanan.
cobra	kb. kobra, ular sendok/tedung beludak.
cobweb	kb. jaringan laba-laba.
coca  cola	kb. (minuman) koka kola.
cocaine	kb. kokain.
coccyx	kb. tulang tungging/sulbi.
cochlea	kb. ruang tempat selaput telinga, rumah sipuh (pada telinga).
cock	kb. 1 ayam jantan. 2 keran. 3 kokang(of a gun). -kkt. 1 mengokang (a rifle). 2 melirik. 3 memiringkan, menelengkan. cock-a-doodle-doo kb. kukurukuk. c. -and-bull story cerita isapan jempol. inf.: c. of the walk yang berkuasa, jago(an).
cockatoo	kb. kakatua.
cockcrow	cockcrow
cockerel	kb. ayam jantan muda, ayam bujang.
cockeyed	ks. 1 bermata juling. she's c. ia bermata juling. 2 sl.: tolol, bodoh, sinting. c. ideas pikiran-pikiran tolol.
cockfighting	kb. sabungan ayam.
cockiness	kb. inf.: kesombongan, kecongkakan.
cockle	kb. semacam tiram (bisa dimakan). his kindness warmed the cockles of my heart kebaikannya menyedapkan hatiku.
cockpit	kb. 1 ac.: kokpit. 2 gelanggang sabung ayam.
cockroach	kb. coro, kecoa(k), lipas, kecuak, jere.
cockscomb	kb. balung, jengger.
cockspur	kb. taji, susuh, jalu.
cocksure	ks. yakin sekali, terlampau yakin. don't be so c. janganlah terlalu yakin.
cocksureness	kb. keyakinan yang terlalu pasti.
cocktail	kb. minuman keras (dengan wiski) c. party pesta cocktail (biasanya diadakan pada waktu sore).
cocky	ks. inf.: sombong, congkak.
cocoa	kb. cok(e)lat. c. bean biji coklat.
coconut	kb. (buah) kelapa. c. milk santan. c. oil minyak kelapa. c. palm pohon kelapa. c. plantation kebun kelapa.
cocoon	kb. kepompong, sarung ulat, kokon.
cod	kb. =codfish. cod-liver oil minyak ikan.
coddle	kkt. memanjakan (o's children)
code	kb. sandi, kode. morse c. sandi morse. 2 kitab undang-undang. c. of laws kitab undang-undang. -kkt. memakai kata-kata sandi, menyandi.
codein(e)	kb. kodein.
codex	kb. (j. -dices). naskah kuno.
codfish	kb. sejenis ikan laut yang menghasilkan minyak ikan.
codger	kb. orang yang aneh sifatnya.
codices	lih codex.
codicil	kb. ketentuan tambahan.
codification	kb. kodifikasi, penyusunan (undang-undang dsb.) menurut sesuatu sistem.
codify	codify
codirector	kb. sesama direktur, direktur bersama.
coed	kb. inf.: mahasiswi.
coeducation	kb. pendidikan bersama (bagi pria dan wanita).
coeducational	ks. mengenai pendidikan bersama bagi pria dan wanita. c. institution universitas yang dikunjungi oleh mahasiswa-mahasiswa dan mahasiswi-mahasiswi, perguruan tinggi dengan murid pria dan wanita.
coefficient	kb. koefisien.
coequal	kb., ks. sesama, sama pangkat/ kedudukan.
coerce	kkt. memaksa. the board must not be coerced into passing this ordinance dewan itu jangan dipaksa menerima peraturan ini.
coercion	kb. (penggunaan) paksaan, kekerasan.
coeval	ks. sama usia/tua, sezaman, sebaya.
coexist	kki. hidup bersama, berdampingan. the two nations have coexisted for centuries kedua bangsa itu telah hidup bersama selama berabad-abad.
coexistence	kb. hidup berdampingan. peaceful c. hidup berdampingan secara damai.
coffee	kb. kopi. black c. kopi hitam/pahit. c. cup mangkok/cangkir kopi. ground c. kopi bubuk.
coffer	kb. peti simpanan.
cofferdam	kb. ruangan di air yang dikeringkan untuk pembangunan dasar jembatan.
coffin	kb. peti mayat/jenazah, petimati.
cofounder	kb. peserta/pesero, pendiri, kawan-pendiri.
cog	kb. 1 roda penggerak, gigi roda bergigi. 2 tenaga penggerak. to slip a c. membuat kekhilafan.
cogency	kb. daya meyakinkan. the c. of his argument was impressive daya meyakinkan daripada alasan-alasannya mengagumkan.
cogent	ks. yang meyakinkan, kuat. to present c. arguments in favor of plan memberikan alasan-alasan yang meyakinkan untuk kepentingan suatu rencana.
cogitate	kkt. merenungkan. she cogitated the past celebration ia merenungkan perayaan yang telah lewat. -kki. memikir. to c. over/upon memikirkan.
cogitation	kb. renungan, kenangan.
cognac	kb. konyak.
cognate	kb. sanak. -ks. yang asalnya sama. c. languages bahasa-bahasa yang sama asalnya.
cognation	kb. hubungan darah atau keturunan.
cognition	kb. kesadaran, pengertian.
cognizance	kb. 1 pengetahuan. he did that with the c. of his superiors ia melakukan hal itu dengan pengetahuan atasannya. 2 tanggung jawab. he has c. over two hundred men ia mempunyai tanggung jawab atas duaratus orang.
cognizant	kb. sadar, mengetahui. he in c. of the serious situation ia sadar akan keadaan yang gawat.
cogwheel	kb. roda gigi.
cohabit	kki. tinggal bersama sebagai suami-isteri.
cohabitation	kb. hidup bersama sebagai laki isteri.
cohere	kki. berkumpul bersama, melengket/melekat satu sama lain.
coherence	kb. pertalian, hubungan. some c. is essential in such a system satu pertalian perlu dalam sistim yang demikian itu. sekedar hubungan perlu dalam sistim seperti itu.
coherency	kb. (j. -cies) = coherence.
coherent	ks. 1 masuk akal, bertalian secara logis. 2 saling berlengketan.
cohesion	kb. kohesi, kepaduan.
cohesive	ks. bersatu, berpadu. c. group kumpulan orang yang bersatupadu.
cohesiveness	kb. kepaduan.
cohort	kb. 1 pengikut. 2 kelompok.
coiffeur	kb. pemangkas rambut (untuk wanita).
coiffure	kb. potongan rambut.
coil	kb. 1 gulungan. 2 gulung. -kki. 1 bergelung, berlingkar. 2 membelitkan diri. 3 berliku-liku. to c. up menggulung. -coiled ks. bergelung (of a snake, hair).
coin	kb. 1 ( mata) uang logam. 2 mata uang. -kkt. membikin, mencipta. to c. money 1 mencetak uang logam. 2 menjadi kaya. coin operated ks. yang digerakkan/dijalankan dengan memasukkan uang logam.
coinage	kb. 1 pembuatan uang logam. 2 penciptaan. c. of new words penciptaan/pembuatan kata-kata baru.
coincide	kki. 1 bertepatan. our arrival coincided perfectly with the meeting kedatangan kami bertepatan benar dengn rapat itu. 2 serupa. their views coincided pandangan-pandangan mereka serupa.
coincidence	kb. kejadian yang kebetulan. their coming was wuite a c. kedatangan mereka memang hal yang kebetulan sekali.
coition	= coitus.
coitus	kb. persetubuhan, sanggama.
coke	kb. 1 batu karang, kokas. c. oven tungku batu arang, tungku kokas. 2 sl.: c. koka kola.
col.	1 (colonel) kolonel. 2 (college) perguruan tinggi. 3 (collector) pengumpul. 4 (colony) jajahan. 5 (column) lajur, kolom.
cold	kb. 1 dingin. 2 pilek, selesma, masuk angin. -ks. 1 dingin. 2 jauh. 3 tidak tertarik. 4 pingsan. cold-blooded ks. 1 kejam. 2 berdarah dingin. cold-eyed ks. dengan mata dingin. c. war perang dingin.
coldness	kb. kedinginan, keadaan dingin.
coleslaw	kb. selada kol/kubis.
colic	kb. mulas/sakit perut (bayi, hewan).
coliseum	kb. stadion besar.
colitis	kb. radang usus besar.
coll.	(colloquial) (bahasa) percakapan, bahasa sehari-hari.
collaborate	kki. bekerjasama. to c. on a new song bekerjasama dalam menggubah nyanyian baru. to with the enemy bekerjasama dengan musuh.
collaboration	kb. kerjasama, kolaborasi. c. with kerjasama dengan. c. on the dictionary kerjasama dalam pembuatan kamus.
collaborationist	kb. = collaborator 1.
collaborator	kb. 1 kolaborator (dengan musuh), kaki-tangan. 2 teman bekerjasama.
collage	kb. susunan benda-benda dengan potongan-potongan kertas dsb yang ditempelkan pada bidang datar dan merupakan kesatuan karya seni.
collapse	kb. 1 keruntuhan, kerobohan. 2 gagalnya. -kkt. 1 mengempiskan (a lung). 2 melipat (kan). -kki. 1 runtuh, roboh. 2 gagal. 3 jatuh, roboh. 4 kempis. 5 melipat.
collapsible	ks. dapat dilipat. c. boat perahu yang dapat dilipat.
collar	kb. 1 kerah. 2 ban leher (anjing dan kuda). -kkt. 1 inf.: menahan. 2 menangkap. c. stud kancing leher.
collarbone	kb. tulang selangka.
collate	kkt. 1 menyatukan, menyusun, menaklik. 2 memeriksa, membanding-bandingkan.
collateral	kb. jaminan. -ks. 1 tambahan. 2 seketurunan. 3 sejajar, yang mengiringi, yang terjadi bersamaan.
collation	kb. pemeriksaan, pembandingan dengan teliti, penaklikan. c. of manuscripts pembandingan naskah-naskah.
colleague	kb. kolega, teman sejawat/sekerja, rekan.
collect	kkt. 1 mengumpulkan (money, stamps). 2 mengambil, mengangkat. 3 menampung. 4 menagih (a debt). -kki. 1 berkumpul, terkumpul, berkerumun. 2 menggenang. -kk. dibayar sipenerima. -collected ks. 1 tenang. 2 yang berkumpul.
collection	kb. 1 koleksi, kumpulan. 2 pungutan. 3 pengumpulan.
collective	kb. perusahaan tani kolektip, usaha tani kolektip. -ks. 1 bersama. 2 bersama, kolektip. c. noun katabenda yang mempunyai arti majemuk.
collectivization	kb. kolektipisasi, pengkolektipan.
collector	kb. 1 pengumpulan. stamp c. pengumpul perangko. 2 pemungut. that edition is a collecror's stem terbitan itu adalah di simpan untuk seorang pengumpul.
college	kb. 1 perguruan tinggi, universitas. 2 fakultas. electoral c. badan pemilih presiden dan wakil presiden di a.s.
collegian	kb. mahasiswa, mahasiswi.
collegiate	ks. bertautan dengan perguruan tinggi. baseball is a c. sport basball adalah olahraga perguruan tinggi.
collide	kki. 1 bertubrukan, bertabrakan. 2 bertubruk. 3 bentrokan.
collie	kb. semacam anjing berbulu panjang dari skotlandia, terkenal dengan kecerdasannya.
collision	kb. tubrukan, bentrokan, tabrakan. c. course arah yang akan mengakibatkan tubrukan.
collocation	kb. sanding kata.
colloid	kb. koloid (a). c. chemistry ilmu kimia koloida.
colloq.	(colloquial). bahasa sehari-hari.
colloquial	yang berhubungan dengan bahasa percakapan atau bahasa sehari-hari. c. expression ucapan yang dipakai sehari-hari. c. language bahasa percakapan.
colloquialism	kb. perkataan/ucapan sehari-hari.
colloquium	kb. pertemuan/rapat keahlian, seminar.
colloquy	kb. konferensi, seminar, musyawarah.
collusion	kb. sekongkolan, kongkalikong. to act in c. with s.o. bersekongkol dengan seseorang.
colo.	(colorado) negarabagian a.s.
cologne	= eau de cologne.
colon	kb. 1 anat.: usus besar. 2 gram.: (tanda) titik dua.
colonel	kb. kolonel.
colonelcy	kb. (j. -cies) pangkat atau jabatan kolonel.
colonial	kb. seorang kolonial. -ks. 1 penjajahan, kolonial. c. policy politik penjajahan. 2 c. kolonial. c. furniture perabot rumah jaman kolonial inggeris.
colonialism	kb. kolonialisme, penjajahan.
colonialist	kb. penjajah.
colonist	kb. penduduk baru.
colonization	kb. kolonisasi.
colonize	kkt. menjajah, mendiami suatu daerah baru.
colonizer	kb. penjajah, penduduk koloni.
colonnade	kb. barisan tiang yang menopang atap.
colony	kb. (j. -nies) 1 koloni, jajahan. 2 perkampungan. 3 masyarakat. 4 kumpulan.
colophon	kb. tanda penerbit, biasanya ditaruh di halaman terakhir pada buku.
color	kb. 1 warna, rona. 2 corak. -the colors j. bendera. -kkt. 1 memberi warna pada, mewarnai. 2 memberi corak tertentu. color-blind ks. buta warna. -colored ks. 1 berwarna. 2 kulit hitam, berwarna. -coloring kb. warna.
coloration	kb. pewarnaan.
colorbearer	kb. pembawa bendera.
colorfast	ks. tidak/tahan luntur. this shirt is c. kemeja ini tidak luntur.
colorful	ks. bersemangat. he's a c. figure ia seorang yang bersemangat.
colorless	ks. 1 tanpa warna. c. complexion air muka pucat. 2 tak menarik. the story was utterly c. cerita itu sama sekali tak menarik.
colossal	ks. besar sekali, luar biasa besarnya. the novel was a c. success roman itu mendapat sukses yang luar biasa besarnya.
colt	kb. anak kuda jantan. c. revolver pistol colt/kol.
column	kb. 1 kolom, lajur. 2 tiang. 3 karangan. 4 gumpalan seperti tiang. 5 mil.: pasukan. spinal c. tulang punggung. steering c. sumbu/batang setir.
columnist	kb. kolumnis, penulis tetap dari karangan dan artikel khusus dalam surat kabar.
com.	1 (commission) komisi. 2 (committee) komite, panitia.
coma	kb. pingsan yang lama karena penyakit, luka atau keracunan. she lay in a c. for a week ia pingsan selama seminggu.
comatose	ks. pingsan, tidak sadar diri. in a c. state pingsan, dalam keadaan pingsan.
comb	kb. 1 sisir, sikat. 2 balung, jengger (of a cock). -kkt. 1 menyisir. 2 menjelajah. to c. out 1 menyisir. 2 mencari dengan teliti.
combat	kb. pertempuran. c. duty tugas tempur. -kkt. melawan, memberantas to c. illiteracy memberantas buta huruf.
combatant	kb. yang bertempur, pejuang.
combination	kb. kombinasi, gabungan. these colors make a nice c. warna-warna ini baik kombinasinya. c. of the safe kombinasi kunci lemari besi.
combine	kkt. 1 menggabungkan. 2 menyatukan. 3 memiliki. -kki. bergabung. -combined ks. yang bergabung, gabungan.
combo	kb. inf.: sekumpulan orang-orang pemain musik, biasanya lebih kecil daripada ben atau orkes.
combustible	ks. mudah terbakar. c. material bahan yang mudah terbakar.
combustion	kb. pembakaran. c. chamber ruang pembakaran.
comdr.	(commander) 1 letnan kolonel (al). 2 komandan.
comdt.	(commandant) komandan.
come	kki. (came, come) 1 datang. 2 terdapat. 3 menimpa. 4 sampai. 5 tiba, sampai. 6 ayo. -come-hither kb., ks. bujukan untuk datang. come-on kb. inf.: penarik, penggairah. -coming kb. kedatangan.
comeback	kb. 1 inf.: muncul/bermain kembali. the boxer has made a marvelous c. petinju itu muncul kembali dengan gilang-gemilang. 2 sl.: jawaban tajam. he always has a c. for every reply ia selalu pandai menjawab kembali untuk tiap-tiap jawaban.
comedian	kb. 1 pelawak. 2 pemain komidi.
comedienne	kb. 1 pelawak wanita. 2 pemain komidi wanita.
comedown	kb. inf.: kemunduran, kehilangan, kedudukan. this is a real c. after all his previous successes ini adalah benar-benar suatu kemunduran baginya setelah segala kemajuannya yang terdahulu.
comedy	kb. (j. -dies) komidi, komedi.
comeliness	kb. kecantikan, keelokan.
comely	ks. cantik, elok, molek, yang menarik.
comer	kb.: pendatang. that tennis player is a real c. pemain tenis itu benar-benar mempunyai harapan baik.
comestible	kb. bahan pangan, panganan.
comet	kb. bintang berekor/berasap/berkotek/sapu.
comeuppance	kb. inf.: hukuman, pembalasan. when his deed backfired, he got his c. ketika tindakannya merugikan dirinya sendiri itu ia menerima hukumannya.
comfort	kb. 1 kesenangan (hidup). 2 law.: bantuan. c. station kakus umum. -kkt. menghibur. -comforting ks. yang menyenangkan/menenangkan/menghibur. c. words kata-kata yang menghibur.
comfortable	ks. 1 menyenangkan. 2 senang. 3 nyenyak. 4 enak. 5 cukup, lumayan. -comfortably kk. dengan senang.
comforter	kb. 1 selimut dari kapas (for a bed). 2 dot buat bayi untuk menenangkan.
comfy	ks. inf.: enak dipakai. these slippers are c. sandal ini enak dipakai.
comic	kb. pelawak. -comics j. cerita/buku komik. -ks. 1 komik. c. book buku komik. 2 yang bersifat gembira. c. opera opera yang bersifat gembira.
comical	ks. lucu, menggelikan, kocak. his appearance is c. ia lucu kelihatannya.
comity	kb. (j. -ties) rasa/sikap hormat.
comm.	1 (committee) panitia, komite. 2 (commission) komisi.
comma	kb. koma (tanda bacaan).
command	kb. 1 aba-aba. 2 perintah. 3 pimpinan. 4 kekuasaan. 5 komando. 6 titah. to be in c. 1 berkuasa. 2 memegang komando. -kkt. 1 memerintahkan. 2 menguasai. 3 memiliki, mempunyai. 4 mewajarkan. 5 membangkitkan, menuntut.
commandant	kb. komandan.
commandeer	kkt. menyita.
commander	kb. 1 letnan-kolonel (al). 2 komandan. c. of the unit komandan pasukan. commander-in-chief panglima tertinggi.
commandment	kb. firman. the ten commandments sepuluh firman allah.
commando	kb. perajurit penyerang. k.k.o., p.g.t., r.p.k.a.d.
commemorate	kkt. memperingati. to c. the fallen heroes memperingati pahlawan-pahlawan yang gugur.
commemoration	kb. (perayaan) peringatan. this event is in c. of washington's birthday perayaan ini adalah untuk memperingati hari ulang tahun kelahiran washington.
commemorative	ks. peringatan. c. stamp perangko peringatan.
commence	kkt., kki. memulai. the inauguration commenced promptly at 11 a. m. pelantikan mulai tepat pada jam 11 pagi.
commencement	kb. 1 permulaan. c. of the tv program permulaan program tv. 2 acad.: upacara pemberian ijazah (pada sekolah).
commend	kkt. 1 menghargai, memuji. 2 mempercayakan, menitipkan.
commendable	ks. patut dihargai/dipuji. his attitude was c. sikapnya patut dihargai.
commendation	kb. pujian, penghargaan. c. ribbon pita penghargaan.
commendatory	ks. bersifat pujian/penghargaan.
commensurable	ks. sepadan. his size and weight are c. tinggi dan berat badannya sepadan.
commensurate	ks. setaraf, sepadan. his job is not c. with his training pekerjaannya tidak setaraf dengan pendidikannya.
comment	kb. 1 komentar. 2 ulasan. -kki. 1 memberikan komentar/ulasan, mengomentari. 2 mempercakapkan. 3 menguraikan. 4 menyebut.
commentary	kb. (j. -ries) 1 uraian. 2 penjelasan.
commentator	kb. komentator, juru ulas. radio c. juru ulas radio.
commerce	kb. perdagangan, perniagaan. school of c. sekolah perniagaan/dagang. he's engaged in c. ia berniaga/berdagang.
commercial	kb. iklan (di televisi atau di radio). -ks. yang bersifat perniagaan/perdagangan, niaga.
commercialism	kb. cara jiwa perdagangan.
commercialize	kkt. memberi sifat komersil, mengkomersilkan.
commie	kb. inf.: = communist.
commingle	kki. bergaul, bercampur. the two countries commingled nicely in their commercial treaty kedua negeri itu bergaul dengan baik dalam perjanjian perdagangan mereka. -commingling kb. percampuran, pergaulan.
commiserate	kki. menunjukkan rasa simpati, menaruh simpati. he commiserated with me over my loss in the election ia menunjukkan rasa simpati nya kepadaku ketika aku kalah dalam pemilihan itu.
commiseration	kb. perasaan menyesal, rasa simpati.
commissary	kb. (j. -ries) toko sandang pangan di kamp tentara, di kedutaan besar. di perkampungan tambang dsb.
commission	kb. 1 jabatan/pangkat perwira. 2 komisi, panitia. 3 komisi. 4 perbuatan. out of c. 1 rusak. 2 tidak bertugas. -kkt. 1 memesan. 2 mempersiapkan untuk berlayar (a ship). 3 mengangkat. -commissioned ks. yang bertugas.
commissioner	kb. komisaris. police c. komisaris polisi.
commissionership	kb. jabatan komisaris.
commit	kkt. (committed) 1 melakukan. 2 menjalankan, berbuat. 3 memasukkan. 4 mengerjakan (murder, a robbery). to c. to memory menghafal.
commitment	kb. 1 janji. to fulfil o's commitments memenuhi janji-janjinya. 2 tanggung jawab. military c. tanggung jawab militer.
committal	kb. penguburan.
committee	kb. panitia, komite, komisi. standing c. panitia tetap. to be on a c. duduk dalam panitia.
committeeman	kb. (j. -men) anggota panitia.
commode	kb. 1 lemari baju yang berlaci-laci. 2 kamar kecil.
commodious	ks. luas, lapang. this room is c. kamar ini luas.
commodity	kb. (j. -ties) barang (per) dagangan, bahan keperluan. basic c. barang dagangan utama, bahan pokok.
commodore	kb. komodor.
common	kb. keadaan yang biasa. -commons j. ruang makan besar. commons majelis perwakilan rendah. -ks. 1 biasa, lazim. 2 umum. 3 bersama. 4 dangkal, kasar. 5 kasar. common-law ks. yang berhubungan dengan hukum adat atau hukum kasus. -commonly kk. biasa.
commoner	kb. orang biasa/awam, rakyat jelata.
commonplace	kb. yang biasa/lumrah, kejadian sehari-hari. jets are a c. now pesawat jet adalah biasa sekarang.
commonweal	kb. kesejahteraan bersama/umum.
commonwealth	kb. persemakmuran. the british c. persemakmuran inggeris.
commotion	kb. keributan, huru hara, kegemparan.
communal	ks. komunal, yang bertautan atau berhubungan dengan umum. c. land tanah milik bersama/desa.
communalism	kb. cara hidup bersama, perkauman.
commune	kb. komune, kelompok yang hidup bersama.
communicable	ks. 1 yang dapat dipindahkan atau diteruskan. 2 yang dapat menular. c. disease penyakit menular.
communicant	kb. 1 anggota/pengunjung. tetap (dari gereja). 2 pemberi keterangan.
communicate	kkt. menceritakan, menyampaikan. he was able to c. his problem to his boss ia dapat menceritakan persoalannya kepada majikannya. -kki. berhubungan dengan. we can c. easily kita dapat berhubungan dengan mudah.
communication	kb. 1 hubungan, komunikasi. 2 kabar. 3 pengumuman, pemberitahuan. to be in c. with berhubungan dengan. -communications j. sistim perhubungan .
communicative	ks. suka bicara/bercakap-cakap. she's not very c. ia tak suka bercakap-cakap.
communicativeness	kb. sifat suka bercakap-cakap.
communicator	kb. orang/alat penghubung.
communion	kb. 1 komuni. 2 kerukunan. the c. of saints kerukunan umat seagama. 3 hubungan erat. in with nature dalam hubungan erat dengan alam.
communique	kb. kominike, pengumuman resmi.
communism	kb.komunisme.
communist	kb. komunis, anggota partai komunis. -ks. komunis. c. party partai komunis. c. china republik rakyat tiongkok.
communistic	ks. yang bersifat komunis. that trade union c. tendencies serikat buruh itu condong ke aliran komunis.
community	kb. (j. -ties) 1 masyarakat, komunita. 2 persamaan. 3 himpunan.
communize	kkt. menjadikan komunis.
commutation	kb. elec.: penukaran jurusan arus listrik. 2 peringanan. c. of a prison sentence peringanan hukuman penjara.
commute	kkt. merubah, memperingan. his sentence was commuted from death to life imprisonment hukumannya dirubah dari hukuman mati menjadi hukuman seumur hidup. -kki. pulang pergi kerja.
commuter	kb. orang yang pulang pergi setiap hari untuk bekerja.. c. train kereta api yang membawa orang yang pulang pergi kerja.
comp.	(compiler) penyusun.
compact	kb. 1 (ladies') tempat bedak, tas kosmetik. 2 auto.: mobil penumpang yang kecil. -ks. 1 rapi, tersusun rapat. 2 padat. 3 pendek gemuk.
compactness	kb. 1 kepadatan. 2 kebuntakan.
companion	kb. teman, kawan, rekan.
companionable	ks. cocok untuk menjadi teman, peramah. he's quite c. ia baik sekali untuk teman.
companionship	kb. perkawanan, persahabatan. he enjoys the c. of his father dia suka sekali ada didekat ayahnya.
companionway	kb. tangga dari geladak kapal ke kamar-kamar dibawah.
company	kb. (j. -nies) 1 perusahaan, firma, maskapai. 2 kompi. 3 teman-teman, tamu-tamu. 4 rombongan.
comparability	kb. sifat bisa diperbandingkan/disamakan.
comparable	ks. 1 sebanding. 2 dapat di(per)samakan. a small house like this is not c. to a palace rumah kecil seperti ini tak dapat dipersamakan dengan istana. the two matters are not c. kedua hal itu tidak dapat dipersamakan.
comparative	ks. 1 yang bertautan dengan perbandingan. 2 komparatip. -comparatively kk. termasuk, terhitung.
compare	kb. bandingan, tara. -kkt. mem(per)bandingkan. to c. to menyamakan dengan. to c. with menyamai, menyamakan dengan, memperbandingkan.
comparison	kb. 1 (per)bandingan. there's no c. between the two tak ada bandingannya antara kedua itu. 2 pembandingan. the c. of dutch and german is interesting perbandingan antara bahasa belanda dengan bahasa jerman adalah menarik hati.
compartment	kb. 1 kompartemen. 2 kamar tidur, ruang terpisah. to reseve a c. on a train memesan kamar tidur di kereta api. 3 bagian ruangan. the watertight compartments of a ship bagian ruangan kapal yang kedap air.
compartmentalization	kb. pembagian dalam bagian-bagian, penggolongan.
compartmentalize	kkt. mengadakan penggolongan atau pembagian. it is sometimes useful to c. data kadang-kadang berguna untuk mengadakan penggolongan data-data.
compartmentation	kb. cara pembagian ruangan.
compass	kb. 1 kompas, pedoman. 2 jangka (a pair of) compasses jangka. 3 batas (yang wajar). c. saw gergaji kecil untuk membuat lingkaran.
compassion	kb. keharuan, perasaan kasihan/terharu. he tried to arouse her c. ia mencoba membangkitkan rasa kasihannya. she had c. on him ia merasa kasihan kepadanya.
compassionate	ks. 1 sangat merasa kasihan. 2 ingin menghibur orang lain. he was granted c. leave upon the death of his father ia diberi cuti penghibur atas kematian ayahnya.
compatibility	kb. kecocokan, kesesuaian.
compatible	kb. cocok, rukun, harmonis. that boy and girl do not seem to be c. pemuda dan gadis itu nampaknya tidak cocok satu sama lain. these colors are c. warna-warna ini cocok.
compel	kkt. (compelled) 1 memaksa. 2 mendorong. -compelling ks. yang memaksakan.
compendious	ks.ringkas, singkat tapi lengkap. c. volume on law buku ringkas mengenai hukum.
compendium	kb. ikhtisar, ringkasan, singkatan. c. of the federal tax law ikhtisar undang-undang pajak pemerintah pusat.
compensate	kkt. mengganti kerugian. -kki. 1 mengimbangi. 2 mengganti kerugian.
compensation	kb. 1 ganti (kerugian), penggantian. 2 bayaran, upah. 3 kepuasan, rasa puas.
compensatory	ks. sebagai pengganti/ imbangan.
compete	kki. 1 bertanding. 2 bersaing. 3 berlomba.
competence	kb. 1 kecakapan, kemampuan, kompetensi. 2 wewenang. this matter does not lie within his c. hal ini tidak termasuk wewenangnya.
competency	kb. = competence.
competent	ks. cakap, mampu, tangkas. a c. interpreter juru bahasa yang cakap.
competition	kb. 1 persaingan, kongkurensi. unfair c. persaingan yang tak adil. open c. persaingan terbuka. 2 pertandingan, kompetisi. chess c. pertandingan catur.
competitive	ks. 1 berhubungan dengan persaingan, bersifat bersaing, bertanding. c. spirit semangat bertanding yang kuat, semangat bertanding. 2 bersaingan.
competitiveness	kb. daya saing.
competitor	kb. saingan, konkuren.
compilation	kb. himpunan, kompilasi. c. of laws himpunan undang-undang.
compile	kkt. menyusun, mengumpulkan, menghimpun. to c. a dictionary menyusun kamus.
compiler	kb. penyusun, penghimpun.
complacency	kb. (j. -cies) kepuasan dengan diri sendiri.
complacent	ks. puas (dengan diri sendiri). some people tend to be c. about the future beberapa orang rupa-rupanya puas dengan dirinya mengenai hari depan. the c. smile of the victor senyum kepuasan pemenang.
complain	kki. 1 mengeluh. 2 mengadu. -complaining ks. yang mengeluh.
complainant	kb. pengadu, pendakwa.
complainer	kb. pengeluh.
complaint	kb. 1 keluhan. a sore throat is a common c. kerongkongan yang sakit adalah keluhan umum. 2 pengaduan. legitimate c. pengaduan yang sah.
complement	kb. 1 imbangan, pelengkap (sehingga sempurna). 2 awak kapal yang lengkap. ling.: pelengkap (penderita, penyerta, pelaku). -kkt. 1 menyempurnakan, melengkapi, menambah. 2 mengimbangi, melengkapi.
complementary	ks. yang melengkapi, saling mengisi/mengimbangi. their personalities were c. kepribadian mereka saling mengimbangi.
complete	ks. 1 lengkap, sempurna. 2 yang menyeluruh. -kkt. 1 menyelesaikan. 2 melengkapkan. 3 melengkapi, mencapai. 4 mengisi (a form). -completely kk. sama sekali.
completeness	kb. kelengkapan, kesempurnaan, keparipurnaan.
completion	kb. penyelesaian. immediate c. of the task is essential penyelesaian tugas ini dengan segera penting sekali.
complex	kb. 1 kompleks. dormitory c. komleks asrama. 2 kebencian yang tak berdasar.
complexion	kb. 1 corak kulit. beautiful c. kulit yang bagus sekali. 2 corak.
complexity	kb. (j. -ties) keruwetan, kerumitan. the c. of modern machinery keruwetan pada mesin-mesin modern.
compliance	kb. 1 pemenuhan. in c. with your request memenuhi permohonan saudara. 2 kerelaan.
compliant	ks. selalu mengalah/tunduk, rela.
complicate	kkt. menyulitkan, menyukarkan. -complicated ks. rumit (susunan), sulit, ruwet. the watch a c. mechanism arloji adalah suatu pesawat yang rumit susunannya.
complication	kb. 1 kesulitan, komplikasi. 2 rintangan. 3 penyakit, komplikasi.
complicity	kb. (j. -ties) hal terlibat dalam sesuatu, kelibatan, keterlibatan. he was charged with c. in the robbery ia dituduh terlibat didalam perampokan itu.
complied	lih. comply.
complies	lih. comply.
compliment	kb. 1 pujian. 2 salam. -kkt. memberi pujian, mengucapkan selamat.
complimentary	ks. berisi pujian. c. ticket karcis cuma-cuma. she was very c. about our party ia amat memuji-muji pesta kami.
comply	kki. (complied) 1 menuruti. 2 tunduk, patuh. 3 memenuhi, mengikuti. 4 menurut.
component	kb. bagian, komponen. the components of a telephone bagian-bagiab alat telepon. c. parts bagian-bagian (yang membentuk kesatuan), barang-barang pelengkap.
comport	kki. membawakan diri, bersikap, bertingkah laku. a teacher must c. himself with dignity seorang guru harus bersikap dengan kewibawaan.
compose	kkt. 1 menggubah. 2 menyusdun. to c. o.s. menenangkan diri. to be composed of terdiri/tersusun dari. -composed ks. tenang, sabar.
composer	kb. penggubah, pengarang, penyusun.
composite	kb. gabungan, campuran. this language is a c. of many languages bahasa ini adalah gabungan dari banyak bahasa-bahasa. -ks. susunan, gabungan. a c. photo foto susunan/kombinasi.
composition	kb. 1 gubahan (musik), komposisi. 2 karangan. 3 susunan, campuran. what is the c. of this point? bagaimana susunan cat ini?
compost	kb. kompos.
composure	kb. ketenangan, kesabaran. to regain o's c. memperoleh ketenangan kembali.
compote	kb. 1 kompot, piring untuk buah atau gula-gula. 2 kolak buah, buah yang dimasak dalam setrup.
compound	kb. 1 kamp, halaman tertutup. 2 bahan campuran. 3 chem.: senyawa, persenyawaan. -ks. gabungan. -kkt. 1 mempersulit, menambah (o's problems). 2 melipatgandakan (interest). -compounding kb. 1 penyusunan,pembentukan kata gabungan. 2 penggabungan.
comprehend	kkt. 1 memahami, mengerti. some theories are difficult to c. ada teori-teori yang sukar dipahami. 2 terdiri dari, meliputi. indonesia comprehends many islands indonesia terdiri dari banyak pulau.
comprehensible	ks. dapat dipahami. what he writes is hardly c. apa yang ditulisnya hampir-hampir tak dapat dipahami.
comprehension	kb. pengertian, pemahaman. that's beyond my c. hal itu diluar pengertian saya.
comprehensive	ks. luas, meliputi banyak hal. c. examination ujian pengetahuan umum.
comprehensiveness	kb. sifat mencakupi, kelengkapan.
compress	kb. kompres. cold c. kompres dingin, jaram. -kkt. 1 menyingkatkan, meringkaskan. 2 memadatkan, memampatkan. -compressed ks. dikempa, ditekan. c. air udara kempaan/mampat.
compression	kb. tekanan, kempaan, pengempaan,pemampatan, kompresi.
compressor	kb. kompresor, pemampat.
comprise	kkt. terdiri dari. this encyclopedia comprises ten volumes ensiklopedi ini terdiri dari sepuluh jilid.
compromise	kb. kompromi. -ks. yang disetujui bersama. -kkt. membahayakan. -kki. berkompromi. -compromising ks. mencurigakan.
comptometer	kb. mesin hitung (yang dapat menambah, mengurangi, membagi dan mengalikan).
comptroller	kb. pengawas keuangan.
compulsion	kb. paksaan, tekanan, keharusan. under c. dengan paksaan.
compulsive	ks. yang mendorong. she has a c. nature ia mempunyai sifat yang mendorong. -compulsively kk. dengan paksa.
compulsory	ks. wajib, diwajibkan. c. education wajib belajar-sekolah. this subject is c. mata pelajaran ini diwajibkan.
compunction	kb. penyesalan, perasaan menyesal. i have no c. about saying "no" saya tidak menyesal menolak.
computation	kb. perhitungan.
compute	kkt. memperhitungkan. to c. the cost memperhitungkan ongkos-ongkos. -kki. menghitung. it's not easy to c. correctly tidak gampang untuk menghitung dengan tepat.
computer	kb. mesin berhitung, komputer. electronic c. mesin berhitung elekronis.
computerize	kkt. mengkomputerkan.
comrade	kb. kawan, sahabat, saudara. they were comrades in battle mereka kawan seperjuangan.
comradely	ks. bersifat persaudaraan. he made a c. gesture ia memberi isyarat persaudaraan.
comsat	(communications satellite) kb. satelit komunikasi.
con	kb., kk. lawan. -ks yang menipu. -kkt. (conned) mengemudikan. conning tower menara/geladak komando.
con.	(consul) konsul.
concatenation	kb. rentetan, rangkaian, keadaan jalin-menjalin.
concave	ks. lekuk, cekung.
conceal	kkt. menyembunyikan (pistol, kesedihan dsb.). to c. o's movements from menyembunyikan gerak-geriknya dari. concealed weapon senjata sembunyi.
concealment	kb. penyembunyian, persembunyian.
concede	kkt. mengakui, menyerahkan. -kki. menyerah.
conceit	kb. kecongkakan, kesombongan.
conceited	ks. congkak, sombong, angkuh.
conceivable	ks. 1 mungkin. 2 yang dapat dipikirkan. -conceivably kk. menurut pikiran.
conceive	kkt. 1 menyusun. 2 memahami. 3 menaruh, mengandung. -kki. 1 menjadi hamil. 2 membayangkan.
concentrate	kb. sari, intisari. -kkt. 1 menghimpun(kan), memusatkan. 2 membersihkan. -kki.memusatkan pikiran. -concentrated ks. 1 pekat, padat. 2 yang dipusatkan.
concentration	kb. pemusatan, konsentrasi. c. of forces pemusatan kekuatan. c. on o's studies memusatkan diri pada pelajaran.
concentric	ks. konsentris. c. circle lingkaran konsentrasi.
concept	kb. 1 konsep(si), buram, bagan, rencana. 2 pengertian. new concepts appear every day pengertian-pengertian baru timbul tiap-tiap hari.
conception	kb. gambaran. 2 penghamilan, pembuahan. the act of c. may take place at any time among human beings perbuatan penghamilan pada manusia bisa terjadi setiap waktu.
conceptual	ks. yang berhubungan dengan konsepsi/pengertian.
concern	kb. 1 perhatian, keprihatinan. 2 firma, perusahaan. 3 soal, urusan. -kkt. menyangkut, mengenai, penting bagi. -concerned ks. kuatir, gelisah, prihatin, risau. -concerning kd. mengenai.
concert	kb. konser. c. hall ruang konser.
concerted	ks. yang diselenggarakan dengan persetujuan bersama.
concerto	kb. komposisi musik yang dimainkan oleh biola, piano, dsb bersama-sama orkes.
concession	kb. 1 kelonggaran. 2 konsesi. mining c. konsesi pertambangan.
concessionaire	kb. pemegang izin. a cabaret c. must pay an entertainment tax pemegang ijin kabaret harus membayar pajak hiburan.
concessive	ks. mengjzinkan, (mudah) menyerah.
conch	kb. (kulit) kerang, keong/siput besar.
conciliate	kkt. mendamaikan. to c. a dispute mendamaikan perselisihan.
conciliation	kb. tindakan mendamaikan. c. board dewan pendamai.
conciliatory	ks. bersifat mendamaikan. to take a c. attitude in the dispute bersikap mendamaikan dalam pertikaian itu.
concise	ks. 1 ringkas, singkat. c. report laporan ringkas. 2 kecil, ringkas. c. dictionary kamus kecil.
conciseness	kb. keringkasan yang padat isinya.
conclave	kb. pertemuan pribadi.
conclude	kkt. 1 menutup, mengakhiri. 2 menandatangani. 3 menyimpulkan. -kki. menarik kesimpulan, berpendapat.
conclusion	kb. 1 kesimpulan. 2 akhir. 3 wasana kata.
conclusive	ks. meyakinkan, menentukan. the evidence in the case is c. bukti dalam perkara itu meyakinkan.
concoct	kkt. membuat (a drink, a lie).
concoction	kb. campuran, buatan yang orisinil, ramuan.
concomitant	kb. hal yang bersamaan. -ks. cocok, seiring(an) dengan . c. with his abitlty cocok dengan kemampuannya.
concord	kb. 1 kerukunan, harmoni, kedamaian. 2 gram.: persesuaian.
concordance	kb. indeks, daftar kata yang disusun secara alfabetis dengan menunjuk ke halaman-halaman buku.
concourse	kb. 1 tempat terbuka di stasiun. 2 kumpulan orang banyak.
concrete	kb. beton. c. base dasar/fondasi beton. c. slab pelat beton. -ks. konkrit. c. example contoh yang kongkrit.
concubine	kb. gundik, kendak, gendak, selir.
concur	kki. (concurred) setuju i c. in your last statement saya setuju dengan pernyataanmu yang terakhir.
concurrence	kb. persetujuan.
concurrent	ks. yang terjadi bersama-sama, yang berbarengan. -concurrently kk. bersamaan, berbarengan. the two programs ran c. kedua program itu diadakan bersamaan.
concussion	kb. gegar(an). brain c. gegar(an) otak. the c. shattered a number of windows gegaran itu meremukkan sejumlah jendela.
condemn	kkt. 1 menghukum, menyalahkan. 2 mengapkir. 3 mengutuk. 4 menyalahkan.
condemnation	kb. 1 penghukuman. 2 pengapkiran. c. proceedings against slum housing proses pengapkiran terhadap perumahan jembel.
condensation	kb. 1 kondensasi, pengembunan. c. of vapor kondensasi uap. 2 penyingkatan. c. of a novel penyingkatan sebuah roman.
condense	kkt. menyingkatkan. to c. an easay menyingkatkan karangan. -kki. memadat, menjadi padat, mengembun. -condensed ks. 1 kental. c. milk susu kental. 2 ringkas.
condenser	kb. 1 kondensor, alat penerima dan penyimpan strom listerik. 2 kondensor, alat perubah gas menjadi zat cair. 3 orang yang mempersingkat.
condescend	kki. berkenan merendahkan diri. -condescending ks. rendah diri, bersifat merendahkan diri.
condescension	kb. sikap merendahkan diri.
condiment	kb. bumbu, rempah-rempah.
condition	kb. kondisi, keadaan. to be in good c. dalam keadaan baik. -kkt. 1 memelihara. 2 mempersiapkan. conditioned reflex refleks yang sudah menjadi kebiasaan, refleks yang dipelajari.
conditional	ks. bersyarat. c. surrender penyerahan bersyarat. c. on tergantung pada. gram.: c. mood bentuk pengandaian.
condole	kki. menyatakan belasungkawa, turut berduka cita. we condoled with him over the loss of his brother kami turut berduka cita atas kematian saudaranya.
condolence	kb. belasungkawa, pernyataan simpati turut berduka cita.
condom	kb. kondom, kapocis, sarung.
condominium	kb. 1 negeri/daerah yang dikuasai bersama. 2 (building) flat yang diperlakukan sebagai milik tersendiri.
condone	kkt. memaafkan, mengampuni. it is impossible to c. his actions mustahil untuk memaafkan tindakannya.
conduce	kki. menimbulkan, mengakibatkan. warmth conduces to drowsiness udara panas menimbulkan rasa kantuk
conducive	ks. mendatangkan, menghasilkan, mengakibatkan. exercise is c. to good health latihan mendatangkan kesehatan yang baik.
conduct	kb. tingkah laku, kelakuan. -kkt. 1 memimpin (an orchestra, church service, negotiations). 2 mengadakan, memimpin. -kki. memimpin. -conducting kb. memimpin.
conductible	ks. 1 dapat menyalurkan/mengalirkan. 2 dapat dikendalikan/dipimpin.
conduction	kb. (peng) antaraan, konduksi.
conductivity	kb. daya konduksi.
conduit	kb. saluran, pipa penyalur. cable c. kabel listrik.
conduktor	kb. 1 mus.: pemimpin orkes. tour c. pemimpin pariwisata. 2 rr.: kondektur kereta api. 3 alat konduktor/penerus. rubber is not a c. of electicity karet bukanlah konduktor arus listrik.
cone	kb. 1 math.: kerucut. 2 basung, contong. 3 horen. ice cream c. horen eskrim, es horen. pine c. buah (pohon) cemara.
conerse	kki. berbicara, ngobrol, bercakap - cakap. we conversed for more than an hour kami bercakap-cakap lebih dari satu jam.
confab	kb. inf.: omongan, obrolan.
confection	kb. 1 (candy) manisan, gula-gula. 2 konfeksi, pakaian konfeksi, pakaian jadi (untuk wanita).
confectioner	kb. penjual/pembuat gula-gula, kue dsb. confectioner's sugar gula tepung (lambang : xxxx).
confectionery	kb. (j. -ties) 1 tempat penjualan gula-gula. 2 perusahaan atau toko yang membuat gula-gula.
confederacy	kb. (j. -ties) 1 konfederasi. 2 persekongkolan, persekutuan.
confederate	kb. sekongkol, sekutu.
confederation	kb. konfederasi, persekongkolan, persekutuan. c. of state persekutuan negara-negara.
confer	kkt. (conferred) 1 menganugerahkan 2 berbuat, memberi. -kki. berunding. to c. several days berunding selama beberapa hari.
conferee	kb. peserta konperensi.
conference	kb. 1 konferensi, kongres. press c. konperensi pers. 2 pertemuan. to have a c. with the president mengadakan pertemuan dengan presiden.
conferment	kb. pemberian, penganugerahan.
confess	kkt. mengakui. to c. o's sins mengakui dosa-dosanya. -kki mengaku(i). -confessed ks. yang telah mengaku.
confession	kb. pengakuan. c. of faith pengakuan iman, syahadat. to go to c. melakukan pengakuan (berbuat dosa).
confessor	kb. 1 penerima pengakuan dosa. 2 pengaku iman. c. of the faith penganut agama keyakinan.
confetti	kb., j. konfeti (guntingan kertas berwarna yang dihamburkan pada waktu pesta).
confidant	kb. orang kepercayaan, teman karib. he was the c. of several presidents ia orang kepercayaan beberapa presiden.
confidante	kb. wanita kepercayaan.
confide	kkt. menceritakan sebagai rahasia mempercayakan. -kki. menceritakan rahasianya. he never confides in his father tak pernah ia menceritakan rahasianya kepada ayahnya.
confidence	kb. kepercayaan. in (strict) c. sangat rahasia, dengan rahasia, dibawah empat mata. c. game penipuan oleh seorang. c. man penipu yang membujuk korbannya supaya menaruh kepercayaan padanya.
confident	ks. yakin, pasti. i am c. they will go saya yakin bahwa mereka akan pergi.
confidential	ks. rahasia. c. report laporan rahasia. -confidentially kk. antara kita sama kita, dibawah empat mata.
configuration	kb. bentuk, susunan. the c. of the earth's surface bentuk permukaan bumi.
confine	kb. confines j. batas-batas, perbatasan. -kkt. 1 mengurung, menahan. 2 membatasi. to be confined melahirkan. -confining ks. yang mengikat. office work is very c. pekerjaan kantor sangat mengikat.
confinement	kb. 1 kurungan. he was in c. for robbery ia dalam kurungan karena perampokan. 2 persalinan. she was in c. and unable to attend ia melahirkan dan tak dapat hadir.
confirm	kkt. 1 menegaskan. 2memperkuat. 3 membaptiskan. -confirmed ks. yang ngotot, tetap..
confirmation	kb. penegasan, pengesahan. i want to reserve a room ; please send c. saya mau memesan kamar ; harap kirim penegasan. this news item is subject to c. kabar ini masih memerlukan pengesahan.
confiscate	kkt. 1 menyita (a car, etc). 2 mengambil-alih. to c. a firm's property mengambil milik perusahaan.
confiscation	kb. penyitaan, pengambil alih.
confiscatory	ks. bersifat penyitaan, pensitaan. c. taxes pajak pensitaan.
conflagration	kb. kebakaran besar, lautan api.
conflict	kb. percekcokan, konflik, perselisihan, pertentangan. -kki. bertentangan. -conflicting ks. yang bertentangan.
confluence	kb. pertemuan. the c. of two rivers pertemuan dua sungai.
conform	kki. 1 menyesuaikan diri, mencocokkan diri. 2 sesuai dengan, memenuhi.
conformist	kb., ks. konformis.
conformity	kb. (j. -ties) persesuaian, kecocokan. in c. with your instructions... sesuai dengan instruksi saudara...
confound	kkt. membaurkan, mengacauakan. -confounded ks. luar biasa, jahanam, terkutuk.
confrere	kb. kawan sekerja, teman.
confront	kkt. 1 berhadapan muka, menghadapi. to c. o's accuser berhadapan muka dengan penuduhnya. 2 menghadapkan. i was confronted with a serious problem saya dihadapkan pada masalah yang berat.
confrontation	kb. konfrontasi.
confuse	kkt. 1 membingungkan. 2 keliru dengan. -confusing ks. membingungkan.
confusion	kb. 1 kebingungan, kekacauan. the c. is too much for me kebingungan itu terlalu/keterlaluan bagiku. 2 kekacauan.
confute	kkt. menyangkal, membantah. (an argument).
cong.	1(congress) kongres. 2 (congregation) jema'ah.
congeal	kkt. membekukan, mengentalkan. horror congealed his blood kengerian membekukan darahnya. -congealed ks. menjadi beku. c. blood darah yang menjadi beku.
congenial	ks. 1 menyenangkan. c. work pekerjaan yang menyenangkan. 2 cocok. we two are c. kita berdua cocok.
congeniality	kb. kecocokan, keserasian.
congenital	ks. bawaan. c. defect kelainan/cacad yang dibawa lahir.
congeries	kb. tumpukan, timbunan, kumpulan.
congested	ks. padat, ramai sekali. c. streets jalan-jalan yang ramai sekali.
congestion	kb. 1 kongesti. 2 kemacetan. c. at this intersection is serious kemacetan pada persimpangan jalan ini menghawatirkan. nasal c. hidung tersumbat.
conglomerate	kb. kesatuan, kumpulan, gumpalan, kelompok, konglomerat.
conglomeration	kb. peradukan, percampuran, penggumpalan. this dish is a real c. masakan ini betul-betul campur aduk.
congratulate	kkt. mengucapkan selamat. i c. you on your promotion saya mengucapkan selamat atas kenaikan pangkatmu.
congratulation	kb. ucapan selamat. our congratulations to you ! selamat kami ucapkan kepadamu.
congratulatory	ks. berisi atau bersifat ucapan selamat. c. message pesan berisi ucapan selamat.
congregate	kki. berkumpul, berkerumun. a crowd congregated on the street corner orang banyak berkumpul pada pojok jalan.
congregation	kb. 1 rel.: jema'ah. 2 kumpulan manusia.
congress	1 kongres. labor c. kongres buruh. 2 c. perwakilan rakyat as yang terdiri dari senat dan dewan perwakilan rakyat.
congressional	ks. yang berhubungan dengan perwakilan rakyat amerika. c. record ikhtisar parlemen, risalah perundingan parlemen.
congressman	kb. (j. -men). anggota kongres, anggota perwakilan rakyat as (teristimewa dari dpr).
congresswoman	kb. (j. -women). anggota wanita kongres, anggota wanita perwakilan rakyat as (teristimewa dari dpr)
congruence	kb. kesesuaian, kecocokan, harmoni.
congruent	ks. kongruen, sama dan sebangun. c. rectangle segi-empat panjang yang kongruen.
congruity	kb. (j. -ties) = congruence.
congruous	ks. = congruent.
conguer	kkt. 1 menaklikkan, menundukkan. 2 membasmi. 3 mengatasi. 4 merebut (hati). -conguering ks. yang menaklukkan. the c. hero pahlawan penakluk.
congueror.	kb. 1 penakluk, pengalah, pemenang. 2 perebut hati.
conguest	kb. 1 penaklukan. 2 perebutan hati.
conical	ks. berbentuk kerucut/horen.
conifer	kb. kayu atau pohon jarum.
coniferous	ks. termasuk jenis pohon jarum.
conj.	1(conjungction) kata sambung. 2 (conjugation) pentasrifan.
conjectural	ks. bersifat terkaan. my opinion is purely c. pendapat saya bersifat terkaan melulu.
conjecture	kb. terkaan, perkiraan, dugaan. this is a matter of c. ini soal terkaan. ini terkaan belaka. -kki. mengira, menerka. to c. that mengira bahwa.
