tajak	k.o. hoe used to remove weeds, esp. in paddy field.
tajali	/tajalli/ (islam) k.o. vision of truth.
tajam	1 sharp. 2 incisive, acute.
taji	1 cock's spur. 2 metal spur attached to fighting cock's leg.
tajin	1 thick water from cooked rice often fed to infants as milk substitute. 2 water with starch for ironing.
tajub	see takjub.
tajuk	1 crown. 2 (lit.) ornamental aigrette. 3 (naut.) outward projection on small craft.
tajwid	(islam) proper pronunciation for correct recitation of the koran.
tak	1. no, not. 2. (java) i, by me. 3. see takt.
tak-tak	/tak tak/ sound of cracking, bullet shots, toy machine gun, etc.
tak-tok	/tak tok/ sound of clicking.
tak-umpet	see petak 3.
takabur	arrogant, haughty.
takah	1. (m) 1) appearance, attitude. 2) of suitable bearing. 2. see takuh.
takal	block and tackle.
takan	/ta'kan/ see tak 1.
takar	1 k.o. pottery container. 2 variable unit of liquid or solid measure between o. quart to o. gallon.
takaran	1 measuring container. 2 measurement, dosage.
takat	(lit.) limit, end point.
takbir	(islam) recitation of laudation, "god is great" (allahu akbar) us. at opening of prayers.
takbiran	1 laudations in the form of such recitations. 2 night of last day of fasting month.
takbirul-ihram	(islam) opening laudation of prayer ritual.
takbur	see takabur.
takdim	(islam) opening (of prayer).
takdir	divine decree, fate.
takdis	holiness.
takel	see takal.
taker	see takar.
takeyari	(japanese) bamboo spear.
takhayul	see takhyul.
takhta	throne.
takhyul	superstitious, superstition.
takik	notch.
takikan	extraction of sap.
takil	see petakilan.
takir	(java, jakarta) water container made of banana leaves, palm fronds, etc.
takjal	hastily, hurriedly.
takjil	(islam) sweet food eaten upon breaking the fast.
takjim	see takzim.
takjub	astonishment, astonished.
takkan	see tak 1.
taklid	1 (rel.) unguestioning acceptance of traditional religious interpretations. 2 (coll.) gullible.
taklif	imposition of responsibility or duty.
taklik	1 (lit.) addendum, attachment. 2 (islam) conditions attached to an agreement, esp. marriage contracts so that, e.g., divorce is effected if husband fails to return after a certain time, etc. 3 (leg.) probationary (sentence).
taklikat	(lit.) addendum, marginal notes.
taklim	see takzim.
takluk	subject, subjection.
taklukan	s.t. subjected.
takoa	/takoah/ see takua.
takrau	/takraw/ (sport) rattan plaited into a rough ball (used in traditional games).
takrif	(lit.) definition.
takrim	see takzim.
takrir	(leg.) evidence, proof.
takro	see takrau.
taksa	equivocal.
taksiran	appraisal.
taksiun	(coll.) station.
taksonomi	taxonomy.
takt	takt
taktik	(mil.) tactics.
taktis	taktis
takua	(china) k.o. firm spiced tofu.
takuh	notch.
takuk	notch.
takungan	accumulated water, puddle, etc.
takur	see tekur.
takut	be afraid.
takwa	1. piety. 2. see takua.
takwim	(lit.) almanac, calendar.
takziah	1 visit the home of people suffering death or injury in the family. 2 sympathy, condolence.
takzim	respect, esteem.
takzir	(islam) punishment imposed by a religious court.
tal	(java) k.o. fan palm, the leaves of which were formerly used for writing on.
tala	in tune, harmonious. garpu-tala tuning fork.
talaah	see telaah.
talak	1. 1) (islam) divorce (o.'s wife). 2) divorce formula used by muslim husband. 2. see talk.
talam	tray.
talang	1. (jakarta, java) middleman. 2. eaves trough, gutter.
talas	taro.
talek	see talk.
talen	25 cents, a quarter (of a rupiah).
talenan	1. a quarter, 25 cents. 2. chopping block, cutting board.
tales	see talas.
tali	1 string, cord, rope. 2 line, connection. 3 belt, strap.
tali-talian	vines.
talibun	k.o. old poetry with a distinctive rhyme pattern.
taligram	see telegram.
taligrap	see telegrap.
talipun	see telepon.
talk	talcum powder.
talkin	(islam) instructions to the dead us. at close of funeral to offer advice on what to say when questioned by the angels of death.
talu	1 opening melody at a wayang show. 2 k.o. gong.
taluk	/ta'luk/ see takluk.
talun-temalun	various resounding noises.
talunan	resonance.
tam	plinking sound of small stones hitting s.t. metallic.
tam-tam	small bongo drum.
tama	see pertama.
tamadun	/tamaddun/ (lit.) civilization.
tamah	see ramah.
tamak	1 gread. 2 greedy, covetous.
taman	garden, park. taman-bacaan reading room. taman-bunga flower garden. taman-sari pleasure park, garden. taman-sindria/kanak-kanak kindergarten. taman-margasatwa 1 game preserve. 2 zoo. taman-makam pahlawan military cemetery. taman-pustaka library.
tamasya	1 view, scenery. 2 spectackle, performance. 3 go on an excursion.
tamasyawan	(lit.) tourist.
tamat	1 finished, completed. 2 end, conclusion.
tamatalkalam	/tamatu'lkalam/ (lit.) end of the story.
tamatan	1 graduation. 2 a graduate.
tambah	1 add. 2 additional amount. 3 more, increasingly.
tambahan	1 addition. 2 supplement, extra amount. 3 furthermore..
tambak	1 earthen dam, embankment. 2 fishpond (made by damming). 3banking, leveling off.
tambal	a patch or mend. tambal-ban tire repair. tambal-sulam 1 repair by patching (clothing, etc.). 2 do s.t. in an ad hoc manner.
tambalan	patch, repairs.
tambang	1. mine. 2 1) cross (river) by small boat, dugout, etc. 2) (lit.) fare. 3. (jakarta) thick rope.
tambangan	ferrying, conveyance for ferrying.
tambat	tether.
tambatan	1 mooring buoy or post. 2 tether.
tambeng	(java) disobedient.
tambera	1. 1) (lit.) bronze. 2) bronze inscription. 2. see ikan.
tambi	1 indian. 2 (in some regions only) term of address for young males from india.
tambo	(m) legend, historical traditions.
tamborin	see tamburin.
tambuh	(m) tambuh-ciek have another plate of rice.
tambuhan	additional serving of rice.
tambul	1 dessert. 2 snacks that accompany beverages. 3 beverage refreshment.
tambun	1. chubby, well fed. 2. (m) see timbun.
tambung	rude, impertinent.
tambur	1 drum, esp. of european origin. 2 (islam) mosque drum.
tamburin	tambourine.
tambus	see timbus.
tameng	(java) a shield of combat.
tammat	see tamat.
tammatu'lkalam	see tamatalkalam
tampa	see tanpa.
tampah	(java) winnowing tray.
tampak	1. appear, be visible. 2. (med.) measles.
tampaknya	appartently.
tampal	1 patch. 2 a mend.
tampalan	1 s.t. affixed or stuck on (i.e. a patch, etc.). 2 appendix of a book.
tampan	1 of suitable bearing (esp. of males). 2 appropriate, fitting.
tampang	1. (m) 1) planting seed, cutting for planting. 2) source. 2. (jakarta) wad, roll. 3.1) appearance of a person. 2) put on, show off.
tampar	a slap with the flat of the hand.
tamparan	a slap.
tampek	see tampak 2.
tampel	slight hit, bump.
tampi	winnowing.
tampian	1 s.t. winnowed. 2 winnowing basket.
tampik	see tempik 1.
tampikan	rejection.
tampil	1 step forward. 2 appear before. 3 appear, come into being.
tampin	k.o. rough container made of plaited palm leaves, esp. for sago.
tampuk	1 (biol.) calyx, s.t. like a calyx. 2 any calyxlike design (rosettes, etc.) or calyx-like lid.
tampung	a patch.
tampur	see tempur.
tampus	(m) sorrel color.
tamsil	1 parable. 2 example.
tamsilan	comparison.
tamsir	(lit.) armor.
tamtam	tamtam
tamtama	(mil.) 1 lower-ranking noncomissioned officer, corporal. 2 lower-ranking comissioned officer (below colonel).
tamu	guest, visitor, s.o. who comes to another person's place.
tamyiz	(lit.) discernment of good and bad.
tamzil	see tamsil.
tan	see sutan.
tan-	(java) a privative previx, a-.
tanah	1 land. 2 country, land. 3 soil, ground.
tanahair	father land. tanah-suci (islam) the holy land (mecca and religious shrines of mideast). tanah-tumpah darah birthplace. tanah-lapang 1 field, plain. 2 a square. tanah-kering a dry, unirrigated field. tanah-longsor landslide.
tanahulayat	(m) community land.
tanak	cooked (of rice).
tanaman	1 plants. tanaman-merambat vine. 2 crop.
tanbiat	(rel.) prophecy.
tanbih	(lit.) note the following (of s.t. to be clarified in the following paragraph).
tancap	1 embed s.t. sharp. 2 (coll.) step on the gas, floor it.
tanda	1 sign, token, mark. 2 signal. 3 omen. 4 typographic symbol.
tandak	(java) k.o. dance.
tandan	the stem of the banana (coconut, etc.) plant from which bunches grow.
tandas	1. absolutely wiped out, demolished. 2. latrine over a stream. 3. firm.
tandatangan	signature.
tandem	see sepeda.
tandes	see tandas 3.
tandil	(lit.) foreman, overseer.
tanding	1. match, equal, counterpart. 2. pile, heap.
tandingan	match, equal.
tandon	1 (fin.) security for a loan, collateral. 2 (java) stock, provision, goods provided. 3 (java) reservoir.
tandu	a litter or sedan chair.
tanduk	1. animal horns. tanduk-an kepala (sport) headshot. 2 see tindak.
tandur	tandur-alih transplanting.
tandus	1 empty and infertile (of land), nonarable. 2 wiped out.
tanfidziah	/tanfiziah/ (islam) executive (of religious organization).
tang	1. 1) pliers. 2) tongs, pincers. 2. (mil.) tank. 3. clanging sound of falling metal.
tangan	1 hand, arm. 2. s.t. resembling a hand or arm in shape or function.
tanganan	1 handmade product. 2 s.t. resembling a hand or arm.
tangeh	(java) far away.
tangen	(math.) tangen line or plane.
tangensial	(math.) tangential.
tangga	1 ladder. 2 staircase, stairs. 3 s.t. arranged in levels, s.t. scaled.
tanggah	(lit.) kitchen.
tanggal	1. fall out, come loose. 2. date.
tanggalan	calendar.
tanggam	dovetail (in carpentry).
tanggap	1. perceptive. 2. (java) 1) summon a dalang. 2) perform a wayang.
tanggapan	1.1) idea, conception. 2) reaction. 2. performance of a wayang.
tanggon	(java) reliable.
tangguh	1. 1) strong, hard to defeat. 2) firm, sturdy, of integrity. 2. postponement, delay.
tangguk	small fish scoop or scoop-net.
tanggul	dike, embankment.
tanggulang	(java) sluic-gate.
tanggung	1. 1) guaranteed. 2) bear s.t. 3) responsible. 2. 1) large but not large enough. 2) ill-timed, soon but not soon enough. tanggung-tanggung halfway, halfhearted.
tanggungan	1 burden, load. 2 s.t. or s.o. o. is responsible for. 3 guarantee, bail, security. 4 insurance.
tangis	1 weeping. 2 wail.
tangisan	weeping, crying.
tangkai	1 stalk, stem. 2 stock, shaft, handle. 3 numeral classifier used with slender objects.
tangkal	talisman, amulet.
tangkapan	1 capture, arrest. 2 haul, catch. 3 prisoner.
tangkar	see tengkar.
tangkas	deft, adroit, agile.
tangki	tank for liquids.
tangkisan	defense, resistance.
tangkue	(china) chunks of sweetened squash used in baking.
tangkul	k.o. large net.
tangkup	(lit.) hollow space.
tangkur	(java) seahorse.
tanglung	(china) paper lantern.
tangpu	(java) pawnshop.
tangsel	(java) a wedge.
tangsi	(coll., mil.) barracks.
tangsin	(china) spiritualism, medium.
tani	farmer.
tanjak	slanting upward.
tanjakan	1 steep grade. 2 ascent, climb.
tanji	see tukang.
tanjidor	/tanjidur/ k.o. brass music popular in jakarta.
tanjul	k.o. noose attached to a pole to snare animals, esp. snakes.
tanjung	1. (geog.) cape, promontory. tanjung-harapan cape of good hope. tanjung-hijau cape verde. tanjung-perak the port of surabaya. tanjung-priok the port of jakarta. 2. see bunga.
tanjur	(m) ladle made of coconut shell.
tank	/teng/ (mil.) army tank.
tanker	/tengker/ tanker (ship).
tanki	see tangki.
tanpa	without. tanpa-prasangka without prejudice.
tanpanama	anonymous.
tanpanegara	stateless.
tanpasta	toothpaste.
tanta	see tante.
tantama	see tamtama
tantangan	challenge, defiance.
tante	1 ma'am, form of reference and address for european, china, or westernized women 30 or older. 2. aunt.
tante-tante	of an age to be an aunt.
tantra	(rel.) the tantric sect of buddhism.
tanur	oven, furnace.
tanya	1 question. 2 inquire.
tanzil	(islam) o. who has received a revelation.
taoci	/taoco/ see tauci.
taoge	see tauge.
taokeh	see tauke.
taola	see tuala.
taosi	see tauci.
tap	(coll.) k.o. distilled alcoholic beverage
tap-tap	1 sound of water trickling on water. 2 sound of s.t. small closing (a cigarette case, etc.).
tapa	asceticism, esp. in order to acquire magical powers.
tapai	1. k.o. sweet cake made of slightly fermented rice or tubers.
tapak	1 palm of hand, sole of foot. 2 a rough lineal measure. 3 tracks, footprints. 4 site.
tapak-tapak	(sumatra) k.o. wooden patten or clog.
tapakan	layer, foundation.
tapal	paste, poultice, plaster. tapal-gigi toothpaste.
tapal-batas	frontier, border.
tapal-kuda	horseshoe.
tape	see tapai.
tapekong	see tepekong.
tapelak	see taplak.
tapi	see tetapi.
tapian	(m) see tepi.
tapih	(java) k.o. woman's ankle-length batik wrap around.
tapioka	tapioca.
tapir	tapir, esp. asian species.
tapisan	1 filtered material, filtrate. 2 a filter, sieve.
taplak	tablecloth
tapol	[tahanan politik] political prisoners.
tapsir	see tafsir.
taptu	(mil.) taps, retreat.
tapuk	1. scar, pockmark. 2. see tampuk.
tar	1. snapping sound of whip, firecracker, or pistol shot. 2. see ter. 3. see tart.
tar-tar	sound of repeated pistol fire.
tar-tor	sound of repeated gunfire.
tara	1. 1) matching, equal. 2) counterpart. 2. 1) the weight of the wrapping, etc., containing goods. 2) tare, a deduction from the total weight to allow for this weight.
taraf	1 standard. 2 degree, level.
tarah	planed smooth.
tarak	1 abstinence. 2 abstain from, avoid (eating, etc.).
taram	(lit.) dim. taram-temaram dark.
tarap	see taraf.
tarate	see teratai.
taraweh	/tarawih/ (islam) nonobligatory evening prayers during fasting month.
tarbiah	(islam) education.
tarbus	turkish-style fez.
tarekat	1 (islam) path for mystics to follow, esp. sufism. 2 (lit.) an order of mystics.
target	target.
tari	a dance. tari-gambus k.o. dance to arabian music. tari-gebyar k.o. balinese dance. tari-kejang break dance. tari-lenso handkerchief dance, a folk dance of e. indonesia popular nationally.
tari-tarian	dances, a variety of dances.
tarian	tarian
tarif	tarif
tarih	see tarikh.
tarik	1. pull. tarik-tambang tug-of war. 2. see tarikh.
tarikah	/tarikat/ see tarekat.
tarikan	tarikan
tarikh	1 era. tarikh-hijrah/hijrah (islam) a.h., the era beginning with muh.'s hight to medina. tarikh-masehi (rel.) a.d., the era beginning with jesus. 2 in the year. 3 (lit.) date. 4 (lit.) chronicle, annals.
taring	1 tusk, fang. 2 canine tooth.
tarip	fare, rate.
tarjamah	/tarjemah/ see terjemah.
taro	1. small tarts, cakes. 2 see taruh.
tarok	1. see taro 1. 2. see taruh.
tarompet	see trompet.
tarpentin	see terpenten.
tart	tart
tarub	see tarup.
taruh	(coll.) place s.t., put s.t.
taruhan	1 bet, wager. 2 stake. 3 s.t. saved. 4 security, deposit.
taruk	1. sprout, bud. 2. see taruh.
tarum	indigo plant.
taruna	see teruna.
tarung	1. sound of metallic clashing (swords, etc.). 2. stumble.
taruni	(mil.) female cadet.
tarup	(java) temporary structure (for weddings, etc.). tarup-agung grandstand.
tarwih	see taraweh.
tas	1. bag, handbag, briefcase. tas-kresek k.o. plastic bag. 2. sound of whizzing (bullets or stones hitting a wall, a small explosion, etc.). 3. see kayu 1.
tasak	styptic.
tasalsul	genealogy.
tasauf	/tasawuf/ (islam) mysticism, esp. of sufist school.
tasbeh	/tasbih/ 1 (islam) a formula extolling god's perfection (subhanahu wa taala). 2 (islam) a string of 100 beads to recite this laudation. 3 (rel.) rosary.
tasdid	see tasydid.
tasdik	affirmation, verification.
tasik	lake.
tasiun	(coll.) see setasion.
tasmak	see tesmak.
tasrif	(ling.) 1 conjugation of arabic verbs. 2 inflection.
tasydid	(islam) diacritical mark used to indicate gemination in arabic script.
tasyhid	(islam) pronouncement of the syahadat
tata	order, arrangement, system. tata-acara agenda. tata-bahasa grammar. tata-bentuk (biol., ling) morphology. tata-boga food science. tata-buku bookkeeping, accounting. tata-bunyi phonetics. tata-graha homemaking. tata-busana dressmaking.
tatabahasa	grammar.
tatah	1. inlaid work. 2. see tatih.
tatakalimat	(ling.) syhntax.
tatakan	tatakan
tatakrama	etiquette.
tatal	wood shavings.
tatanama	nomenclature.
tatanan	(java) arrangement, order. tatanan-sosial masyarakat the social order of society.
tatanegara	1 form of gvt. 2 state structure. 3 public institutions.
tatapan	close observation, gaze, etc.
tatarambut	hair dresser.
tataran	rank, level.
tataruang	(art, printing) lay out.
tatarupa	make up, format.
tatawarna	technicolor.
tatih	unsteady steps (of toddler, etc.).
tating	see tatang.
tatkala	(lit.) when, at the time.
taton	see ketaton.
tatu	(java) wound(ed).
tau	(coll.) see tah 1,2.
taubat	see tobat.
taucang	(china) pigtail.
tauci	/tauco, taucyo/ (china) fermented bean paste used as condiment.
taufan	see topan.
taufik	(islam) god's guidance.
tauge	(china) bean sprouts.
tauhid	(rel.) unity of god.
tauk	see tahu 1.
tauke	1 china shop proprietor. 2 employer, boss.
tauladan	see teladan.
taulan	see tolan.
taun	1. /ta'un/ (lit.) epidemic, esp. cholera. see tahun.
taup	see taut.
taurat	1 (islam) the scripture revealed to prophet moses. 2 (rel.) old testament, esp. pentateuch.
tausi	see tauci.
tautan	link.
tavip	[tahun vivere pericoloso] the year of living dangerously (sukarno's speech of august 17, 1964].
tawa	laughter, laugh. tawa-sumbang laughing on the outside but crying on the inside. tawa-terkekeh giggle.
tawaan	1 laughingstock, object of ridicule. 2 mockery.
tawadu	(islam) prescribed ablutions before performing prayer ritual.
tawaf	ceremony of circumambulation of the ka'abah in mecca seven times.
tawak-tawak	k.o. gong used to summon people.
tawakal	tawakal
tawanan	1 military internee. 2 prisoner. 3 captivation, detention.
tawar	1. 1) tasteless, insipid. 2) ineffective (of poison, magic spells, incantations, etc.). 3) undisturbed, at an even temper. 2. bargain.
tawar-tawar	1 unmoved, emotionless. 2 moderate, average.
tawaran	offer, bid.
tawarikh	(lit.) history.
tawas	alum.
tawes	k.o. freshwater fish.
tawon	bee.
tawur	1. engage in a gang fight. 2. see tabur.
tawuran	engage in a gang fight.
tayammun	/tayamum/ islam) ritually purify o.s. with sand in absence of water.
tayangan	1 s.t. held in the palms. 2 (lit.) presentation.
taypak	see taipak.
tayuban	k.o. dance in which male members of audience are invited to join female professional dancers.
tbc	/tebese/ [tuberculosis] tuberculosis.
tc	/tese/ [training center] (sport) training center.
te	see sate.
team	/tim/ 1 (sport) team. 2 team, group for carrying out a project.
teater	drama theater.
teaterawan	dramatist.
tebahan	beating.
tebak-tebak	repeatedly guess. tebak-tebak manggis 1 gamble by guessing the number of segments a particular mangosteen fruit containts. 2 keep guessing.
tebakan	1 guess, conjecture. 2 riddle.
tebangan	felled tree.
tebaran	1 circular, bulletin. 2 seed.
tebasan	produce bought before harvesting.
tebat	1 dam. 2 fishpond created by such a dam.
tebece	/tebese/ tuberculosis.
tebeng	protective temporary screen (e.g. a mat to provide shade, etc.).
teberau	k.o. reedlike plant.
tebese	see tebece.
tebi	see rumput.
tebing	steeply sloping riverbank or mountain side.
tebir	see tabir.
tebu	1 sugar cane. 2 name for various k.o. reeds.
tebuan	see tabuhan.
tebuk	perforation (e.g. eyelet for shoelace, etc.).
tebusan	1 ransom. 2 compensation.
tedarus	(islam) group recitation of koran us. by taking turns, often performed during fasting month.
tedas	(coll.) clear, distinct.
tedeng	(java) protective screen (i.e. to shield from heat). tedeng-aling-aling s.t. used to cover up a criminal or secret act.
teduh	1 calm (following s.t. noisy or violent). 2 shaded, shade.
teduhan	shade, shelter.
tedun	(java) hernia.
teecu	(china, lit., humble) i.
tefakur	/tefekur/ see tafakur.
tega	1 bring o. self to, have the heart to. 2 do s.t. without worrying about the consequences.
tegak	1 upright, erect. 2 standing.
tegakan	an upright clusster, a stand.
tegal	1. (lit.) becouse. 2. /tegalan/ dry (not irrigated) field near the rice fields but used for vegetables and other secondary crops.
tegang	1 taut, tight. 2 tense, strained.
tegap	1 well built, strurdy. 2 steady and unshakable.
tegar	1. stiff, rigid. 2. see tagar.
tegas	1 clear, distinct, explicit. 2 firm, resolute. tegas-nya explicity, in other words.
tegasan	1 affirmation. 2 emphasis.
tegel	1. (java) capable of doing s.t. despicable. 2. /tegel, tekhel/ floor tile.
tegelte	a briquet of tea leaves.
teges	(jakarta) see tegas.
tegor	see tegur.
teguh	1 firm, solidly made or done. 2 tenacious. 3 dependable.
teguk	a swallow or gulp.
tegun	startled.
tegunan	astonishment.
tegur	expressions used to engage o. in a conversation. tegur-sapa words used to open a conversation (greetings, etc.).
teguran	1 warning, reprimand. 2 greeting.
teh	tea (both beverage and leaves). teh-botol bottled or packaged tea. teh-es iced tea. teh-kotak tea to drink in cartons.
tehnik	/tehnis/ see teknik.
tehnikus	see teknikus.
tehnisi	see teknisi.
tehnologi	see teknologi.
teja	yellowish sunset glow. teja-keluang brightness after a rain.
teji	see kuda.
tek	see tik 1.
tek-tek	sound of tapping. bakmi tek-tek china noodle dish sold by street vendors who tap on their woks to attract customers.
teka-teki	1 riddle. teka-teki jenaka conundrum. 2 puzzle.
tekab	[team khusus anti banditisme] special banditry team of police.
tekad	1 determined to do s.t. despite the consequences. 2 strong will, resolve.
tekak	(anat.) 1 soft palate. 2 throat. 3 taste.
tekan	1. pressure. 2. see teken 1,2.
tekap	cover.
tekapan	1 over. 2 dome, cupola.
tekat	tekat
tekdung	1 k.o. homemade rifle used in the revolution. 2 (jakarta) pregnant out of wedlock.
tekebur	see takabur.
tekek	see toke 2.
tekelek	see teklek.
teken	1. (coll.) 1) signature. 2) sign. 2. drawing, sketch. 3. (jakarta) see tekan.
tekenan	1. registration for military service. 2. picture, drawing.
tekeran	flint.
tekhnik	/tekhnis/ see teknik.
tekhnokrat	see teknokrat.
tekhnologi	see teknologi.
teki	k.o. grass the root of which is used in the preparation of emping.
tekidanto	(japanese) grenade hurler.
tekis	(lit.) nearly happen.
teklak-tekluk	(java) bobbing up and down.
teklek	(java) wooden clog with leather straps.
teknik	1 technique. 2 technology, engineering. 3 technical.
teknikus	technician.
teknis	technical.
teknisi	technician.
teknokrasi	technocracy.
teknokrat	technocrat.
teknokratis	technocratic.
teknologi	technology, engineering.
teknologis	technological.
teko	/tekoh/ teapot.
tekong	see tikung.
tekor	(coll.) show a deficit.
tekoran	container made of banana or palm leaves.
tekosi	(coll.) tea cozy.
teks	text. teks-pidato the text of the speech.
tekstil	textile.
tekstur	tekstur
tektonis	(geol.) tectonic.
tekuk	(jakarta) crumpled, bent up. tekuk-lutut bending of the knee.
tekukan	1 fold. 2 tool for folding.
tekukur	large turledove.
tekun	1 diligent, zealous. 2 diligence.
tekur	bend over (of head).
tekwan	k.o. soup with fishballs.
tel.	[teluk] (geog.) bay, gulf.
tela	1. (lit.) pavilion for women in a palace complex. 2. see ketela.
telaah	study, research.
telaahan	research paper.
telabang	(lit.) k.o. shield.
teladan	model, example.
telaga	1 lake, pond. 2 stagnant pit, well.
telah	already (marker indicating a completed action).
telak	right on target, unequivocally.
telan	swallow. telan mentah-mentah utterly defeat.
telangkai	matchmaker.
telangkup	see telungkup.
telanjang	bare, naked. telanjang-kaki barefoot. telanjang-bugil/bulat stark naked.
telanjur	too late (of s.t. already past and irreversible).
telantar	neglected.
telap	1 cause injury (by knives, etc.). 2 vulnerable. 3 (phys.) permeable.
telapak	/telapakan/ 1 palm of hand, sole of foot. telapak-kuda hoof. 2 bottom part of s.t.
telasih	see selasih.
telat	(coll.) overdue, too late.
telatah	o.'s characteristic ways, gestures, movements, etc.
telaten	1 patient, persevering. 2 painstaking.
telau	a spot, stain of color.
teledek	(java) dancing girl.
teledor	negligent, careless.
teledu	k.o. a small badgerlike mammal of sumatra.
telefon	see telepon.
telefonis	by telephone.
telefoniste	female telephone operator.
telegraf	see telegrap.
telegrafis	1 telegraphy operator. 2 telegraphic.
telegram	telegram.
telegrap	telegraph.
telegrapis	see telegrafis.
telek	1. (jakarta) see telak. 2. /tele`k/ (java) bird droppings.
telekomunikasi	telecommunications.
teleks	telex.
telekung	(islam) outermost robe worn by women when praying.
telempap	breadth of hand (a measure).
telempong	(m) k.o. percussion instrument.
telenan	see talenan.
teleng	1. (anat.) pupil (of eyes). 2. /te`le`ng/ at an angle. mata-teleng (sunda) cross-eyed.
telengkup	lie on o.'s stomach.
telentang	see lentang 2.
telep	(sl.) take s.t. without permission.
telepati	telepathy.
telepisi	see televisi.
telepon	telephone.
telepuk	design printed onto cloth with gold or silver foil.
telepun	see telepon.
teler	1. (med.) foul discharge from an infected ear. 2. 1) overexhausted. 2) intoxicated. 3. see es.
teler-teleran	get plastered, get completely drunk.
teleskop	telescope.
teletong	(java) manure, dung.
televisi	television.
telik	see tilik.
telinga	1 ear. telinga-gajah large ears. 2 ear shaped handle. telinga-panci handle of a pan.
telingkah	(lit.) behavior.
telingkup	see telungkup.
teliti	careful, thorough.
telkom	[telekomunikasi] telecommunications (a public corporation).
telop	still photographs shown on television.
telor	1. see telur. 2. having a speech defect.
telp.	[telpon] telephone.
telpon	see telepon.
telu	(lit., java) three.
teluh	magical formula.
teluk	(geog.) bay, cove, gulf. teluk-benggala bay of bengal. teluk-iran persian gulf. teluk-rantau 1 district, region. 2 river bend.
teluk-belanga	(m) k.o. traditional tunic for men.
teluki	see bunga.
telukup	see telungkup.
telungkup	face downward.
telunjuk	index finger.
telur	1 egg, roe, etc. telur-asin salted egg. telur-ceplok fried egg. telur-dadar omelette. 2 (biol.) ovum. 3 a grade or score of zero.
telut	see lut.
tema	theme, topic.
temaah	(m) greedy.
temabur	scattered.
temadun	see tamadun
temaha	/temahak/ see temaah.
temali	see tali.
temambah	(math.) additive.
teman	friend, companion. teman-hidup life's companion, helpmate. teman-sekerja colleague. teman-temin (sl.) male and female friends.
temanten	(java) bride, bridegroom. temanten-baru newlyweds.
temara	(lit.)k.o. spear.
temaram	dark (obscure).
temarang	see terang.
temasa	/temasya/ see tamasya.
tembaga	copper. tembaga-kuning brass. tembaga-merah copper. tembaga-perunggu bronze. tembaga-putih pewter.
tembak	shoot at.
tembakan	1 shooting. 2 shot.
tembakau	/tembako/ tobacco. tembakau-belati imported tobaco. tembakau-kerosok dried tobacco leaf. tembakau-jawa nativegrown tobacco. tembakau-rajangan cut tobacco. tembakau-sek shag tobacco.
tembam	puffed-up (of face).
tembang	sung or recited java poetry.
tembekar	see tembikar.
tembel	1. sty (in eye). 2. see tambal.
tembelek	see telek.
tembem	see tembam.
temberang	garrulous, bombastic, given to boasting.
tembereng	1 potsherd. 2 earthenware. 3 (math.) segment. 4 outer edge, borderline.
tembesi	k.o. tree yielding timber.
tembikai	watermelon.
tembikar	1 glazed porcelain. ceramics, china. 2 earthenware. 3 sherds.
tembilang	spade (for digging).
tembilu	see sembilu.
tembok	masonry wall. tembok-beton concrete wall.
tembokan	stone dam.
tembola	k.o. game of chance, tombola.
tembolok	1 craw, crop. 2 (coll.) paunch.
tembong	(java) spot, esp. facial birthmark.
tembuk	see tebuk.
tembung	(lit.) cudgel.
tembuni	(biol.) afterbirth, placenta.
tembus	1 perforate. 2 emerge. 3 penetrated.
tembusan	1 perforation, penetration. 2 throroughfare, passage, tunnel. 3 carbon copy, esp. for forwarding to s.o.
temebar	1 (java) spread out, dispersed. 2 dispersive.
temen	see teman.
temenan	(java) really, trully.
temenggung	1 ( lit.) title of high-ranking royal official. 2 title of regent (in colonial period).
temerang	see terang.
temin	1. metal band (for reinforcing a handle, etc.). 2. (sl.) female friend.
teminal	terminal.
temonuklir	(phys.) thermonuclear.
tempa	metal handiwork.
tempaan	s.t. made.
tempah	in advance.
tempahan	an order (of some item).
tempang	see timpang.
tempap	see telempap.
tempat	place, spot, location. tempat-persembunyian hideaway. tempat-abu ashtray. tempat-kelahiran place of birth. tempat-pengasingan 1 internment camp. 2 isolation ward. tempat-tinggal residen.
tempaus	k.o. fragrance used in cigarettes.
tempawan	forget, beaten.
tempayak	maggots.
tempayan	k.o. large water jar.
tempe	1 k.o. fermented soybean cake, tempeh. 2 s.t. trivial and unimportant or low grade in quality.
tempel	1 adhere. 2 patch.
tempelak	blame, reproach.
tempelan	1 sticker, poster. 2 attached to s.o. or s.t. 3 revenue stamp.
tempeleng	slapping on the face or ears.
tempelengan	a slap administered.
temperamen	temperament
temperas	(lit.) in complete disarray.
temperatur	temperature.
tempias	a splash, a spray.
tempik	1. a shout. 2. (java) vagina.
tempikan	a cry, a shout.
tempil	see tampil.
templekan	1 (java) be close to e.o. 2 assembling.
tempo	/tempoh/ 1 time. minta-tempo ask for a delay. tempo-hari 1) the other day. 2) formerly. 2 period of time. 3 (coll.) when. 4 tempo. 5 break, interruption.
tempohari	see tempo.
tempolong	cuspidor, spittoon.
temporer	temporary.
tempoyak	k.o. salty condiment made of fermented durian.
tempua	weaverbird.
tempuhan	an attack.
tempuling	harpoon, trident.
tempur	combat.
tempurung	piece of coconut shell. tempurung-kepala (anat.) cranium, skull. tempurung-lutut (anat.) kneecap.
tempuyung	k.o. medicinal plant.
temu	1. wild gingger, generic term for many curcuma species and similar plants. temu-giring k.o. medicinal root. temu-kunci k.o. root used for spice and medicine. temu-kuning / kunyit tumeric. temu-lawak k.o. wild gingger. 2. come together.
temurun	see turun.
tenaga	1 power, energy. tenaga-atom atomic energy. tenaga-batin spiritual power. tenaga-kuda horsepower. tenaga-listrik electric power. 2 personnel, staff, force. tenaga-ahli expert. tenaga-kerja manpower, labor force.
tenang	1 calm, composed. 2 quiet, still.
tenar	1 noise. 2 well known.
tenda	1 tent. 2 awning. 3 top of a pedicab.
tendang	a kick with the heel or side of the foot.
tendangan	(sport) kick. tendangan-pertama kick-off. tendangan-sudut corner kick.
tendas	(lit.) decapitation.
tenden	bid, offer.
tendens	/tendensi/ tendency.
tendensius	tendensius
tener	paint thinner.
teng	1. tank (container). teng-bensin gasoline tank. 2. (china) lantern. 3. sound of a bell.
teng-neng	sound of railway crossing warning bell.
tengadah	gaze upward.
tengah	1 middle, center. 2 among, midst. 3 in the process of.
tengah-tengah	middle.
tengahan	tengahan
tengak-tengok	look about repeatedly.
tengal	(jakarta) badly cooked, tough.
tengara	signal, sign.
tengari	noon.
tenggala	a plow.
tenggalung	k.o. civet cat.
tenggara	south east.
tenggelam	1 sink, be under water. 2 sink below a surface, disappear.
tenggeran	perch, roost.
tenggeret	cicada.
tenggiling	scaly anteater.
tenggiri	spanish mackerel. tenggiri-luding k.o. mackerel.
tenggok	(java, jakarta) basket.
tenggorok	/tenggorokan/ (anat.) throat, larynx.
tengguli	molasses.
tengik	1 rancid, pungent. 2 (coll.) spiteful.
tengil	1. (java) swell. bulge. 2. tending to be sarcastic in a hurtful way.
tengkalang	k.o. rice storage shed on stilts.
tengkar	dispute.
tengkawang	name of several k.o. dipterocarpaceae trees, including those which yield illipe nuts.
tengkek	k.o. bird.
tengki	1 (r.r.) tank car. 2 (gas) tank.
tengkoh	(china) prepared opium.
tengkok	see tengkuk.
tengkorak	(anat.) skull, cranium.
tengku	term of address and reference for certain malay nobility.
tengkuk	1 nape of neck. 2 bunch (of bananas). 3 stalk of rice.
tengkulak	broker, middleman.
tengkuluk	headcloth, turban.
tengkurap	lying flat on o.'s stomach.
tengkuyung	k.o. mollusk.
tenglang	(china) a chinese person.
tengloleng	tengloleng
tengteng	1. k.o. chewy sweet confection. tengteng-gepuk k.o. sweet made with peanuts and sugar. tengteng-jahe confection with gingger. tengteng-kacang k.o. peanut brittle. 2. see tenteng 1.
tengu	k.o. tiny mite or bug.
tenis	/tennis/ tennis. tenis-meja ping-pong, table tennis.
tenong	large, convered container to carry food in.
tenor	tenor.
tensi	(med.) 1 tension. 2 blood pressure.
tensimeter	device to measure blood pressure.
tentamen	(acad.) preliminary examinations.
tentang	1 place directly opposite, facing, or above. 2 exactly at or on. 3 about.
tentara	(mil.) army.
tenteng	1. /tentengan/ things carried in the hand, carry-on luggage. 2 see petentang-petenteng.
tentera	see tentara.
tenteram	quiet, peaceful.
tentir	1 tutorial. 2 preliminary exam.
tentram	/tentrem/ see tenteram.
tentu	1 fixed, definite.2 sure, certain. tentu-nya certainly. of course.
tenuk	k.o. tapir.
tenun	weaving affairs. tukang-tenun weaver. kain-tenun woven cloth.
tenunan	fabric, woven product.
tenung	1 fortune-telling. 2 horoscope. 3 enchantment, wizardry or withchcraft.
tenungan	fortune-telling.
teodolit	(tech.) theodolite.
teokrasi	theocracy.
teolog	theologian.
teologi	/teologia/ theology.
teologis	theological.
teorem	(math.) theorem.
teoretikus	theoretician.
teoretis	theoretical.
teoretisi	theoretician.
teori	theory.
teoris	theorist.
teorisasi	theorizing.
teoritikus	see teoretikus.
teoritisi	see teoretisi.
teosof	theosopher.
teosofi	theosophy.
tep	1. see tip 1. 2. see tik 1.
tepa-slira	(java) principle of putting o.s. in an other's place, i.e. not doing s.t. o. would not want done to o.s.
tepak	1. a light slap. 2. /te`pak/ betel box. te`pak-rokok cigarette case. te`pak-tembakau tobacco pouch.
tepakan	slap.
tepas	1. bamboo wickerworks (used as railing, wall, etc.). 2. (java, sunda) veranda, porch.
tepat	1 exact, precise. 2 appropriate.
tepatan	1 destination. 2 aim, purpose.
tepaut	difference between two quantities, time between two events.
tepdek	tape dect.
tepek	numerel classifier for thin, sticky objects.
tepekong	(china) idol.
tepekur	see tafakur.
teperling	glitter.
tepi	side, edge, periphery.
tepian	1 edge, border, hem. 2 bathing place by the riverbank.
tepo-sliro	see tepa-slira.
tepok	1. worn-out, run-down. 2. see tepuk. 3. /te`pok/ lame.
tepos	tepos
tepuk	light blow.
tepukan	1 clapping, applause. 2 beater.
tepung	1 flour, esp. rice flour. 2 powder. tepung-terigu wheat flour. tepung-kanji cornstarch. tepung-ragi baking powder. tepung-beras pulverize rice.
ter	1. tar. 2. see tir 1.
ter-	ter-
tera	official seal.
teraan	1 seal. 2 imprint.
terabaikan	slighted, ignored.
terabasan	shortcut.
teracung	pointed outward.
terada	see tiada.
terajang	see terjang.
teraju	(lit.) a balance, pair of scales.
terak	slag, cinder. terak-api cinders. terak-dapur kitchen rubbish. terak-nasi hard crust adhering to the rice pot.
terakhir	1 latest. 2 last. 3 ultimate.
terali	latticework, bars (of window), trellis.
teralih	inadvertently shifted.
teraling	k.o. bird.
teram-temeram	(lit.) overcast.
teramat	very.
terampil	see trampil.
terampunkan	terampunkan
terancam	threatened, in danger.
terang	1 clear, bright. terang-bulan 1) moonlight. 2) k.o. pancake with peanuts and other ingredients. 2 evident.
terang-bulan	1 moonlight. 2 k.o. pancake with peanuts and other ingredients.
terang-terangan	frank, open, blunt.
terangguk-angguk	1 uncontrollably nod. 2 toss and pitch (of a boat).
terangkat	terangkat
teraniaya	molested, mistreated.
terantuk	accidentally bump into.
terap	1. k.o. tree, the bark of which is used in making bark cloth. 2. arraging, applying. 3. groove along blade of kris. 4. see tiarap.
terapan	1. applied. 2. inlayed design.
terapeutik	/terapeutis/ therapeutic.
terapi	therapy.
terapis	therapist.
terarah	aimed, directed, guided.
teras	1. 1) (biol.) hard core of certain trees, xylem. 2) essence, nucleus. 3) principal element, elite. 2. /te`ras/ porch, terrace.
terasa	1 felt. 2 feel ( of a part of the body).
terasi	condiment made from pounded and fermented shrimp or small fish.
teratai	k.o. lotus.
teratak	shed, temporary hut.
terawangan	s.t. full of holes.
terawat	be well taken care of.
teraweh	/terawih/ see taraweh.
terbalas	1.answer,reply 2.response 3.revenger 4.reprisal,retaliation.
terban	collapse (dam, riverbank).
terbang	1. 1) fly. 2) disappear. 3) rapidly ascending. 2. (java) k.o. tambourine.
terbawa	1 brought , taken along (accidentally). 2 involved. 3 because of,influenced by.
terbayang	1 be visible 2 be imagined .
terbelangah	1 agape (of mouth). 2 ajar (of door).
terbetik	1. 1) announced. 2) leaked out, come to light (of secret). 2. (in some region only) papaya.
terbirit - birit	1 helter-skelter, hurriedly (scramble). 2 suffer from slight diarrhea.
terbis	terbis
terbit	1 rise, emerge. 2 arise, well up. 3 appear, come out.
terbitan	1 publication. 2 edition, issue.
terbudur	prominent, protruding (of eyes).
terbus	a fez.
terbut	large bolt, stud.
tereak	see teriak.
terem	1. see trem. 2. see tiram.
terenung	lost in reverie.
tergegap- gegap	haltingly, falteringly (in speaking).
tergerus	scraped, rubbed down.
tergoyah	shakable.
tergunting	accidentally cut.
terhadap	1 about, concerning. 2 to, toward.
terhapus	vanished, disappeared.
terhenti	1 stopped, halted. 2 broken off.
terheran-heran	greatly amazed, astonished.
terhibur	consoled, comforted.
terhimpit	1 weighed down. 2 wedged in. 3 be in a tight spot, be in a jam.
terhimpun	collected, assembled.
terhukum	1 sentenced 2 punished .
teri	1 k.o. tiny sea fish. 2 of small importance.
teriak	1 a scream. 2 yell s.t., shout s.t. teriak-an scream, shout.
teriakan	scream, shout.
terigu	wheat.
terik	1. 1) extreme, intense. 2) intenseness. 2. fried spiced beef.
terima	acceptance. terima-jadi ready for occupancy, use, etc. (of house, manufactured product, etc.). terima-kasih thank you.
terinjak - injak	1.trampled upon 2.ignored disregarded.
teripang	sea cucumber, sea slug.
teristimewa	1 special,extraordinary 2 most special,in particular .
teritip	k.o. barnacle.
teritis	/teritisan/ covered passageway (under eaves of house, within covered bridge, etc.).
teritor	territory.
teritorial	territorial.
teritorium	territory.
terjadi	1 happen,occur, take palace 2 consist.
terjajaki	probed, sounded out.
terjal	steep, sheer.
terjang	thrust with part of body, kick the feet, attack, lunge.
terjangan	lunge.
terjangkau	1 achieved, reached. 2 achievable.
terjangkiti	1 conatminated, infected, smitten by (virus, germ, disease). 2 smitten by.
terjeblos	1 step or drive into a hole or ditch. 2 cheated, fooled, tricked. 3 thrown into prison.
terjela	dangling.
terjemah	(islam) translation of the koran.
terjemahan	translation.
terjerumus	1 fall on o.'s face. 2 plunged into misery, sin, etc. 3 fall into a trap, hole.
terjun	1 jump down. 2 enter a field of study or activity.
terka	a guess, conjecture.
terkaan	guess, conjecture, supposition.
terkadang	see kadang 1.
terkam	springing leap of a predator.
terkaman	1 a pounce. 2 grip of a predator.
terkandas	beached,stranded.
terkatakan	can be expressed.
terkatung - katung	1 float. 2 drift, be uncertain, hover.
terkelik	make a gurgling sound (of the stomach).
terkemuka	terkemuka
terkemut	1 throb, beat (of pulse). 2 stagger.
terkendali	restrained
terkepung	1 surrounded, encircled. 2 beleaguered.
terkilir	be sprained.
terkiprah	take action or steps.
terkiwir-kiwir	1 hang and flap loosely. 2 be made to fall hopelessly in love.
terkocak	1 shaken. 2 troubled.
terkocoh - kocoh	hurriedly, in a hurry.
terkun	(dokter dukun) doctor practicing traditional folk medicine.
terkunci	be locked.
terlaksana	carried out.
terlalu	too, exceedingly, very.
terlampau	too, very much so.
terlanting	1 thrown, tossed. 2 no longer useful, useless.
terlecah	1 get stuck in the mud. 2 get a bad name.
terlempar	tossed aside, flung.
terlengar	unconscious, a faint (from a blow).
terlihat	1 seen. 2 visible.
terlingkup	1.covered,veiled (of head ) 2.included,embraced.
terliput	1 covered, enveloped, surrounded. 2 overwhelmed.
terlonjak	1 jump up suddenly. 2 jump (with joy).
terlunta-lunta	be in constant dissiculty, suffer constantly.
terlupakan	forgotten accidentally.
termala	suffering, languishing.
termangu-mangu	1 confused, dazed. 2 taken aback, speechless. 3 thoughtful.
termasuk	included, counted, belonging to.
termasyhur	well-known, famous.
termegah-megah	huff and puff, out of breath.
termik	termik
terminologi	terminology.
termis	thermal.
termit	termite.
termodinamika	(phys.) thermodynamics.
termometer	termometer
termos	thermos bottle.
ternak	livestock. ternak-potong beef cattle.
ternang	(lit.)jug.
ternganga	1 open, agape. 2 amazed, flabber gasted.
terngungu	make such noises.
ternilai	be estimated, given a value.
terobatkan	1 treated s.t. medically. 2 comforted, tempered.
terobosan	penetration.
teromel	see tromel.
teromok	pleasingly plump.
teromol	see tromel.
terompah	k.o. rough wooden or leather clog.
terompet	trumpet, bugle.
terong	see terung.
teropong	1 telescope, binoculars. 2 tube.
teror	terror.
teroris	terrorist.
terorisme	terrorism.
terowongan	tunnel.
