sitar	see siter.
sitegang	see tegang.
sitekan	see tekan.
siten	see seten.
siter	zither.
siti	1 title for a woman of noble lineage. siti-hawa eve. siti-mariam (islam) mary, the mother of jesus. 2 a woman's name.
sitiau	see si 2.
sitiran	citation, quotation (from book).
sitokar	see stoker.
sitologi	(med.) cytology.
sitronella	k.o. plant, citronella.
sitrun	citron.
sitti	see siti.
situ	1. 1) there (not very far away and near person addressed). 2) (coll.) you. 2. (sunda) lake.
situasi	1 situation, circumstances. 2 location, the way s.t. is located.
situn	(lit.) k.o. earthenware pot.
situs	archaeological site.
siul	sound of whistling.
siulan	whistling s.t.
siuman	1 become sober. 2 recover consciousness.
siung	1. 1) canine tooth. 2) fang, tusk. 3) clove (of garlic). 2. sound of bazzing.
siur	1. sound of leaves rustling. 2. see silang.
siut	sound of sizzling, whizzing, etc.
siutan	whizzing sound.
siva	[surat impor valuta asing] foreign exchange import permit.
sivil	see sipil.
sivilisasi	civilization.
siwak	(lit.) bundle of young twigs or roots used to clean teeth.
siwakan	(java) not on speaking terms.
siwalan	(jv) k.o. fan palm or its edible fruit.
siwar	(psychological war] psychological warfare.
siwer	(java) squinting. mata-siwer cross-eyed.
siyet	1 k.o. knitting. 2 wool for knitting.
sk	[surat keputusan] decree.
sk.	[surat kabar] newspaper.
skak	see sekak.
skakelar	see sakelar.
skala	scale (of map, etc.).
skandal	scandal.
skap	tool to plane wood.
skat	1 ice skates. 2 skating.
skema	1 scheme, sketch. 2 chart, diagram.
skematis	schematic.
skena	(thea.) scene.
skenario	scenario.
skeptikus	a skeptic.
skeptis	skeptical.
skeptisi	skeptic.
sket	/skets, sketsa/ sketch.
sketsel	partition.
skizofren	schizophrenic.
skizofrenia	schizophrenia.
skka	[sekolah kesejahteraan keluarga atas] upper secondary school for training home economics teachers.
skm	[sarjana kesehatan masyarakat] master of public health.
skn	[staf keamanan nasional] national security staff.
skop	shovel, spade.
skor	(sport) score.
skorbut	(med.) scurvy.
skorkar	score card.
skorsing	suspension (of student, sportsman, etc.).
skp	[sekolah kepandaian puteri] home economics school.
skrining	screening (of applicants, us. for security reasons).
skrip	(thea.) script.
skripsi	k.o. minithesis to obtain dokterandus degree.
skuadron	/skwadron/ squadron.
skup	see skop.
skuter	(coll.) motor-scooter.
sl-	see also entries with sel-.
sla	1. salad. 2 see slah.
slada	see selada.
slagorde	(mil.) battle-array.
slah	(crd.) trick.
slahrom	/slahrum/ whipped cream.
slametan	(coll., java) ceremonial meal, esp. at marriages, promotions, etc.
slang	1. tube, hose. 2. /sleng/ slang.
slebor	1. (jakarta) mudguard, fender. 2. (coll.) unconventional.
slek	women's slacks often tight.
slendro	five-tone tuning system of java gamelan.
slenger	(auto.) crank, starting-handle.
slintru	(java screen to partition a room.
slip	see selip 2.
sliwar-sliwer	to and fro.
sljj	[sambungan langsung jarak jauh] (tel.) direct-dial long distance network.
slof	carton of cigarettes (unit of 10 packs).
slogan	slogan.
sloganisasi	sloganizing.
sloganisme	mentality characterized by excessive use of slogans.
sloki	1 shot glass. 2 a shot (of liquor).
slompret	1. trumpet (us. made of paper). 2. see sompret 1.
slong	/nge-slong/ not working (of brakes).
slop	see slof.
slot	see selot.
slt.	[selatan] south.
sm	1. [sekolah menengah] secondary school. 2. [sarjana muda] academic degree similar to the baccalaureate.
sm.	[sebelum masehi] b.c., before christ.
sma	[sekolah menengah atas] upper secondary school.
smir	see semir.
smokel	see semokel.
smp	[sekolah menengah pertama] lower secondary school.
snel	(coll.) fast.
snelvarband	long gauze bandage.
snur	(coll.) cable, wire, cord.
so	(e. indonesia) see sudah.
so'un	see sohun.
soal	/so'al/ 1 problem, matter. 2 question.
sob	[staat van oorlog en beleg] (pol.p state of war and siege.
sobat	1 friend. 2 comrade (among communists).
sobek	torn, ripped.
sobekan	a torn piece.
sobok	alloy.
sobsi	[sentral organisasi buruh seluruh indonesia] all-indonesia federation of labor organizations.
soda	soda (of various substances containing sodium).
sodet	1. spatula. 2. see sudet.
sodok	shovel, spade.
sodokan	1 a poke. 2 (sport) shot in billiards. 3 instrument to poke or thrust.
sodomi	sodomy.
soe	(china) bringing misfortune, unlucky.
soek	see sobek.
soen	/sun/ see sun.
sofa	sofa.
sofis	sophist.
sofisme	sophism.
softball	/softbol/ (sport) softball.
soga	k.o. tree from which red dye used for batik is made.
sogang	fence, palisade.
sogok	1. (coll.) bribery. 2. stab, pierce through.
sogokan	bribe.
sohon	see sohun.
sohor	famous.
sohun	(china) transparent bean flour vermicelli.
sok	1. 1) as if, pretending. 2) put on airs. 2. /sok/ stocking, sock. 3. /sok/ socket, waterpipe connection. 4. see syok 2.
sok-sok	(java) often.
sok-sokan	putting on airs, showing off.
soka	k.o. flowering tree.
sokbreker	(auto.) shock absorber.
soklat	(coll.) see coklat.
sokoguru	1 (java) central pillar (of house). 2 princippal factor.
sokong	prop, support.
sokongan	support, aid, contribution.
sol	1. sole (of a shoe). 2. the musical note sol.
solar	diesel fuel.
solat	(islam) 1 ritual prayers and actions performed five times daily. 2 perform such prayers.
soldadu	see serdadu.
solderan	soldering tool.
soleh	see saleh.
solek	well-dressed, stylish.
solidaritas	/slidaritet/ solidarity.
solider	in solidarity with.
solis	soloist.
solo	single, solo.
solok	gift, contribution in kind.
solokan	see selokan.
solot	(jakarta, java) heatedly angry.
solvabilitas	solvency.
som	a hem.
somah	houshold. somah-seperut maternally related family (but with different fathers).
somatis	somatic.
sombar	(ambon) shade, shadow.
sombong	arrogant, conceited.
sompek	chipped, broken off.
sompret	1. (jakarta) dammit !, term of verbal abuse. 2. see slompret 1.
somsom	(jakarta) conceited, arrogant.
sondak	see sundak.
sonder	(coll.) without.
sondolan	a forceful push (with the head).
sondong	k.o. net for catching shrimp.
sondor	see sodor.
sonebril	(coll.) sunglasses.
soneta	sonnet.
songar	proud, arrogant.
songgeng	1. protrude. 2. see sungging.
songket	see sungkit 1.
songkok	rimless fezlike cap us. made of velvet.
songpia	(china) k.o. small fried spring-roll us. filled with finely shrodded meat.
songsang	see sungsang.
songsong	1. (java) k.o. ceremonial umbrella of royalty. 2. against.
songsongan	welcome.
sono	1. (jakarta) place of origin. 2. (jakarta) see sana.
sontak	torn, damaged, broken off.
sontok-akal	see suntuk.
sontoloyo	(coll.) exclamation of disapproval or dislike, damn you. !.
soon	see sohun.
sop	soup.
sopak	1. k.o. discoloration of the skin. 2. (java) hairpiece.
sopan	1. respectful. 2. well mannered, decorous.
sopek	k.o. small traditional fishing boat.
sopi	1 distilled palm wine. 2 (lit.) liquor.
sopia	see songpia.
sopir	chauffeur, driver.
sopran	soprano.
sorak	applause, cheering.
sorakan	cheer, yells.
sorang	(coll.) alone.
sorangan	(sunda) alone, on o.'s own. sorangan-wae` all alone, single.
sorban	see serban.
sore	afternoon, early evening (between three and six p.m.).
soreh	see surih.
sorek	bamboo.
sorenya	the following afternoon.
sorga	see surga.
sorgaloka	(lit.) heaven, paradise.
sori	(coll.) excuse me !.
sorjan	see surjan.
sorok	1. see sogok 1. 2. see suruk.
sorong	1 sliding, pushing. 2 bribe.
sorongan	1 s.t. pushed or shoved (e.g. a bolt). 2 a bribe. 3 a push, shove.
sorot	ray, beam of light (of lamp, sun, etc.).
sorotan	1 ray, beam. 2 radiation, spotlight. 3 attention (in press, public, etc.).
sortasi	sorting, grading.
sos.	[sosial] social studies division.
sosbud	[sosial budaya] sociocultural.
sosi	(china) key (to lock, etc.).
sosial	1 social. 2 charitable.
sosialis	socialist, socialistic
sosialisasi	socialiszation.
sosialisme	socialism.
sosialitas	charitableness, charity.
sosiatri	measurement of social behavior, esp. as a field of study.
sosiawan	a social-minded or altruistic man.
sosiawati	a social-minded or altruistic woman.
sosio-budaya	sociocultural.
sosio-nationalisme	socialist nationalism.
sosiografi	social ethnography.
sosiolinguistik	sociolinguistics.
sosiolog	sociologist.
sosiologi	sociology.
sosiologis	sociological.
sosis	sausage.
sositet	social club (colonial period).
soska	[sosialis kanan] right-wing socialist.
soski	[socialis kiri] left-wing socialist.
sosok	1. 1) buttonhole, eye. 2) noose, loop. 2. 1) form, shape, frame. 2) numeral classifier for body.
sosong	see songsong 2.
sosor	bill (of duck, etc.).
sospol	[sosial dan politik] 1 social and political science. 2 university division of social and political sciences.
sosuio-psikologi	social psychology.
soto	k.o. clear soup. soto-ayam chicken soup. soto-babat tripe soup. sop-daging beef soup. soto-mi/mie noodle soup. soto-madura madurese-style soup (with potato croquettes).
sotoh	flat roof, roof-terrace.
sotong	cuttlefish, squid.
sovyet-uni	soviet union.
sowan	(java) visit (s.o. of higher status).
sp	[sri paduka) his excellency, title for kings and at o. time the president of indonesia.
sp-	see also entries with sep-.
spada	a call to announce o.'s arrival at a house, anybody home ?
spak	wheel spoke.
spalek	/spalk/ splints.
span	see sepan.
spanduk	street banner affixed on both ends.
spaneng	/spaning/ voltage.
spanrok	k.o. tight skirt.
spanyol	see sepanyol.
sparepart	/sperpar/ spare parts.
spasi	space (in typing, etc.).
spatbor	/spatbord/ (auto.) fender, mudguard.
speedometer	/spidometer/ speedometer.
spekkuk	see spekuk.
spektakuler	spectacular.
spektograf	spectograph.
spektogram	spectogram.
spektrum	spectrum.
spekuk	k.o. multilayered butter cake.
spekulan	(fin.) speculator.
spekulasi	1 speculation, conjecture. 2 risky commercial venture. 3 undertake a risky venture.
spekulatif	speculative.
spekulator	speculator.
speling	1 synchronization of mechanical parts. 2 erratic (of o.'s behavior).
sperma	(biol.) sperm.
spesi	(biol.) species.
spesial	special.
spesialis	specialist.
spesialisasi	specialization.
spesialitas	specialty.
spesies	(biol.) species.
spesifik	1 specific. 2 characteristic (of certain place or ethnic group).
spesifikasi	specification.
spidol	felt-tip marker.
spiku	see spekuk.
spion	1 spy. 2 reaview mirror.
spionase	espionage.
spir	unus. well-developed muscle. spir-lengan biceps.
spiral	1 piral. 2 (med.) intrauterine birth control device.
spiralisasi	program for getting the population to accept intrauterine birth control devices.
spiran	(ling.) spirant.
spirit	(coll.) enthusiasm, vigor.
spiritual	/spirituil/ spiritual.
spiritus	/spirtus/ methylated spirit, rubbing alcohol.
spon	/spons/ foam rubber sponge.
sponse	see besi.
sponsor	sponsor (of contest, etc.).
spontan	spontaneous.
spontanitas	spontaneity.
spor	/sport/ (coll.) 1 sports. 2 exercise.
spora	(biol.) spore.
sporadis	sporadic.
sportif	1 sportsman like, fair. 2 casual 9of clothing).
sportifitas	/sportivitas/ sportsmanship.
sportip	see sportif.
sprei	see seprai.
spreken	(coll.) speak dutch.
spt.	[seperti] as, like.
spuit	/spoit/ syringe.
spura	see spora.
sput	see seput.
spy.	[supaya] so that.
sr	[sekolah rakyat/rendah] elementary school.
sr-	see also entries with ser.
sr.	[suster] title of catholic nun.
sreg	(java) 1 well fitting, comfortable. 2 comfortable, at ease. 3 appropriate (of o.'s behavior).
srempeng	(java) enthusiastic.
srempet	see serempet.
sri	see seri 1.
sribombok	(java) k.o. long-necked waterbird.
srikandi	1 a heroin, arjuna's wife, in some old romances and wayang. 2 heroine.
srikaya	see serikaya 1.
srimpet	see serempet.
srimpi	(java) k.o. court dance.
srimpung	see serimpung.
sripah	1. (java) the deceased. 2. see syarifah.
sripanggung	see seri 1.
srrrt	written representation of sound of zipping or squirting.
srt.	[surat] letter (correspondence).
sruput	sound of a slurp.
ss	[sarjana sastra] bachelor's degree in literature.
ssk.	[surat-surat kabar] newspapers.
ssksd	[sekolah staf dan komando angkutan darat] (mil.) army command and staff school.
sss	[suka sama suka, senang sama senang] by mutual consent (esp. with regard to sex and marriage).
ssssst	/st/ hush ! (sound made to silence s.o.).
st-	see also entries with set-.
st.	[sutan] (m) title of nobility.
staar	see star.
stabil	stable.
stabilisasi	stabilization.
stabilisator	stabilizer, stabilizing factor.
stabilitas	stability.
stabilo	1 light color marking pen to highlight text. 2 neon-colored.
stabiloan	traces of marking with such a pen.
stadia	(med.) stages of a disease.
stadion	stadium.
stadium	(med.) stage of a disease.
staf	staff.
stagen	(java) women's waist sash or cummerbund.
stagnasi	stagnation.
staking	(coll.) a strike (work stoppage).
stalles	(coll.) center seats in a theater.
stambom	1 lineage. 2 pedigree (of animals).
stambuk	ledger.
stambul	k.o. stage show often featuring indigenous versions of western drama.
stamina	stamina.
stan	/stand/ 1. (sport) score. 2. stand, small shop (in recreation or shopping centers).
standar	1. standard. 2. bicycle or mortorcycle kickstand. 3. (mil.) standards, emblems of an army, etc.
standardisasi	standardization.
stang	1 bar (of vehicle, engine, etc.). 2 handlebar of a bicycle. 3 (coll.) control s.o. or s.t.
stanplas	/stanplat/ bus stop.
stansa	stanza.
star	(med.) catatact.
start	1 (coll.) begin a journey. 2 (sport) start.
starter	1 (auto.) starter. 2 (elec.) flourescent light starter.
stasi	(rel.) station of the way of the cross.
stasioner	stationary.
stasiun	see setasion.
stater	see starter.
statif	stative.
statis	static, stationary.
statistik	1 statistics. 2 statistical, according to statistics.
statistikus	statistician.
statistisi	statisticians.
status	status.
statuta	/statuten/ statutes.
stek	see setek.
steker	1 electrical plug, light switch. 2 cigarette lighter.
stel	see stil.
steling	(mil.) 1 installation, camps. 2 position. 3 take a position.
stelsel	system.
stembat	see stimbat.
stempel	see setempel.
stempet	lubricating grease.
sten-gun	k.o. machine gun.
steno	/stenografi/ stenographer.
stensilan	1 a stencil. 2 mimeographed materials.
stepa	(geog.) steppe.
ster	(che.) queen.
sterek	(coll.) 1 strong, full-flavored (of beverages). 2 strong and healthy.
stereokopis	stereoscopic.
stereometri	geometry.
stereotip	stereotype.
steril	sterile.
sterilisasi	sterilization.
stetoskop	stethoscope.
steup	see stuip.
stewal	see setiwal.
stiker	sticker, decal.
stil	1 (sl.) stylishly dressed. 2 have a certain attitude.
stilistika	stylistics.
stimbat	(coll.) steam bath.
stimulans	stimulant, stimulus.
stimulasi	stimulation.
stip	see stuip.
stir	see setir.
stki	[surat tanda kewarganegaraan indonesia] indonesian citizenship card.
stl.	[setelah] after.
stm	[sekolah tehnik menengah] technical high school.
stnk	surat tanda nomor kendaraan] motor vehicle license.
stock	/stok/ stock, supply.
stoker	(r.r.) engineer's helper.
stoking	women's stockings.
stop	see setop 1.
stopkontak	electric socket, plug.
stoples	stoppered glass jar for storing food.
stopmap	folio-sized folder.
stor	see setor.
storemking	see stromking.
storing	radio static, disturbance.
strap	see setrap.
strat	(coll.) street.
strata	levels (in society, education).
strategi	strategy.
strategis	strategic.
stratifikasi	stratification.
stratigrafi	stratigraphy.
stratosfer	see stratosfir.
stratosfir	stratosphere.
stratum	stratum (of soil, society, etc.).
streng	(coll.) strict, severe.
streples	strapless (bra, gown, etc.).
strimin	k.o. coarsely woven fabric used for lining.
strip	see setrip 1.
striptis	(sl.) strip-tease.
stromking	/strongking/ high-pressure kerosene lantern.
stroom	/strom/ see setrum.
structuralisme	structuralism.
struktur	structure.
struktural	structural.
strukturil	see struktural.
struma	(med.) goiter.
sttb	[surat tanda tamat belajar] diploma for primary or secondary school.
studen	(coll.) student.
studi	1 study. 2 research.
studio	studio.
studium-generale	k.o. introductory general studies course.
stuip	/step/ convulsions, fits (esp. accompanying children's fevers).
stupa	stupa. dome enclosing an effigy of buddha.
su	1. see sudah. 2 see bungsu.
suai	see sesuai.
suak	1. (lit.) inlet, small bay. 2. (m) cancel. 3. see swak.
suaka	1. 1) asylum. 2) sanctuary. 2. see sewaka 1.
sual	see soal.
suam	warm. suam-suam rather warm.
suami	husband.
suang-suang	(lit.) tak-suang-suang not easy.
suangi	(lit., ambon) k.o. prowling, nocturnal evil sorcerer.
suap	1 a mouthful. 2 bribe.
suapan	1 act of eating with the hand. 2 bribe.
suar	signal light, flare.
suara	1 voice. 2 sound. 3 vote.
suarang	(m) joint property of husband and wife acquired during marriage.
suargaloka	see sorgaloka.
suari	see kasuari.
suasa	gold with large alloy mixture, pinchbeck.
suasana	1 milieu. 2 ambience, atmosphere.
suatu	a certain (unspecified).
subahat	see syubhat.
subak	(bali) water-control system.
suban	splinter, sliver of wood.
subang	ear-plugs.
subhanahu-wa-taala	1 (islam) praise be unto thee the almighty, a laudation uttered upon completion of o.'s ritual prayers or upon mentioning one of god's names. 2 (islam., coll.) lord ! exclamation of surprise.
subjek	see subyek.
subjektif	subjective.
subjektivisme	subjectivism.
subjektivitas	/subjektivitet/ subjectivity.
subkomisi	subcommission.
subkutis	subcutaneous.
sublim	sublime.
sublimasi	sublimation.
subordinasi	subordination.
subordinat	(ling.) subordinate.
subsider	1 (leg.) with the option of. 2 subsidiary, secondary.
subsidi	subsidy, subsidized.
substantif	substantive
substitusi	substitution.
substratum	(ling.) substratum.
subtil	subtle.
subtropis	subtropical.
subuh	1 dawn, daybreak. 2 (islam) the early morning prayer.
subur	1 fertile. 2 thriving, prosperous. 3 healthy.
suburban	/suburben/ k.o. automobile formerly used for interurban passenger transportation.
subversi	subversion.
subversif	subversive.
subyek	1 subject, topic of discussion. 2 (ling.) subject.
subyektif	/subyektip/ see subjektif.
subyektivisme	see subjektivisme.
suci	1 pure, purified. suci-hama sterile, aseptic. 2 holy.
suda	bamboo spikes sticking upward to form a mantrap.
sudah	1 already, as of a certain point in time. 2 past, last. 3 done, finished. 4 good-bye. 5 all right, i agree. 6 never mind, don't. sudah-nya finally. se-sudah after.
sudahnya	finally.
sudara	/sudare/ see saudara.
sudetan	1 incision. 2 waterway diversion.
sudi	1. 1) acquiesce, be agreeable. 2 please (formal). 2.(m) sudi-siasat interrogation.
sudip	k.o. used for mixing culinary ingredients.
sudit	see sodet.
sudra	(lit.) lowest hindu caste.
sudu	1 goosebeak, duckbill. 2 k.o. large spoon. 3 convex blade, (of machine, etc.).
suduk	see sodok 2.
sudung	1 hut, esp. in agricultural field. 2 polite self-deprecating term for o.'s own house.
sudut	1 corner. 2 (math.) angle. 3 direction. 4 point of fiew.
suf	wool cloth.
sufi	1 mystical, esp. related to sufism. 2 a sufic mystic.
sufiks	(ling.) suffix.
sufisme	sufism.
sufrah	floorcloth or carpet on which ceremonial meals are spread out.
sugesti	power (hypnotic, etc.) to direct another's actions.
sugestif	1 having the power to direct another's actions. 2 suggestive (of lewd dances, etc.).
sugi	1. toothpick. 2. (m) tobacco quid, esp. chewed with betel.
sugih	(java) wealthy.
suguhan	s.t. presented (e.g. food served to guests, a drama performance, etc.).
sugul	(coll.) see masygul.
sugun	(lit.) tangled, tousled (of hair).
suh	1. schoo ! (exclamation to drive away animals, esp. chickens). 2. 1) (java) broom binding (of plaited rattan, etc.). 2) a binding factor which keeps diverse elements together.
suhanura	[suara hati nurani] the voice of o.'s inner heart.
suhu	1 temperature. 2. 1) teacher of the art of self-defence. 2) (china) healer.
suhuf	(islam) scriptures inspired by god.
suikher	see seher.
suit	sound of whistling.
suitan	a whistle, whistling.
sujadah	see sajadah.
sujen	(java) skewer (for meat).
sujian	embroidery.
sujud	(islam) 1 bow from kneeling position so that forehead touches floor, a part of prayer ritual.
suka	1 happiness, joy, pleasure. 2 like, be fond of. 3 be willing, would like. 4 be apt to.
sukaan	1 sweetheart, darling. 2 favorite.
sukacita	1 happy, glad, merry. 2 joy, happiness.
sukamandi	(java) k.o. dark cotton cloth.
sukar	hard, difficult.
sukarela	voluntary.
sukarelawan	a volunteer.
sukarelawati	woman volunteer.
sukaria	1 happy. 2 delight, pleasure.
sukat	1 unit of measure of four gantang or 12.6 liters. 2 measure.
sukatan	measure.
suklih	(coll.) searchlight.
sukma	life spirit, soul.
sukses	1 success. 2 be successful.
suku	1. 1) a quarter, one-fourth. 2) a part. 3) extended family, ethnic group. 4) (biol.) family. 5) (lit.) 50 cents. 2. (java) leg. 3. (ling) syllable.
sukuisme	communalism, ethnocentricity.
sukun	1. breadfruit. 2. (java) toothless gum. 3. diacritical mark in arabic script to indicate presence of a vowel.
sukur	see syukur.
sukwan	[sukarelawan] volunteer.
sukwati	[sukarelawati] female volunteer.
sula	sharp vertical stake (for impalement or for husking coconuts). sula-an sharp stake.
sulaan	sharp stake.
sulah	(lit.) bald, hairless.
sulaiman	(bib., islam) solomon.
sulak	a (feather) duster.
sulalat	1 descent, lineage. 2 family tree.
sulam	embroidery.
sulaman	embroidery, embroidered goods.
sulang	lampblack, soot.
sulap	1. conjuring, sleight of hand. 2 (java) dazzled (as if by magic).
sulat-salit	(lit.) irregular (of teeth).
sulawesi	celebes, sulawesi.
sulbi	(anat.) the vertebrae.
sulfa	medicinal powder containing a sulfanilamide drug.
sulfur	sulphur.
sulih	(java) a substitute.
suling	1.flute. 2. suling-an 1) distillate. 2) refinery.
sulit	1 difficult, hard, complicated. 2 (lit.) secret, hidden, secluded.
sulselra	[sulawesi selatan dan tenggara] s. and south east sulawesi.
sultan	sultan.
sultanat	sultanate.
suluh	1 torch. 2 (lit.) scout, spy.
suluk	1 mysticism. 2 ( java) recitation of a wayang narrator.
sulung	oldest, first-born.
sulur	1 spiraling upward (of plants).
sulur-bulur	confused, incohernt (of speech).
suluran	climbing plant.
sulut	[sulawesi utara] north sulawesi.
sulutteng	[sulawesi utara dan tengah] north and central sulawesi.
sum.	[sumatera] sumatra.
sumang	feverish, esp. of children.
sumangat	see semangat.
sumarak	see semarak.
sumba	see kesumba.
sumbang	1. 1) incestuous. 2) illicit (esp. in sexual matters). 3) out of tune, discordant. 2. contribution.
sumbangan	contribution.
sumbangsih	contribution.
sumbar	(java) boast, brag.
sumbat	stopper, plug.
sumber	1 well. 2 source. 3 resources.
sumbi	rod used in weaving to hold edge taut.
sumbing	jagged, dented, chipped. bibir-sumbing harelip.
sumbu	1. 1) wick. 2) fuse. 2. 1) wagon axle. 2) pivot, axis. 3. horn of a rhinoceros.
sumbul	(java) k.o. basket with a lid.
sumbut	(java) in balance with the efforts or costs, worthwhile.
sumilir	see semilir.
sumir	short, brief, succinct.
sumirat	(sunda) beam, glowing.
sumpah	1 oath. 2 curse.
sumpah-sumpah	k.o. flying lizard.
sumpal	(java) stopper.
sumpalan	s.t. obstructing a passage.
sumpek	(java) 1 crowded. 2 feel stifled, have o.'s head in a whirl because of problems.
sumpel	see sumpal.
sumping	(java) k.o. ear ornament worn in classical dance.
sumpit	1. chopsticks. 2. blowpipe. 3. k.o. coarse, plaited storage bag, esp. for rice or salt.
sumpit-sumpit	k.o. coarse, plaited storage bag, esp. for rice or salt.
sumpitan	sumpitan
sumsel	[sumatera selatan] south sumatra.
sumsum	(anat.) marrow. sumsum-(tulang) belakang spinal cord.
sumteng	[sumatera tengah] central sumatra.
sumuhun-dawuhisme	mentality characterized by sycophancy.
sumur	well.
sumurung	outstanding.
sumut	[sumatera utara] north sumatra.
sun	kiss on the cheek.
sunah	see sunat2.
sunan	1. title for the holy men who first brought islam to java. 2. (java) ruler of surakarta.
sunat	1. circumcision. 2. /sunat rasul/ (islam) optional, but meritorious if performed (of pious deeds, prayers, etc.).
sunbulat	(zod.) virgo.
sunda	sundanese, the sunda area (west java).
sundai	see limau.
sundal	/sundel/ 1 prostitute. sundal-bolong k.o. evil female spirit (with a hole in her back). 2 lewd, immoral. 3 (vul.) whore !, a strong exclamation of disapproval.
sundul	see sondol.
sundut	(m) generation, descent.
sungai	river, stream. sungai-mati 1 driver river. 2 road full of holes and stones.
sungga	(lit.) spike or sharp stake implanted at angle to impede enemy's progress.
sungging	painting, decoration.
sunggit	see sungkit 1.
sungguh	1 true. 2 really, truly. 3 actually, in fact.
sungguh-sungguh	seriously, wholeheartedly.
sungguhan	(coll.) serious, in earnest.
sungguhpun	see sungguh.
sungkal	(lit.) sungkal-bajak plowshare.
sungkan	(java) reluctant to approach or take action toward s.o. of higher status.
sungkawa	see belasungkawa.
sungkem	1. (java) show respect by kneeling and pressing o.'s face to another's knees. 2. (lit.) prop up.
sungkit	1. embroidered with bits of gold or silver thread. 2. pry out.
sungkup	concave cover or shelter.
sungkupan	k.o. basket.
sungkur	spade, shovel.
sunglap	see sulap 1.
sungpia	see songpia.
sungsang	1 upside down. 2 against the grain.
sungsum	see sumsum.
sungu	(java) horn of animal.
sungut	1. 1) (biol.) a specialized organ of touch in an animal or insect (e.g. tentacle, antenna, feeler, etc.). 2) moustache. 2. sungut-an grumbling complaint.
suni	(islam) pertaining to the sunnite movement.
sunjam	(lit.) head downward.
sunnah	see sunat 2.
sunni	see suni.
sunti	knob on gingger root.
suntikan	injection, vaccination.
suntil	chewing tobacco.
sunting	1. ornament or flower worn behind the ear. 2. sunting-an editing.
suntuk	1 too late. 2 be overtaken by events or time. 3. entire length of time.
sunyata	(lit.) true.
sunyi	1 lonely. 2 quiet. 3 deserted, desolate.
sup	see sop.
supaya	1 so that. 2 please, particle introducting a polite command.
supel	1 flexible. 2 sociable.
super	1 high-octane (of gasoline). 2 (coll.) superior.
superioritas	superiority.
supermi	instant noodles.
supersemar	[surat perintah sebelas maret] document handing over the gvt. power from sukarno to suharto.
supervisi	supervision.
supir	see sopir.
supit	see sumpit.
suplai	supply.
suplemen	supplement.
suporter	(sport) enthusiast, fan.
supra-alami	supernatural.
supremasi	supremacy.
sur	see syur 1.
sura	see asyura.
surabi	see serabai.
surah	(islam) division of the koran, a sura.
surai	(lit.) dressed or parted (of hair, animal fur, etc.).
surakarta	solo, city in central java.
suralaya	(lit.) dwelling of the gods.
suram	1 vague, hazy. 2 gloomy, dark, dull.
surat	1 letter, epistle. 2 certificate, receipt, document.
suratan	1 writing. 2 fate, destiny.
surau	(islam) prayer-house, communal building suitable for any devotion except friday prayer.
suren	see jalak. /sure`n/ (java) see surian.
surga	heaven. surga-dunia an earthly paradise.
surgawi	heavenly, pertaining to heaven.
suri	1. shuttle comb on a weaving loom. 2 see ibu.
suri-teladan	good example, model.
suriah	syria.
surian	k.o. tree.
surih	(m) a scratch or line.
surjan	(java) long-sleeved man's jacket us. of woven, striped material.
sursak	see sirsak.
suruh	1 (coll.) be ordered to. 2 order s.o. to do s.t.
suruhan	1 message, order. 2 messenger, delegate.
surukan	1 hiding place, shelter. 2 (coll.) drawer.
surung	see sorong.
surup	(java) fitting, proper, appropriate
surut	1 withdraw. 2 lessened, subsided.
survai	/survei/ 1 research. 2 to survey.
surya	(lit.) sun.
suryahi	(lit.) syrian.
suryakanta	magnifying glass.
sus	1. see kue. 2. see zus.
susah	1 troubled. 2 hard to get. 3 difficult, bothersome.
susastera	literature.
susi	sister, term of address to catholic nun.
susila	1 decent, well behaved. 2 decency, morality.
susis	see sosis.
suspensi	1. (leg.) suspension, adjournment. 2. (phys.) suspension.
suster	1 catholic nun. 2 term of reference and address for a female nurse. suster-an convent.
susu	1 breast. 2 milk.
susuan	(java) nest.
susuh	1 large projecting thorn or hook. 2 spur.
susuhunan	(java) title of the ruler of surakarta.
susuk	1. 1) small piece of gold or diamond inserted in the face as a magical charm to improve o.'s beauty. 2) pin, nail. 3) (med.) implant. 2. (java) surplus change after payment. 3. see sosok 2.
susukan	(java) channel between two rivers.
susulan	1 appendix, supplement. 2 continuation.
susun	1 stack, orderly pile. 2 row, series. 3 arranged in a stack.
susunan	1 composition, compilation. 2 formation, structure.
susur	1. edge, fringe, margin. 2. (java) quid of tobacco, often mixed with betel ingredients.
susuran	edge, margin, fringe.
susut	shrink, decrease.
susutan	reduction.
sut	flapping sound, sound of s.t. thin jerked rapidly.
sutan	1 title of minangkabau nobility above the rank of marah. 2 term of address to o. of this rank, us. as tan.
suten	see bersut.
sutera	silk.
sutil	(jakarta, java) frying spatula.
sutra	see sutera.
sutradara	film or play director.
sutuh	see sotoh.
suun	see sohun.
suvenir	souvenir.
suwar-suwir	(java) k.o. sweetmeat.
suwiran	shred.
suwukan	healing by blowing.
sw.	[subhanahu wa taala] (islam) the almighty and most worthy of praise, written after god's name.
swa-	self-, a prefix in formal neologisms.
swadaya	innate strength or effort, self-supporting.
swadesi	gandhian movement of swadeshi, the confining of consumption to goods of village production.
swak	(coll.) 1 sickly and weak, exhausted. 2 weak (of batteries).
swakarsa	o.'s own will.
swakarya	self-developing (of projects without gvt. funding).
swakelola	self-management (i.e. community construction of public buildings.
swalayan	self-service.
swapraja	autonomous area or region.
swara	see suara.
swarga	see surga.
swarnadipa	(lit.) the golden isle, sumatra.
swartepit	k.o. card game of dutch origin.
swasembada	self-supporting, self-sufficient.
swasiswa	an autodidact.
swasta	private.
swat.	[swatantra] autonomy.
swatantra	autonomy, autonomous.
swedia	sweden, swedish.
swembak	(coll.)swimming pool.
swempak	swimming suit.
swi	[sumbangan wajib istimewa] k.o. motor-vehicle tax levied in the 1960s.
swt.	1. [subhannahu wa taala] (islam) the almighty and most worthy of praise, written after god's name. 2. [swatantra] autonomy, autonomous. 3. [swasta] private (not public, of businedded, etc.).
sy-	see also entries with s-.
syaban	/sya'ban/ (islam) the eighth month of the arabic calendar.
syabas	[in some regions only] good! well done!.
syafaat	1 (rel.) mediation, intercession (in communication with god). 2 blessing.
syafakat	1. indness, sympathy. 2. see sepakat.
syah	1. (lit.) ruler. 2. see sah 1.
syahadat	1 confession, testimony. 2 (islam) the profession of faith : there is no god other than allah, and the prophet muh. is his massenger.
syahbandar	harbormaster, port officer.
syahdan	(lit.) so it happened, the next thing in the story.
syahdu	1 eminent, excellent. 2 serene, calm.
syahid	(islam) martyr or warrior killed while fighting for islam principles.
syahmat	see sekakmat.
syahwat	1 lust, voluptuous feeling. 2 orgasm.
syair	1 story related in verse form using o. -end-rhyme quatrains. 2 poem. 3 rhyme containing clues to the lottery.
syaitan	see setan.
syak	suspicion, doubt, distrust.
syakti	see sakti.
syal	shawl, muffler.
syalat	see solat.
syaleh	/syalih/ see saleh.
syalwat	see selawat.
syam	(lit.) syria.
syaman	shaman.
syamanisme	shamanism.
syampo	shampoo.
syaraf	see saraf 1.
syarahan	(lit.) edition.
syarak	(islam) canon law.
syarat	condition, prerequirement, requisite.
syariah	/syari'ah, syariat, syari'at/ islam law.
syarif	(islam) title of a male descendant of muh.
syarifah	1 title of a female descendant of muh. 2 (coll.) arab women.
syarikat	see serikat.
syasis	see sasis.
syatriya	see kesatria.
syawal	/syawwal/ (islam) the 10th month of the arabic calendar.
syekh	(islam) 1 sheikh. 2 title of a islam scholar.
syelawat	see selawat.
syeti	(in some regions only) moneylender of indian descent.
syiar	/syi'ar/ (islam) magnigicience, greatness (of god and religion).
syiir	see syair.
syinkek	see singkeh.
syirik	/syirk/ (islam) 1 belief in more than o. god, polytheism. 2 s.t. to be avoided on religious grounds.
syit	see sit.
symposion	/symposium, simposion, simposium/ see simposion.
syok	1. 1) very attractive. 2) very absorbed in s.t., interested and excited. 2. /syok/ (med.) shock. 3. see sok 1.
syolat	see solat.
syor	see syur 1.
syorga	see surga.
syubhat	s.t. dubious.
syuco	(japanese) administrator of a residency.
syuhada	1 (islam) persons who died for islam (martyrd, warriors in religious war, etc.). 2 heroic martyrs of a just cause.
syuk	see syok 1.
syukur	1 thank god, thanks be to god. 2 happily, fortunately.
syukuran	expression of gratitude to god.
syur	1. 1) exciting, absorbing. 2) sexually arousing. 2. (lit.) advice, suggestion.
syurga	see surga.
syuriah	advisory.
syuur	see syur 1.
t	/te/ t, the 20th letter of the alphabet.
t'hoa.	[tionghoa] chinese.
t.	[tanpa] without.
t.p.	[tanpa penerbit] no indication of publisher (in bibliographies, etc.).
t.s.	(teman sejawat) colleague (used in professional correspondence by doctors).
ta	1. see to 1. 2. see tak 1.
ta'lim	see takzim.
ta'rif	see takrif.
ta'zim	see takzim.
taajal	see takjal.
taajub	see takjub.
taala	see allah.
taalim	see takzim.
taart	see tart.
taassub	fanatical, dogmatic, bigoted.
taat	1 obedient. 2 loyal.
taawuz	(islam) prayer recited before reading the koran.
tabah	1. 1) determined, resolute. 2) able to endure (hardship, etc.). 2. see tebah.
tabak	k.o. tray used to present s.t.
tabal	1. k.o. drum used at royal installations. 2 formal installation ceremony.
taban	the gutta-percha tree.
tabanas	[tabungan pembangunan nasional] savings for national development, a gvt.-insured savings account program.
tabas	see tebas1.
tabe	see tabik.
tabeat	see tabiat.
tabek	see tabik.
tabel	table, list. tabel-tegakan (fin.) yield table.
tabernakel	(rel.) tabernacle.
tabiat	/tabi'at, tabiyat/ 1 character, nature. 2 behavior.
tabib	1 traditional healer. 2 (lit.) physician.
tabik	1 greeting, salute given in greeting. 2 hello, good morning (afternoon, etc.).
tabir	screen, partition. tabir-asap smoke screen. tabir-besi the iron curtain.
tablet	tablet, pill. tablet-hisap/isap lozenge.
tablig	/tabligh/ (islam) 1 sermon at a religious meeting. 2 such a religious meeting.
tablo	(thea.) pantomime.
tabokan	a slap.
tabrakan	collision.
tabu	1 taboo. 2 consider taboo, avoid doing.
tabuan	see tabuhan.
tabuh	1. s.t. used to strike percussion instruments, esp. a gong. 2. k.o. large mosque drum used to summon people to prayer.
tabuhan	1. k.o. percussion instrument. 2. (lit.) k.o. wasp.
tabulasi	tabulation.
tabunan	the heaping and burning of rubbish.
tabung	1 k.o. bamboo tube used for storage. 2 money box.
tabungan	1 money box. 2 savings.
taburan	sowing.
tabut	1 (bib.) ark. 2 (islam, m) effigy representing muh.'s steed, carried in procession on the 3d day of muharam. 3 (islam, m) procession on the 3d day of muharam.
taci	/tacik/ 1 (china) term of address or reference for o.'s elder sister. 2 (coll.) term of address or reference for china woman.
tada	see tiada.
tadah	1 storage receptacle. 2 cistern, reservoir.
tadahan	stolen goods bought by a fence.
tadarus	see tedarus.
tadbir	management.
tadi	1 a while ago, some time ago. 2 this (morning, evening, etc.) just past, last (night), this past (two, three, etc. o'clock). 3 the o. from a while ago, the aforementioned.
tadinya	formely, just befor.
tadrus	see tedarus.
taduh	see teduh.
taek	1 (java, vulg.) bullshit ! exclamation of surprise or disagreement. 2 see tahi.
tafahus	1 a search. 2 examination.
tafakur	/tafakkur, tafkur/ 1 contemplation. 2 reflective, contemplative.
tafakuran	1 meditation. 2 engage in meditation.
taferil	scene, picture.
tafsir	1 (islam) exclamation of passages of koran by supplying additional information. 2 exegesis (of christian scriptures).
tafsiran	1 interpretation, explanation. 2 commentary, exegesis.
taftan	taffeta.
tagal	pebble.
tagan	stake in gambling.
tagar	sound of thunder.
tagih	1 addicted to s.t. 2 habitually accustomed to s.t.
tagihan	a claim.
tah	1. (lit.) 1 wonder, particle in interrogative sentences, expressing reflectiveness. 2. see entah.
tah.	[tahun] year.
tahadi	see tadi.
tahajud	/tahajut/ see sembahyang.
tahak	a belch.
tahakik	see tahkik.
tahalil	see tahlil 2.
tahan	1 endure, put up with. 2 last, hold out.
tahanan	1 resistance, opposition, obstruction. 2 arrest, detention.
tahang	1 (lit.) ravine. 2. 1) barrel, cask, drum. 2) tank, reservoir.
tahap	/tahapan/ stage, phase.
tahayul	see takhyul.
tahbisan	tahbisan
tahdiriyah	(islam) kindergarten.
tahfidz	know by heart.
tahi	1 excrement, feces. 2 filth, dregs. tahi-binatang meteorite. tahi-besi iron rust. tahi-gergaji sawdust. tahi-gigi tartar on teeth. tahi-lalat small moles, freckles. tahi-kuping ear wax.
tahil	1 a measure of weight equal to 16 kati. 2 a measure of gold, silver, or opium.
tahir	(lit.) pure.
tahiti	k.o. rattan.
tahiyat	(islam) 1 prayer greeting god. 2 greetings.
tahkik	verification.
tahlil	1. 1) (islam) repeated recitation of the confession of faith : there is no god but god : (la ilaha illallah). 2) (rel.) songs of praise (protestant).
tahmid	(islam) devotional repetition of the ejaculation, "praise god," alhamdulillah, often as part of a mystic exercise.
tahsil	acquisition, esp. collection of rents, taxes, etc.
tahta	see takhta.
tahu	1. /tahu, tau/ 1) know, be cognizant of. 2) (coll.) i do not know (often accompanied by a shrug etc.). 3) you understand ? 2. /tau/ (coll.) ever, once. 3. /tahu/ tofu, soybean curd.
tahu-tahu	/tau-tau/ sudenly and unexpectedly.
tahua	/tahua, tawa/ (china) k.o. by-product of tofu, similar to yoghurt in consistency.
tahun	/tahun, taun/ year.
tahunan	tahunan
tahyul	see takhyul.
tai	see tahi.
taifun	see topan.
taik	1. see tahi. 2. see naik.
taiko	(china) leprosy.
taipak	1 (china) gambling. 2 financier in gambling.
taipun	see topan.
tais	dirty.
taisen	(china) 1 the other number in a fixed pair of numbers in a number game or lottery. 2 the beloved.
taiso	(japanese) group calisthenics.
