sophisticate	kb. orang yang pintar dan berpengalaman dalam hal-hal duniawi.
sophistication	kb. pengalaman dalam soal-soal duniawi.
sophistry	kb. (j. -ries) cara berpikir yang menyesatkan, cara berpikir yang tidak masuk akal.
sophomore	kb. mahasiswa tingkat kedua. s. year tahun kedua.
soporific	kb. obat tidur/penidur. -ks. membuat mengantuk, mengantukkan.
soppy	ks. 1 basah (clothes). 2 lembab, basah (weather).
soprano	kb. 1 penyanyi sopran. 2 suara sopran.
sorcerer	kb. tukang/ahli sihir.
sorceress	kb. ahli sihir wanita.
sorcery	kb. (j. -ries) ilmu sihir.
sordid	ks. 1 kotor, jorok (environment). 2 kototr, mesum (stories).
sore	kb. luka. -ks. 1 sakit. i have a s. arm tanganku sakit. 2 marah. don't get s. at me jangan marah kepada saya. 3 menjengkelkan. -sorely kk. terasa, dengan berat. he'll be s. missed kepergiannya akan terasa berat.
sorehead	kb. inf.: pemarah, orang yang mudah mendongkol.
soreness	kb. rasa sakit, kesakitan.
sorghum	kb. 1 sejenis tanaman yang menyerupai jagung atau gandum. 2 semacam ceng, tetes, air gula.
sorority	kb. (j. -ties) perkumpulan mahasiswi/wanita.
sorrel	kb. 1 merah bata, coklat merah/ kemerah-merahan (color). 2 kuda cokelat kemerah-merahan (horse).
sorrow	kb. 1 dukacita. there was s. on her face wajahnya membayangkan rasa dukacita. 2 penderitaan. -kki. to s. over berdukacita atas.
sorrowfull	ks. sedih.
sorry	ks. 1 menyesal. 2 menyedihkan. 3 ma'af.
sort	kb. 1 orang. 2 macam, rupa. 3 jenis. 4 yang demikian. -kkt. menyortir, memisah-misahkan (mail, clothes). -sorting kb. penyortiran.
sorter	kb. tukang sortir/pilih. s. of mail tukang sortir surat-surat (pos).
sortie	kb. serangan tiba-tiba/mendadak.
sos	kb. isyarat darurat, panggilan minta tolong.
sot	kb. pemabuk.
souffle	kb. kue dadar pakai telur. cheese s. kue dadar keju.
sought	lih seek.
soul	kb. 1 jiwa. 2 arwah. 3 orang, makhluk.
soul-searching	kb. mempertimbangkan masak-masak. ks. mendalam.
soulful	ks. menggetarkan jiwa/hati, penuh perasaan. s. music musik yang menggetarkan jiwa.
sound	kb. 1 bunyi. 2 suara. 3 selat. to s. off memperdengarkan. -sounding kb. pengukuran dalam air dengan gema suara atau dengan pengukuran, dugaan.
sounder	kb. orang atau alat yang membunyikan sesuatu (of an alarm).
soundly	kk. keras-keras. to spank s. menampar dengan keras.
soundness	kb. 1 kesehatan (of body). 2 kekuatan, kesehatan, kesegaran (of mind). 3 kebaikan (of an enterprise). 4 hal-hal yang menguatkan (of an argument).
soundproof	ks. tahan suara, tak tembus suara. -kkt. menjadikan sebuah kamar tahan bunyi/suara (a room).
soup	kb. 1 sup, sop. vegetable s. sop sayur. 2 sl.: kabut. s. kitchen dapur umum.
soupbone	kb. tulang sup.
soupy	ks. tebal, pekat (fog, weather).
sour	ks. 1 asam, masam. s. cream susu asam. s. face muka asam. 2 tidak enak (of remarks). -kk. asam. to turn s. manjadi asam/basi. -kkt. membuat kapok/jera. -kki. menjadi asam, kemasaman (of milk).
source	kb. 1 sumber (of information, news). 2 sumber, mata air (of a well, river). s. of infection asal permulaan infeksi.
sourpuss	kb. inf.: pengomel, pencomel, perengut.
souse	kb. sl.: pemabuk. -kkt. menceburkan. -soused ks. sl.: mabuk.
south	kb. selatan. to live in the s. berdiam di as bagian selatan. -ks. selatan. south-southeast ks. selatan menenggara. south-southwest ks. selatan membarat daya.
southeast	kb. bagian tenggara. he lives in the s. dia tinggal di as bagian tenggara. -ks. tenggara. s. asia tenggara. s. wind angin tenggara. the wind is s. angin menenggara.
southeasterly	ks. dari arah tenggara, di sebelah tenggara.
southeastern	ks. bagian tenggara.
southerly	ks. dari/ke arah selatan. s. wind angin selatan.
southern	ks. selatan. she is s. dia orang selatan. s. dialect logat bagian selatan. s. exposure menghadap ke selatan (of a room, house).
southerner	kb. orang selatan.
southernmost	ks. bagian paling selatan.
southland	kb. daerah selatan.
southpaw	southpaw
southward(s)	kk. menuju ke selatan, menyelatan.
southwest	kb. bagian barat-daya. he lives in the s. dia tinggal di as bagian barat daya. -ks., kk. barat-daya.
southwesterly	ks. dari arah barat-daya, di sebelah barat-daya.
southwestern	ks. barat-daya.
souvenir	kb. tandamata, oleh-oleh.
sovereign	kb. raja, yang berkuasa. s. rule pemerintahan tertinggi. s. right hak-hak yang berkuasa. s. of the seas penguasa lautan. s. power kekuasaan yang memerintah.
sovereignty	kb. (j. -ties) kedaulatan. transfer of s. penyerahan kedaulatan.
soviet	kb. sovyet. s. publications publikasi-publikasi sovyet. s. union sovyet.
sow	kkt. (sowed, sowed atau sown) 1 menaburkan (seeds). 2 menyebarkan (dissension). to s. land with wheat menaburi tanah dengan gandum.
sower	kb. penabur.
sown	lih sow kkt.
sox	= socks.
soy	kb. kedele. s. sauce kecap.
soya	lih soy.
soybean	kb. (kacang) kedelai.
sp.	[spelling] ejaan. 2 [special] istimewa, khusus, tertentu. 3 [species] jenius. 4 [spirit] semangat ; minuman keras.
spa	kb. 1 sumber air mineral. 2 tempat pemandian air panas.
space	kb. 1 tempat. 2 angkasa. 3 ruang. 4 spasi, jarak. 5 (jangka) waktu. -kkt. memberi jarak (flowers). s. fiction cerita khayalan yang berhubungan dengan angkasa raya. s. flight penerbangan (ruang) angkasa. -spacing kb. jarak, mengadakan jarak.
spacecraft	kb. kendaraan angkasa.
spaceman	kb. (j. -men) angkasawan, antariksa.
spacer	kb. pengatur jarak (pada mesin tik).
spaceship	kb. tembakan ke ruang angkasa.
spaceshot	kb. kendaraan/kapal angkasa.
spaceworthy	ks. sanggup terbang di angkasa luar.
spacious	ks. luas, lapang.
spaciousness	kb. keluasan, kelapangan.
spade	kb. 1 sekop. 2 kartu sekop. -kkt. menyekop, menggali dengan sekop.
spadework	kb. persiapan-persiapan, pekerjaan pendahuluan/persiapan.
spaghetti	kb. spageti.
spake	lih speak.
span	kb. jengkal (of a hand). 2 masa (of time). 3 jangka, waktu. 4 rentang (of a bridge). 5 sepasang (of horse). -kkt. (spanned) 1 merentang. 2 menjengkal (with the hand). 3 menjangkau.
span.	[spanish] 1 bahasa spanyol. 2 bangsa spanyol. 3 orang spanyol.
spangle	kb. kida-kida, kelip-kelip.
spangled	ks. berkelip-kelip.
spaniard	kb. orang spanyol.
spaniel	kb. anjing spanil. cocker s. anjing kecil yang berbulu panjang.
spanish	kb. bahasa spanyol. the s. j. orang-orang spanyol. -ks. spanyol.
spank	kb. tampar(an). -kkt. menampar, memukul (bagian pantat). -spanking kb. tamparan, pukulan di pantat. ks. inf.: amat, sekali. to have a s. good time bergembira sekali.
spar	kb. tiang kapal.
spare	kb. 1 ban serap (stire). 2 serap. -ks. 1 terluang, senggang (time). 2 kurus (man). -sparing ks. 1 berhemat. 2 secara hemat. -sparingly kk. dengan hemat.
sparerib	kb. tulang iga babi.
spark	spark
sparkle	kb. kilau, cahaya berkelip. i saw the s. in her eyes saya melihat matanya berseri-seri. -kki. berkilau-kilauan (of ornaments, lights). -sparkling ks. yang berkilauan.
sparkler	kb. kembang api yang mengeluarkan percikan api.
sparred	saling bertahan dan menyerang (of boxer).
sparrow	kb. burung pipit/gereja.
sparse	ks. jarang, tipis. s. growth of hair pertumbuhan rambut yang tipis. s. population penduduk yang jarang. -sparsely kk. jarang. this area is s. populated daerah ini jarang penduduknya.
sparseness	kb. kekurangan.
spasm	kb. kekejangan, kejang urat. to work in spasms bekerja angin-anginan.
spasmodic	ks. 1 tak teratur. s. interest perhatian yang tak tetap. 2 hebat (rage). 3 menyesak (cough). -spasmodically kk. tak teratur/tetap. he works s. dia bekerja tak teratur.
spastic	ks. kejang. s. disease penyakit yang disertai kekejangan.
spat	kb. pertengkaran, percekcokan.
spate	kb. banjir, hujan. s. of lincoln biographies banjir biografi-biografi lincoln.
spatial	ks. mengenai ruang/temat. s. relationship hubungan yang renggang.
spatter	kb. percik, renjisan. -kkt. memerciki (s.o. with mud). -kki. 1 memercik (of rain on a roof). 2 berhamburan (of bullets). 3 menyembur, merenjis, menjepret (of grease).
spatula	kb. sudip, kape.
spawn	kb. telur ikan, telur katak, dll. -kkt. 1 membiakkan (crime). 2 menimbulkan (political problems). 3 menelurkan. -kki. bertelur, menelur. spawning ground tempat (ikan) bertelur.
spay	kkt. memandulkan (binatang betina).
speak	kkt. (spoke, spoken) mengatakan. -kki. 1 berbicara. 2 berpidato. 3 berkata. -spoken ks. yang diucapkan. -speaking. kb. berpidato.
speakeasy	kb. (j. -sies) sl.: kedai minuman (keras) gelap.
speaker	kb. 1 pembicara, ahli pidato. he's a fluent s. of balinese ia seorang yuang berbicara lancar dalam bahasa bali. 2 (loud-) pengeras suara. 3 penutur (of a language).
spear	kb. tombak, lembing. -kkt. menombak.
spearhead	kb. 1 pelopor. 2 permulaan, bagian pertama, taraf permulaan. -kkt. mempelopori, membuka jalan bagi.
spearmint	kb. tanaman permen.
spec.	1 [special] istimewa, khusus. 2 [specimen] contoh. 3 [specification] spesifikasi, perincian.
special	kb. 1 rest.; makanan istimewa. 2 rr.: kereta api istimewa. 3 suratkabar istimewa. 4 pertunjukan tv yang tunggal. -ks. 1 istimewa, khusus. 2 luar biasa. -specially kk. khusus(nya).
specialist	kb. spesialis, ahli. he's a s. on ... dia seorang spesialis tentang... eye s. dokter ahli penyakit mata, dokter spesialis mata.
specialization	kb. spesialisasi, pengkhususan, pengahlian. high degree of s. spesialisasi yang mendalam.
specialize	kki. 1 berspesialisasi (in some field). 2 mengkhususkan, mengkhusus pada.
specialty	kb. (j. -ties) bidang/keahlian khusus. linguistics is his s. ilmu bahasa merupakan bidang khususnya.
specie	kb. mata uang.
species	kb. 1 jenis. s. of dog jenis anjing. 2 macam. the s. rumpun manusia.
specific	kb. obat. specifics j. pokok-pokok, seluk beluk. -ks. spesifik, khusus, tertentu. specifically kk. tegasnya, khususnya.
specification	kb. 1 spesifikasi, perincian. built to specifications dibangun menurut perencaan yang terperinci. 2 syarat, perincian (of a contract).
specificity	kb. ketegasan, kekhususan.
specifies	lih specify.
specify	kkt. (specified) 1 menetapkan. to s. the choice of color menetapkan pemilihan warna-warna. 2 menentukan. at a specified time pada waktu yang ditentukan.
specimen	kb. contoh, bahan percobaan. urine s. contoh air kencing. plant s. contoh tanaman. s. page contoh halaman. to take a s. of s.o's blood mengambil contoh darah. s. copy a) lembaran contoh. b) contoh buku.
specious	ks. tampaknya bagus. s. argument alasan yang kedengarannya saja bagus.
speck	kb. 1 noda (of dirt). 2 bintik (of color). he was just a s. on the horizon ia kelihatan sebagai sebuah bintik di kaki langit. 3 (jumlah) sedikit. we haven't a s. of fruit kami tak mempunyai buah-buahan barang sedikitpun.
speckle	kb. bintik, becak, kurik.
specs	kb., j. 1 inf.: kaca mata, tasmak. 2 inf.: perincian, spesifikasi.
spectacle	kb. tontonan, pertunjukan besar. to make a s. of o.s. berlagak, bertindak memalukan. -spectacles j. kacamata, tasmak.
spectacular	kb. perunjukan besar-besaran. -ks. hebat, spektakuler, mengagumkan, menakjubkan (view, career).
spectator	kb. penonton. s. sport olahraga tontonan.
specter	kb. hantu, momok.
spectrum	kb. (j. -tra, -trums) spektrum. the entire s. of political views seluruh aneka warna pandangan-pandangan politik.
speculate	kki. 1 memikirkan, mempertimbangkan. 2 berspekulasi, mengadu untung/nasib (on the market).
speculation	kb. 1 spekulasi (on the market). 2 pemikiran, renungan (about s.t.).
speculative	ks. spekulatif, bersifat untung-untungan.
speculator	kb. 1 spekulan. 2 tukang catut.
sped	lih speed.
speech	kb. 1 pidato. 2 kemampuan berbicara. 3 cara berbicara, logat.
speechless	ks. terdiam, terkelu.
speechmaking	kb. pengucapan pidato.
speed	kb. 1 kecepatan. 2 persneling. 3 sl.: amphetamine, penggiat jalannya darah (drug). -kkt. (sped) 1 mempercepat (the work). 2 mengirim dengan cepat (reinforcements). -speeding kb. melampaui batas kecepatan.
speedboat	kb. perahu motor cepat.
speeder	kb. pelanggar batas kecepatan.
speedometer	kb. pengukur cepat, meteran kecepatan.
speedster	kb. 1 pelanggar batas kecepatan. 2 pelari cepat. 3 kendaraan cepat, kapal cepat dsb.
speedway	kb. 1 gelanggang balapan mobil. 2 jalan raya untuk lalulintas cepat.
speedy	ks. cepat. s. delivery pengantaran yang cepat. to make a s. recovery sembuh dengan cepat. -speedily kk. dengan cepat.
spell	kb. 1 musim, masa sakit. dry s. musim/masa kering. 2 serangan. 3 pesona, jampi, mantera (sihir). -kkt. (spelled atau spelt) 1 mengeja. 2 menggantikan. 3 berarti. -spelling kb. ejaan. s. book buku ejaan. s. pronunciation ucapan menurut ejaan.
spellbinder	kb. pembicaa yang dapat memikat hati pendengar-pendengarnya.
spellbound	ks. terpesona. to be held s. by terpesona oleh.
speller	kb. 1 pengeja. 2 buku ejaan.
spelt	lih spell.
spend	kkt. (spent) 1 mengeluarkan, membelanjakan (money). 2 menghabiskan. 3 melewatkan (the week end). 4 membuang-buang. 5 tinggal. 6 mempergunakan. -kki. mengeluarkan uang. -spent ks. 1 habis tenaga. 2 yang dipakai. -spending kb. pengeluaran.
spender	kb. pemboros.
spendthrift	kb. pemboros
spent	lih spend.
sperm	kb. air mani, sperma. s. bank lumbung benih.
spew	kkt., kki. to s. forth memuntahkan.
sphere	kb. 1 bola, bulatan,. 2 bidang, lingkungan. s. of influence lingkungan pengaruh.
spherical	ks. 1 berbentuk bola. 2 yang berhubungan dengan bola.
sphinx	kb. patung raksasa dari zaman mesir kuno.
spice	kb. rempah-rempah, bumbu. -kkt. membumbui, membubuhi rempah-rempah. -spiced ks. dibumbui. s. meat daging yang dibumbui.
spiciness	kb. 1 kepedasan, pedasnya. 2 kesedapan. 3 kehangatan (of a story).
spick-and-span	ks. rapi dan bersih.
spicy	ks. 1 pedas (food). 2 kurang senonoh, agak cabul (story).
spider	kb. laba-laba. s. web jaring laba-laba.
spied	lih spy.
spiel	kb. sl.: kata olok-olok. -kkt. to s. off menyebut dengan lancar (names).
spies	lih spy.
spigot	kb. keran, klep.
spike	kb. paku besar. s. heal tumit tajam. -spikes j. 1 memaku (boards together). 2 menghentikan (a rumor, escape). 3 inf.: membubuhi alkohol (a drink).
spill	kb. jatuh (jungkir-balik). -kkt. (spilled atau spilt) menumpahkan (a drink, blood). -kki. meluap, tertumpah.
spilt	lih spill.
spin	kb. putaran, kisaran. 2 auto.: perjalanan keliling dengan mobil. -kkt. (spun) 1 memutar, memusingkan (a top). 2 memintal (cloth). 3 membuat (a web). -kki. 1 berputar (of a top). 2 pusing. -spinning kb. pemintalan.
spinal	kb. med.: suntikan pelali dalam sum-sum belakang. -ks. mengenai tulang belakang. s. column tulang belakang. s. cord urat saraf tulang belakang.
spindle	kb. gelendong, kumparan. spindle-legged ks. berkaki panjang dan kurus.
spine	kb. tulang belakang. 2 punggung (of a mountain, book). 3 duri (of cactus, porcupine).
spine-chilling	ks. menegakkan bulu roman. spine-tingling ks. seram (story).
spineless	ks. 1 tak bertulang. 2 lemah.
spinet	kb. piano kecil.
spinich	kb. bayam.
spinner	kb. 1 pemintal, pengantih (of cloth). 2 pembual (of tales).
spinster	kb. perawan/gadis tua.
spinsterhood	kb. semasa hidup sebagai gadis tua.
spiny	ks. berduri.
spiraea	kb. semacam tumbuhan.
spiral	kb. pilin. -ks. spiral. -kki. naik (terus). wages have spiraled in recent months upah-upah naik dalam bulan-bulan belakangan ini.
spirant	kb. phon.: bunyi geseran/bergeser.
spire	kb. puncak menara (of a church).
spirit	kb. 1 roh, jiwa. 2 semangat. 3 arwah (of a dead person). 4 jin, hantu, mambang, makhluk halus. 5 suasana. -spirits j. 1 (drink) minuman keras. 2 semangat. -spirited ks. 1 hangat, bersemangat (discussion). 2 bersemangat, gesit (horse).
spiritual	kb. nyanyian negro di as. -ks. 1 bathin, rohani. s. help bantuan bathin. 2 keagamaan. s. writings karangan-karangan keagamaan.
spiritualism	kb. ilmu wasitah.
spiritualist	kb. penganut ilmu wasitah.
spirituous	kb. yang mengandung alkohol. s. liquors minuman keras.
spit	kb. air ludah/liur. 2 tempat memanggang. -kki. (spat atau spit) meludah. don't s. on the floor jangan meludah di lantai.
spitball	kb. bola gumpalan kertas.
spite	kb. dengki, dendam, irihati. to do s.t. for or out of s. melakukan sesuatu karena merasa dengki. -kkt. menjengkelkan, mendongkolkan.
spiteful	ks. pendengki, pendendam, berdengki, irihati.
spitfire	kb. wanita yang marah/galak.
spittle	kb. air ludah/liur.
spittoon	kb. tempolong, peludahan.
splash	kb. 1 cemplungan (of a stone, body entering the water). 2 ceburan (of an oar). -kkt. 1 memercikan(water). 2 bepercikan. -kki. mendebur, cebar-cebur. -splashing kb. deburan, pukulan (of waves).
splashdown	kb. penceburan.
splashy	ks. heboh, dengan cara menarik perhatian.
splatter	= spatter.
splay	ks. miring, renggang keluar.
splayfoot	kb. (j. -feet) kaki bebek.
spleen	kb. limpa (kecil). to vent o's s. upon s.o. mencurahkan rasa bencinya pada seseorang.
splendid	ks. 1 baik sekali (show, oppertunity). 2 enak (meal). 3 tampan (in appearance). -splendidly kk. dengan baik sekali.
splendor	kb. semarak, kemegahan.
splice	kb. sambungan, sambatan. -kkt. manyambung. inf.: to be spliced kawin.
splint	kb. belat. to put a broken arm in splints membelat lengan yang patah. -kkt. membelat.
splinter	kb. suban, serpih. s. group kelompok yang memisahkan diri dari induk organisasinya karena berselisih pendirian. -kkt. memecahkan (a door). -kki. 1 memecah, terpecah (of glass, wood, a group). 2 menyerpih.
split	kb. 1 robek, sobek (in clothing). 2 keretakan (in furniture, a group). 3 sl.: pembagian (of the profits). 4 gerak mengangkang. -ks. retak, belah (wall). -kkt. (split) 1 membelah (wood). 2 membagi. 3 fin.: menambah (stock). 4 memisahkan.
splitting	kb. pemiosahan/pemecahan (of the atom). ks. berat sekali. s. headache sakit kepala serasa mau pecah.
splotch	kb. percikan (of ink).
splotchy	ksd. berbercak-bercak, bernoda.
splurge	kb. pembelian secara royal. to go on a s. berbelanja secara royal. -kki. berbelanja royal-royalan, beroyal-royal dengan.
splutter	kb. bunyi getaran/repetan (of a motor). -kki. 1 berbicara dengan gugup. 2 bergetar, merepet (of an engine).
spoil	kb. spoils j. barang rampasan (of war). -kkt. (spoiled atau spoilt) 1 memanjakan (a child). 2 mengganggu (o's day). 3 (ruin) membuang-buang. 4 merusak, membuat busuk (food). -kki. busuk, basi (of food). -spoiled, spoilt ks. manja, alem(of a child).
spoilsport	kb. perusak permainan.
spoilt	lih spoil.
spoke	kb. jari-jari, ruji.
spoke(n)	lih speak.
spokesman	kb. (j. -men) jurubicara, jubir.
sponge	kb. 1 bunga karang, sepon. s. rubber karet sepon. 2 bolu. s. cake bolu, bolukukus. -kkt. 1 menggosok (a car, abody). 2 inf.: mengemis, mengorek (money) (off dari).
sponger	kb. inf.: orang yang hidup atas biaya orang lain, tukang bonceng.
spongy	ks. seperti bunga karang, seperti sepon.
sponsor	kb. sponsor, penyokong, yang membiayai. -kkt. 1 mensponsori. 2 membiayai, mengongkosi.
sponsorship	kb. usaha, sokongan. under the s. of atas usaha.
spontaneity	kb. (j. -ties) spontanitas.
spontaneous	ks. secara spontan, tanpa diminta-minta. -spontaneously kk. secara spontan.
spoof	kb. inf.: lelucon. -kkt. membuat lelucon mengenai.
spook	kb. hantu.
spookish	ks. 1 yang berhantu (building). 2 ngeri (feeling).
spooky	ks. menyeramkan, menakutkan.
spool	kb. gelendong, kili-kili, kumparan. a s. thread segelendong benang.
spoon	kb. sendok. serving s. sendok gulai/nasi.
spoon-feed	to spoon-feed 1 menyuapi (a baby). 2 memanjakan (o's pupils). spoon-fed ks. manja, didulang.
spoonful	kb. sesendok penuh.
sporadic	ks. sekali-sekali, jarang-jarang, sporadis. -sporadically kk. dengan sporadis.
spore	kb. sepura.
sport	kb. 1 olahraga, sport. -sports j. olahraga, keolahragaan.
sportscast	kb. berita olah raga.
sportscaster	kb. penyiar berita olah raga.
sportsman	kb. (j. -men) olahragawan.
sportsmanlike	ks. sportif
sportsmanship	kb. sikap sportif.
sportswear	kb. pakaian olahraga.
sportswoman	kb. (j. -women) olahragawati.
sportwriter	kb. wartawan olahraga.
sporty	ks. yang menyolok (car, clothes). -sportily kk. secara menyolok.
spot	kb. noda, selekeh (on o's clothing). 2 bintik. 3 tempat. 4 sedikit. 5 beruntusan (on skin). -spotted ks. berbintik, ber(tutul). s. cat kucing tutul. s. fever penyakit demam yang menimbulkan bintik-bintik pada kulit.
spotlesness	kb. kerapian, keadaan tak bercacat/bernoda.
spotless	ks. bersih, tak bernoda.
spotlight	kb. 1 lampu sorot. to be in the s. manjadi pusat perhatian umum. 2 lampu pinggir (on cars). -kkt. menyoroti.
spotter	kb. 1 tukang penghapus noda. 2 peninjau, pengintai.
spotty	ks. 1 bernoda (of clothing). 2 kadang-kadang baik, kadang-kadang buruk ; turun-naik (of grades, performance).
spouse	kb. 1 suami. 2 isteri.
spout	kb. corot, cerat (of pitcher, kettle). -kkt. 1 menyemburkan (abuse, obscenities). 2 menyemprotkan (water). -kki. memancar.
sprag	kkt. (spragged) mengganjal, menggalang.
sprain	kb. keseleo. -kkt. keseleo, terpelecok. he sprained his ankle mata kakinya keseleo.
sprang	lih spring.
sprawl	kb. kedudukan lintang pukang. -kki. terlentang, menggeletak (on the grass). the blow sent him sprawling pukulan itu membuat dia tergeletak.
spray	kb. 1 percikan, semrotan (of water). s. gun alat semprot, semprotan. 2 setangkai (of flowers). 3 (wind-blown) buih. 4 obat penyemrotan. -kkt. 1 menyemrot (trees, o's throat). 2 memberondongi (with bullets). -spraying kb. penyemprotan.
sprayer	kb. semprotan, (alat penyemprot).
spread	kb. 1 lebarnya (of wings). 2 penyebaran (of information). 3 penjalaran (of a disease). 4 perbedaan between income and expenditures). 5 (meal) makan besar. 6 olesan, lumuran, pulasan (of cheese).
spread-eagle	berbaring dengan kaki terkangkang dan tangan terlentang di atas tanah. -spreading kb. 1 menjalarnya, penjalaran (of disease). 2 perkembangan (of knowledge).
spreader	kb. 1 penyebar (of knowledge, disease). 2 alat penyebar (of fertilizer). 3 pengoles, pemulas (of butter).
spree	kb. pelesir. to go on a shopping s. pergi berbelanja sambil bersuka-ria.
sprier	lih spry.
spriest	lih spry.
sprig	kb. ranting, tangkai.
sprightly	ks. 1 sigap. 2 riang gembira.
spring	kb. 1 musim semi. 2 sumber, mata air. 3 per, pegas. (watch, auto). -kkt. (sprang, sprung) 1 membocorkan, meretakkan (a wall). 2 membuka, melepaskan (a lock). spring-cleaning kb. pembersihan rumah dalam musim semi. -sprung ks. rusak.
springboard	kb. batu loncatan.
springiness	kb. kekuatan pelenting, daya melenting/memegas.
springtime	kb. musim semi.
springy	ks. elastis.
sprinkle	kb. 1 penetasan (of rain). 2 penghamburan (of papper). -kkt. 1 menaburkan, menghamburkan (dirt). 2 memerciki, menyirami (the lawn). 3 membubuhi (pepper on s.t.). 4 tersebar. -kki. gerimis, hujan rintik-rintik.
sprinkler	kb. 1 alat penyiram (in yard). 2 alat penyembur api (against fire).
sprinkling	kb. 1 sedikit olesan (of mayonnaise). 2 penyiraman. 3 beberapa.
sprint	kb. lomba lari jarak pendek, lari cepat. to make a s. for the door melompat lari kearah pintu. -kki. berlari secepat-cepatnya.
sprinter	kb. pelari (dalam lomba lari).
sprite	kb. bidadari, peri.
sprocket	kb. gigi jentera.
sprout	kb. 1 taoge. 2 rebung. -kkt. memakai (whiskers, wings). -kki. 1 bertunas (of plants). 2 tumbuh meninggi (of a child).
spruce	kb. sejenis pohon cemara. -kkt. to s. o.s. up berdandan dengan rapi, merapikan diri.
sprue	kb. seriawan, guam.
sprung	lih spring.
spry	ks. (sprier, spriest) 1 giat, sigap, gesit. 2 bersemangat.
spud	kb. inf.: kentang.
spun	lih spin.
spunk	kb. 1 keberanian. she has a lot of s. dia seorang wanita pemberani. 2 semangat.
spunkiness	kb. keberanian.
spunky	ks. 1 berani. 2 bersemangat.
spur	kb. 1 taji (of a cock). 2 pacu (of horseman). 3 rr.: cabang rel kereta api. -kkt. (spurred) 1 menerjang dengan taji. 2 memacu (a horse). he was spurred on by his teacher dia didorong oleh gurunya. s.line/track simpang jalan kereta api.
spurious	ks. palsu, lancung.
spurn	kkt. menolak (dengan angkuhnya).
spurt	kb. 1 semburan (of liquid). 2 dorongan. -kkt. menyemburkan, menyemprotkan (blood). -kki. 1 menyembur (of a liquid). 2 berlari dengan cepat.
sputnik	kb. sputnik.
sputter	kki. 1 memercik (of grease in a pan). 2 menggerutu, bercakap dengan menggagap. kb. 1 bunyi yang merepet/berdesis (of an engine). 2 bunyi yang berdesis (of grease).
sputum	kb. 1 dahak. 2 air liur/ludah.
spy	kb. (j. spies) mata-mata. -kkt. (spied) melihat. i spied him in the mirror saya melihatnya didalam cermin. -spying kb. spionase. he was hanged for s. dia digantung karena menjadi mata-mata.
spyglass	kb. keker.
sq.	[square) (empat) persegi . 2 [squadron] skwadron.
sq. ft.	[square foot/feet] kaki persegi.
squab	kb. anak burung dara, burung dara muda.
squabble	kb. pertengkaran, percekcokan. -kki bertengkar, bercekcok. to s. over s.t mempertengkarkan sesuatu. -squabbling kb. pertengkaran, percekcokan.
squabbler	kb. orang yang bertengkar.
squad	kb. 1 mil.: regu. rescue regu penolong. 2 pasukan (of police). s. car mobil patroli/polisi.
squadron	kb. skwadron.
squalid	ks. jorok, jembel. s. quarters perumahan yang jorok.
squall	kb. 1 hujan badai yang turun mendadak. 2 angin keras yang mendadak. snow s. hujan badai salju. -kkt. berteriak, menangis sambil berteriak-teriak.
squalor	kb. kejorokan, kejembelan, kemelaratan.
squander	kkt. menghabiskan dengan sia-sia. to s. money menghamburkan uang.
squanderer	kb. orang yang membuang - buang / menghambur-hamburkan.
square	kb. 1 kwadrat, (empat) persegi. 2 sl.: seorang yang konvensionil, orang yang ketinggalan zaman mengenai mode. 3 (village) alun-alun. 4 hasil perkalian. 5 lapangan persegi.
squarely	kk. 1 secara jujur. to win fairly and s. betul-betul menang secara jujur. 2 tepat. to shoot s. between the eyes menembak tepat diantara matanya.
squash	kb. 1 semacam labu, semacam ketela, gambas. 2 sport : permainan bola dan raket. 3 krus. orange s. oranye krus. -kkt. 1 meremas, melumatkan (cookies). 2 (stop) menghentikan. 3 menundukkan (in debate).
squashy	ks. becek, berlumpur (of ground).
squat	kb. berjongkok. -ks. lontok, pendek dan gemuk. -kkt. (squatted) 1 berjongkok, bertanggek. 2 menduduki tanah (on a piece of land).
squatter	kb. penghuni liar. squatter's right hak penduduk atas tanah bagi penghuini liar.
squatty	ks. lontok, pendek dan gemuk.
squaw	kb. wanita indian.
squawk	kb. 1 inf.: keluhan, omelan (about low pay). 2 kuak (of fowl). -kki. 1 inf.: (complain) mengeluh, mengomel. 2 berkuak (of a chicken). 3 sl.: mengakui (to the police).
squeak	kb. 1 cicit, decit (of a mouse). 2 ciutan (of brakes, a door). -kki. 1 bercicit, mencicit (of a mouse). 2 mengerik (of a door, a pen). 3 berkecut-kecut (of a wheel which needs oil). -squeaking kb. 1 bunyi yang berdecit-decitan (of a mouse). 2 ciutan.
squeaker	squeaker
squeaky	squeaky
squeal	kb. 1 pekik (of delight). 2 jeritan (of complaint). 3 dengking (of a pig). -kki. 1 menjerit, memekik (of a person). 2 berdengking, mendengking (of a pig).
squealer	kb. 1 orang atau hewan/barang yang berteriak/berjerit. 2 (pig) anak babi.
squeamish	ks. berpilih-pilih.
squeegee	kb. alat penyapu/pembersih air terbuat dari karet.
squeeze	kb. 1 tekanan. 2 tiruan. 3 pemerasan. -kkt. 1 memeras (money from s.o., fruit). 2 memencetr, meremas (a kitten). 3 menyelipkan. 4 memeluk, mendekap (a child in o's arms). -kki. diperas.
squeezer	kb. pemeras. lemon s. pemeras jeruk.
squelch	kb. pukulan yang membungkamkan. -kkt. 1 memadamkan, menindas (an uprising). 2 mendiamkan (s.o.).
squib	kb. 1 berita singkat (in a newspaper). 2 petasan, kembang api.
squid	kb. ikan cumi-cumi.
squiggle	kb. garis berlekuk-lekuk.
squint	kb. kerdipan, penglihatan juling. to give s.o. a s. of one eye menerlingkan sebelah matanya pada seseorang. -kki. mengedipkan mata. to s. at s.o. memandang seseorang.
squire	kkt. mengantarkan, menemani, mengawal.
squirm	kki. menggeliat(-geliut). -squirming kb. menggeliat-geliat.
squirrel	kb. bajing, tupai.
squirt	kb. semprotan (of liquid). s. gun 1 pestol air. 2 alat penyemrot. -kki. muncrat, menyembur (of liquid).
ss	[steamship] kapal api.
st.	1 [street] jalan. 2 [saint] santo. 3 [strait] selat.
stab	kb. tikaman, bacokan. 2 pengkhianatan. -kkt. (stabbed) menikam. to s. s.o. in the back 1 menikam/menusuk dari belakang. 2 (betray) mengkhianati.
stability	kb. (j. -ties) 1 stabilitas, kemantapan, kestabilan. 2 keseimbangan.
stabilization	kb. stabilisasi.
stabilize	kkt. menstabilkan, menstabilisasikan, memantapkan.
stabilizer	kb. alat penstabil, pengatur keseimbangan, stabilisator.
stable	kb. 1 kandang. 2 rombongan (of exports). -ks. 1 stabil (economy, government). 2 seimbang, stabil (ship, plane). 3 tabah hati, teguh, stabil (person). 4 tetap, tak berubah (of a liquid). -kkt. mengandangkan, menempatkan di kandang (a horse).
stablemate	kb. 1 kuda sekandang. 2 kawan sekandang.
stack	kb. 1 tumpukan (of mail, papers). 2 cerobong asap. 3 banyak. -stacks j. tempat rak-rak berisi buku di perpustakaan. -kkt. 1 menumpukkan, melonggokkan (wood). 2 menyusun, mengatur (books). -sl.: stacked ks. berbadan/berpotongan tampan (of a woman).
stadium	kb. (j. -iums, -ia) stadion, gelanggang, arena.
staff	kb. 1 staf. 2 dewan, majelis. 3 para pegawai. 4 tongkat. 5 bahan pokok. -kkt. mengangkat pegawai-pegawai. -staffing kb. susunan kepegawaian.
staffwork	kb. pekerjaan administratif.
stag	kb. rusa jantan. to go s. pergi sendirian (tanpa wanits), pria saja. s. dinner pesta makan untuk pria saja.
stage	kb. 1 panggung, pentas. s performance pertunjukan di panggung. 2 tingkat. 3 taraf. 4 tingkatan. stage-struck ks. amat tertarik akan permainan sandiwara panggung. -staging kb. pementasan, pemanggungan.
stagecraft	kb. kepandaian menyajikan sandiwara.
stagehand	kb. petugas untuk pentas.
stagger	kb. jalan sempoyongan, jalan terhuyung-huyung. -kkt. 1 mengejutkan. 2 membingungkan. 3 menggemparkan, menggoncangkan. 4 mengatur bergiliran. -stagering ks. mengejutkan, mengagetkan (costs).
stagnancy	kb. kemacetan, kemandekan.
stagnant	ks. 1 menggenang, mandek (water). 2 membosankan (society).
stagnate	kki. 1 menggenang (of water). 2 mati, tidak mendapat kemajuan (of skills).
stagnation	kb. stagnasi.
staid	ks. tenang dan serius. s. community masyarakat yang tenang-tenang saja.
stain	kb. 1 noda (on cloth, on o's character). 2 zat warna (for slides). -kkt. 1 mengotorkan, menodai (cloth, o's hands). 2 menodai, mencemarkan (o's reputation). -kki. menjadi kotor.
stainless	ks. tak bernoda. s. steel baja tak berkarat.
stair	kb. tangga. stairs j. tangga.
staircase	kb. tangga rumah.
stairway	kb. tangga.
stairwell	kb. ruangan tempat tangga.
stake	kb. 1 pancang. 2 kayusula (for execution). -stakes j. taruhan. -kkt. 1 mempertaruhkan (o's future) (on pada). 2 memancangkan (planes). 3 membantu dalam keuangan seseorang. 4 mentraktir (to a lunch).
stakeout	kb. pengawas, pengintai, penjaga.
stale	ks. 1 basi, apak (of food, news). 2 membosankan (of lectures). 3 pengap, apak (of air). 4 lelah. to feel s. merasa lelah/bosan.
stalemate	kb. 1 chess : mutu. 2 jalan buntu. -kkt. mengunci (sehingga tak dapat bergerak), memacatkan.
staleness	kb. 1 kebasian (of food, news). 2 kepengapan (of air).
stalk	kb. batang, tangkai. -kkt. mengejar, mengikuti (animals).
stall	kb. 1 kedai, stan, kios. 2 (horse) kandang. 3 inf.: alasan, dalih.
stallion	kb. kuda jantan.
stalwart	kb. pendukung (partai). -ks. tegap.
stamen	kb. (j. -mina) benang sari/serbuk.
stamina	kb. 1 daya tahan, keuletan. 2 j. lih stamen.
stammer	kb. kegagapan, cara bicara yang gagap. -kki. menggagap. -stammering kb. gagap.
stamp	kb. 1 perangko. 2 ketukan kaki. 3 meterai. 4 kupon. 5 tanda. 6 cap. -kkt. 1 memperangkoi (an envelope, letter). 2 mengecap. 3 menunjukkan. 4 merentak. 5 membersihkan (snow off o's shoes). -stamped ks. dibubuhi perangko.
stampede	kb. 1 penyerbuan (of elephants). 2 perebutan (for tickets). -kkt. 1 menyerbu (o's way). 2 mendorong, mendesak. -kki. lari (berebutan).
stance	kb. 1 cara berdiri. 2 pendirian, sudut, sikap mental.
stanch	kkt. menyumbat, menghentikan (flow of blood).
stanchion	kb. tiang penyangga.
stand	1 pendirian. 2 warung, kedai, stan (flower, fruit). 3 tribune (sports). 4 pangkalan, perhentian. 5 cantelan, sangkutan (for hats). 6 kios. 7 bidang. 8 perhentian untuk memberi pertunjukan. -standing kb. kedudukan.
standard	kb. 1 standar. 2 ukuran, norma, patokan. 3 (flag) panji. 4 martabat, watak, moral. 5 tiang, kiap (for a lamp). 6 tingkat, taraf. 7 ukuran dasar (of length).
standardbearer	kb. 1 pembawa panji-panji. 2 pemimpin (of a party).
standardization	kb. standar(d)isasi, penstandaran, pembakuan.
standarize	kkt. menstandarisasikan, membakukan.
standee	kb. orang yang berdiri (di bis, di opera, dll).
standpoint	kb. sudut, pendirian.
standstill	kb. perhentian. to be at a s. terhenti samasekali. to come a s. menjadi macet, berhenti. to fight to a s. bertempur sampai sama-sama berhenti.
stank	lih stink.
stanza	kb. bait.
staple	kb. 1 bahan pokok/baku. 2 kokot, kawat jepret, jeglegan. 3 bahan tetap (of conversation). 4 serabut. -ks. pokok. -kkt. mengokot, merapikan dengan kokot.
stapler	kb. (alat) pengokot, stepler, penjepret kawat.
star	kb. 1 bintang. 2 asterisk, tanda bintang. kkt. (starred) 1 menandai dengan bintang. 2 mempertunjukkan sebagai bintang film. -starred ks. bertanda bintang.
starboard	kb. bagian kanan. s. side sebelah kanan.
starch	kb. 1 kanji, tajin (in shirt). 2 zat tepung (in food). -kkt. menganji, menajin(kan). -starched ks. berkanji, dikanji (shirt).
starchy	ks. yang mengandung zat tepung (food).
stardom	kb. pekerjaan sebagai bintang (film).
stare	kb. pandangan, tatapan. -kkt. 1 menatap. 2 nampak, kelihatan. 3 memandang (s.o. up and down). 4 menatap muka. -kki. 1 membelalak. 2 memandang, menatap (at s.o., seseorang).
starfish	kb. tapak-tapak, bintang laut.
stargazing	kb. 1 memperhatikan dan mempelajari bintang-bintang. 2 melamun. he is much given to s. dia suka melamun saja.
stark	ks. 1 yang sebenarnya. 2 dingin, kejam sekali (climate, weather). -kk sama sekali.
starlet	kb. pemain muda, bintang harapan.
starlight	kb. cahaya bintang.
starling	kb. burung jalak.
starlit	ks. bercahaya/diterangi bintang (evening).
starry	ks. berbintang-bintang, penuh bintang (sky). starry-eyed ks. mempunyai mata yang bercahaya.
start	kb. 1 awal. 2 permulaan (of a show). 3 kesempatan, bantuan. 4 gerak terkejut. -starting ks. memulai.
starter	kb. 1 auto : setater. 2 pelepas pacuan (of a race). 3 pengikut balapan/pacuan (in a race). 4 pengantar, permulaan.
startle	kkt. mengejutkan, mengagetkan. to s. s.o. out of his wits menakutkan seseorang sampai kehilangan akal. -startling ks. yang mengejutkan.
starvation	kb. mati/penderitaan kelaparan. to die of s. mati kelaparan. s. wages upah yang tak cukup untuk kebutuhan-kebutuhan dasar kehidupan.
starve	kkt. memaksa menderita kelaparan, melaparkan. -kki. mati kelaparan. to s. out memaksa menyerah karena kelaparan. to s. to death kelaparan hingga mati.
stash	kkt. inf.: menyimpan, menyembunyikan (food/money away).
state	kb. 1 negarabagian. 2 negara. 3 keadaan. 4 kebesaran. -the states amerika serikat. state-wide ks. di seluruh negara bagian. -stated ks yang ditetapkan/dijanjikan.
statebood	kb. status sebagai negarabagian.
statecraft	kb. keahlian/ketrampilan/kepandaian (sebagai) negarawan.
stateless	ks. tak bernegara.
stateliness	kb. keagungan, kemegahan.
stately	ks. agung, mulia, megah.
statement	kb. 1 pernyataan (to the press). to make a s. memberikan pengumuman, membuat pernyataan. 2 rekening.
stateroom	kb. kamar, kabin (di kapal).
stateside	ks. di/dari amerika serikat. s. news berita dari as.
statesman	kb. (j. -men) negarawan, ahli kenegaraan.
statesmanlike	ks. sebagai negarawan. s. qualities sifat-sifat seorang negarawan.
statesmanship	kb. kenegarawanan, kecakapan sebagai negarawan.
static	kb. gangguan udara (pada radio). -ks. statis. s. electricity listrik statis. s. society masyarakat yang statis.
statics	kb. ilmu statika.
station	kb. 1 stasiun. 2 pemancar, setasiun (radio). 3 pangkalan (air force, naval) 4 pos. 5 lingkungan. station-to- station ks. tel.: dari stasiun ke stasiun (bersedia berbicara dengan siapa saja pada nomor yang dipanggil). s. wagon station wagon.
stationary	ks. 1 tak (dapat) bergerak (of furniture). 2 tak berubah (in number). 3 yang seimbang. meteor.: s. front keadaan-keadaan cuaca yang seimbang.
stationery	kb. 1 kertas surat. 2 alat tulis-menulis. office s. alat tulis-menulis kantor.
stationmaster	kb. kepala/sep setasiun.
statistic	kb. statistik.
statistical	ks. yang berhubungan dengan statistik. s. date. fakta-fakta statistik. -statistically kk. secara statistik.
statistician	kb. ahli statistik.
statistics	kb. ilmu statistik. j. angka-angka statistik. s. on the election angka-angka statistik dari pemilihan.
statuary	kb. (j. -ries) patung-patung.
statue	kb. patung.
statuesque	ks. dengan pandangan yang seram.
statuette	kb. arca, patung kecil.
stature	kb. tinggi seseorang. he's above average s. ia melebihi tingi orang pukul-rata/rata-rata.
status	kb. 1 status. 2 keadaan. s. conscious sadar akan pangkat. s. quo keadaan tetap pada suatu saat tertentu. s. seeker pengejar gengsi, gila pangkat. s. symbol tanda kebesaran.
statute	kb. undang-undang. -statutes j. anggaran dasar.
statutory	ks. menurut undang-undang. s. law undang-undang.
staunch	ks. kukuh, setia. a s. democrat seorang demokrat yang kukuh. -kkt. = stanch.
stave	kb. helaian papan yang diikat dengan ban besi. -kkt. (staved atau stove) to s. in menabrak sampai pecah, meremukkan kedalam (of the boat).
stay	kb. 1 tinggal. 2 penundaan. 3 jahitan penguat pada pakaian. 4 ruji (in an umbrella). 5 penupang. stay-at-home kb. seseorang yang lebih suka tinggal di rumah.
std	[standard] standar, baku, norma.
ste	[sainte] santa.
stead	kb. faedah, manfaat. to server/stand one in good s. berjasa/bermanfaat sekali bagi seseorang.
steadfast	ks. tabah, setia. -steadfastly kk. tetap, tabah.
steadfastness	kb. ketabahan, kesetiaan.
steadiness	kb. 1 keteguhan hati. 2 ketetapan (of hand, gaze). 3 kestabilan (of prices).
steady	kb. inf.: (j. -dies) pacar. -ks. 1 kokoh (table). 2 tetap (employment, customer). 3 mantap (of surgeon's hand). 4 (secara) terus-menerus (breeze, progress). 5 kuat (nerves). 6 tetap (barometer, demand). -steadily kk. terus- (menerus).
steak	kb. sepotong daging sapi, bistik. round s. daging punggung sapi. salisbury s. sejenis pergedel daging sapi.
steakhouse	kb. restoran bistik.
steal	kb. inf.: barang yang harganya murah sekali. -kkt. (stole, stolen) 1 mencuri, mencoleng. 2 menyerobot, membolos. -stealing kb. pencurian, tindakan mencuri.
stealth	kb. by s. secara sembunyi-sdembunyi, dengan diam-diam.
stealthiness	kb. cara diam-diam/tersembunyi.
stealthy	ks. secara diam-diam, dengan cara sembunyi-sembunyi. -stealthily kk. dengan diam-diam.
steam	kb. 1 uap air (panas). 2 uap, setom. 3 kukus. 4 tenaga, enersi. -kkt. 1 mengukus (food). 2 membersihkan dengan uap (panas). 3 menyemprot dengan uap (wallpaper). s. room mandi uap.
steamboat	kb. kapal uap/api.
steamed-up	ks. penuh bersemangat. to get all s.-up over s.t. berapi-api semangatnya.
steamer	kb. kapal api/uap. to take a s. to..... naik kapal api ke.....
steamship	kb. kapal api/uap.
steamy	ks. beruap, penuh dengan uap.
steed	kb. kuda.
steel	kb. baja. s. blue biru (seperti) baja. s. castings tuangan baja. s. engraving a) seni pahat baja. b) ukiran baja.
steelmaker	kb. pembuat baja.
steelworker	kb. buruh pabrik baja.
steelworks	kb. pabrik baja.
steely	ks. seperti/laksana baja.
steep	ks. 1 curam (hill). 2 tinggi (price). -kkt. to s. o.s. in philosophy mendalami/mengasyikkan (diri) dalam ilmu falsafah. -kki. merendam dalam air panas (of sea).
steeple	kb. menara.
steeplechase	kb. lomba kuda melalui rintangan-rintangan.
steeplejack	kb. tukang panjat menara (untuk membersihkan, memperbaiki).
steepness	kb. kecuraman, keterjalan.
steer	kb. lembu jantan. -kkt. menyetir, mengemudikan (a vehicle). -kki. mengemudikan. -steering kb. sistim kemudinya/setirannya.
steerage	kb. kelas dek/geladak (di kapal).
stein	kb. gelas/mangkok bir.
stellar	ks. sebagai bintang. s. role peranan sebagai bintang (dalam pilem dsb). s. spectrum spektrum bintang.
stem	kb. 1 tangaki (flower). 2 batang, gagang (of pipe). 3 batang (of watch). 4 tandan (of bananas). 5 akar kata (of a word).
stemware	kb. gelas-gelas yang bertangkai.
sten	kb. s. gun senapan sten, mataliur.
stench	kb. bau busuk/amis, hancing.
stencil	kb. 1 stensil. 2 setensilan (material). -kkt. menyetensil. s. paper kertas setensil.
stenographer	kb. juru steno, stenograf.
stenographic	ks. stenografis. s. report laporan stenografis.
stenography	kb. stenografi, tulisan cepat.
stentorian	ks. nyaring, keras sekali (suara).
step	kb. 1 langkah. 2 tindakan. 3 anak tangga (on a ladder). 4 tingkat. 5 irama. steps j. tangga. -kkt. (stepped) menginjakkan (foot). step-up kb. peningkatan (in production). stepped-up ks. bertambah-tambah (production, demand).
stepbrother	kb. abang/kakak tiri, adik tiri laki-laki, saudara tiri.
stepchild	kb. anak tiri.
stepdaughter	kb. anak tiri perempuan.
stepfather	kb. ayah tiri.
stepladder	kb. jenjang, tangga.
stepmother	kb. ibu tiri.
stepparent	kb. orang-tua tiri.
steppe	kb. padang rumput yang luas (tanpa pohon).
stepsister	kb. saudara perempuan tiri.
stepson	kb. anak tiri laki-laki.
ster.	[sterling] sterling.
stereo	kb. stereo, alat gramofon dengan stereo.
stereophonic	ks. stereoponis. s. recording rekaman stereoponis.s. sound suara stereoponis.
stereopticon	kb. stereoptikon.
stereoscopic	ks. stereoskopis. s. lens. lensa stereoskopis.
stererotype	kb. stereotip, klise. -kkt. to be stereotyped meniru-niru.
sterile	ks. 1 steril, mandul (person or animal) 2 steril, suci hama (bandage). 3 tandus (soil). 4 hampa (in ideas).
sterility	kb. (j. -ties) kemandulan, kesterilan.
sterilization	kb. sterilisasi, pemandulan.
sterilize	kkt. mensterilkan, memandulkan. sterilized gauze kain khasah yang telah disterilkan.
sterilizer	kb. alat sterilisasi.
sterling	kb. uang sterling. -ks. 1 sejati, tulen. 2 luhur (character). 3 bermutu. s. performance pertunjukan yang bermutu.
stern	kb. buritan, bagian belakang kapal. -ks. 1 keras. 2 jahat, buruk (climate). 3 tegang (look).
sternness	kb. 1 ketajaman, kekerasan, kekasaran. 2 keseksamaan, kepatuhan, kajituan.
sternum	kb. tulang dada.
stethoscope	kb. stetoskop.
stevedore	kb. buruh pelabuhan (untuk memuat dan membongkar kapal).
stew	kb. 1 rebusan, masakan hospot. 2 inf.: susah-hati. -kkt. merebus pelan-pelan (food). -stewed ks. 1 yang direbus. s. fruit buah yang direbus, rebusan buah. 2 sl.: mabok.
steward	kb. 1 pelayan (deck, dining room). 2 av.: pramugara. 3 pengurus (of a church).
stewardess	kb. pramugari.
stewardship	kb. pekerjaan mengurus.
stewpan	kb. panci rebus.
stewpot	kb. periuk-belanga.
stick	kb. 1 (walking) tongkat. 2 batang. 3 potongan. 4 (golf, hockey) getokan. 5 av.: kemudi. -kkt. (stuck) 1 menikam. 2 menusuk. 3 memasukkan. 4 melekatkan. 5 menempelkan. menyuntingkan. 7 menjulurkan. 8 inf.: menipu. 9 memancangkan. 10 mencocokkan.
sticker	kb. etiket, pelekat, tempelan.
stickiness	kb. keadaan bergetah/lengket.
stickler	kb. orang ngotot. to be a s. for honesty sangat mnghargai kejujuran, berpegang teguh kepada kejujuran.
stickpin	kb. peniti (dasi).
sticky	ks. 1 (me)lengket, leceh. 2 lembab dan panas (day). 3 inf.: sulit (situation).
stiff	kb. sl.: mayat. -ks. 1 kaku (collar, fabric). 2 keras, bersikeras, kuat, gigih. 3 berat. 4 inf.: tinggi (price). 5 kencang (breeze). 6 sulit. 7 kental. 8 ketat. (of lock). 9 amat, sekali. stiff-backet ks. bersandaran keras (chair).
stiff-necked	ks. bersikeras, berkeras-degil.
stiffen	kkt. mengeraskan (clothes). -kki. mengeras, menjadi kaku (with rage, of jelly). -stiffening kb. pengerasan.
stiffness	kb. 1 kekakuan (of manner, of joints). 2 sulitnya (of an exam). 3 tingginya (of price). 4 kekentalan (of jelly).
stifle	kkt. 1 mencekik. 2 menahan (a yawn). 3 membuat tak berdaya, melumpuhkan (opposition, competition). -stifling ks. yang mencekik, gerah, sangat melemaskan.
stigma	kb. noda, cacad.
stigmatize	kkt. merupakan noda, menodai.
stiletto	kb. belati.
still	kb. 1 (whiskey) penyuling. 2 keheningan, kesunyian (of the night). 3 film : gambar fragmen. -ks. tenang. s. evening malam yang tenang. -kk. masih. are they s. there? apakah mereka masih disana?
stillbirth	kb. kelahiran mati.
stillborn	ks. 1 lahir mati (baby). 2 gagal (hope).
stillness	kb. keheningan, kesunyian.
stilt	kb. jangkauan. to walk on stilts naik jangkungan.
stilted	ks. 1 muluk-muluk. 2 kaku, resmi.
stimulant	kb. stimulans, (obat) perangsang.
stimulate	kkt. 1 merangsang, menggairahkan, menstimulir. to s. production merangsang produksi. 2 mendorong (s.o). -stimulating ks. yang membangkitkan semangat, yang menimbulkan kegairahan.
stimulation	kb. 1 perangsangan. 2 perangsang, pendorong.
stimulative	kb. perangsang. ks. yang suka merangsang.
stimulus	kb. 1 perangsang (of a nerve). 2 pendorong, perangsang, dorongan. to give a s. to education memberi dorongan kepada pendidikan.
sting	kb. 1 sengatan (of a bee). 2 kepedihan (of defeat). 3 pukulan (of attack). -kkt. (stung) 1 menyengat. 2 menyakitkan hati, melukai (from a remark). -kki. merasa perih.
stinger	kb. alat penyengat.
stinginess	kb. kekikiran, kebakhilan, kelokekan, kepelitan.
stingy	ks. 1 kikir, lokek, pelit, bakhil (person). 2 berdikit-dikit. s. serving of ice cream sajian eskrim secara berdikit-dikit.
stink	kb. bau busuk. -kkt. (stank, stunk) 1 berbau busuk/keras. 2 tak disukai. -stinking ks. yang berbau keras.
stinker	kb. inf.: orang yang buruk tabiatnya. that course is a real s. pelajaran itu sungguh yang sulit sekali.
stint	kb. tugas. to do o's. s. menjalankan tugasnya.
stipend	kb. 1 beasiswa (for education). 2 gaji, upah tetap.
stipulate	kkt. menetapkan. the contract stipulated that... kontrak itu menetapkan bahwa..... -stipulated ks. yang ditentukan. the s. sum jumlah yang ditentukan.
stipulation	kb. syarat, ketentuan.
stir	kb. 1 keributan, kegemparan. 2 sl.: (jail) penjara. 3 kacauan, adukan. -kkt. (stirred) 1 mengaduk (food). 2 mengobarkan (the fire). 3 menggerakkan. -stirring ks. yang menggemparkan.
stirrup	kb. pemijak kaki, sanggurdi, behel.
stitch	kb. 1 setik. 2 setik jahitan (by a surgeon). -kki. menjahit. -stitching kb. jahitan.
stock	kb. 1 fin.: saham, sero. 2 persediaan. 3 keturunan. 4 (food) air kaldu. 5 ternak. 6 batang (of a rifle). -kkt. 1 menyediakan, mempunyai (dalam persediaan), menyimpan barang. 2 mengisi. stock-intrade kb. 1 barang persediaan/jualan. 2 alat-alat bertukang).
stock-still	ks. tidak bergerak. -stocked ks. well-s. shop toko yang penuh persediaannya.
stockade	kb. benteng, tembok pertahanan.
stockbroker	kb. pedagang/makelar saham.
stockholder	kb. pemegang saham.
stocking	kb. kaus kaki. s. cap tutup kepala yang bentuknya seperti kaus. s. feet memakai kaus kaki saja.
stockinged	ks. berkaus-kaki.
stockpile	kb. persediaan, cadangan. -kkt. menimbun, mengadakan persediaan. -stockpiling kb. penimbunan barang.
stocktaking	kb. 1 inventarisasi. 2 penilaian.
stocky	ks. pendek gemuk. -stockily kk. pendek gemuk. s. built bertubuh pendek.
stockyard	kb. tempat penyimpanan ternak.
stodginess	kb. 1 sifat membosankan. 2 keadaan gemuk pendek.
stodgy	ks. 1 tidak menarik, bosan. 2 gemuk, berat.
stogie	kb. cerutu (murah).
stoic	kb. orang yang pandai menahan hawa nafsunya.
stoical	ks. tenang dan pandai mengendalikan nafsunya.
stoicism	kb. sikap tenang, sabar dan tabah.
stoke	kkt. menyalakan api (a furnace). to s. up mengisi.
stoker	kb. tukang/juru api, setoker.
stole	kb. sejenis selendang, syal.
stole(n)	lih steal.
stolid	ks. pendiam.
stomach	kb. 1 perut. stomach-ache sakit perut. 2 selera, keinginan. -kkt. menelan, menerima.
stomp	kki. mengentakkan kaki, menerjang kebawah. to s. on menginjak.
stone	kb. 1 batu. s. fence pagar batu. 2 (grave) batu nisan. 3 biji (of peach). 4 (precious) batu permata. -kkt. 1 melemparkan batu, melempari dengan batu. 2 mengeluarkan (a peach). -stoned ks. 1 tanpa biji (fruit). 2 sl.: mabuk.
stonecutter	kb. pemahat batu.
stonemason	kb. tukang batu.
stonewall	kb. dinding tembok. to run into a s. menghadapi oposisi yang keras.
stoneware	kb. periuk-belanga.
stonework	kb. 1 bangunan baru. 2 pahatan/hiasan batu.
stony	ks. berbatu-batu (path). stony-faced ks. berpandangan dingin, tidak memperlihatkan perasaan, berwajah muka yang tidak berubah-ubah.
stood	lih stand.
stooge	kb. inf.: antek, kakitangan.
stool	kb. 1 tempat duduk yang tidak memakai sandaran, bangku tak bersandaran.
stoop	kb. 1 bungkuk. 2 (porch) serambi muka. -kki. membungkuk. stoop-shouldered ks. berbahu bungkuk.
stop	kb. 1 perhentian, setopan. 2 kenop (of organ). 3 phon.: konsonan letusan. 4 penghentian. -kkt. (stopped) 1 menghentikan . 2 menundukkan. -kki. 1 berhenti. 2 menginap (at a hotel). 3 macet, mogok. -stopped ks. tersumbat, tertutup (pipe).
stopgap	kb. pengganti sementara. this will serve as a s. pakailah ini sebagai pengisi lowongan.
stoplight	kb. 1 lampu belakang (on cars). 2 (traffic) tanda lalu lintas.
stopoff	kb. persinggahan.
stopover	kb. persinggahan.
stoppage	kb. kemacetan, penghentian. work s. kemacetan pekerjaan.
stopper	kb. sumbat, perop, tutup, sumpal. conversation s. pernyataan yang mengakhiri segala pembicaraan. -kkt. menutupi (a bottle).
storage	kb. 1 penyimpanan. to place furniture in s. menempatkan perkakas-perkakas rumah di gudang. 2 tempat penyimpanan. 3 biaya penyimpanan (costs).
store	kb. toko, warung, kedai. shoe s. toko sepatu. -stores j. perbekalan. -kkt. menyimpan (corn, clothes).
storehouse	kb. gudang. he's a s. of knowledge ia merupakan gudang pengetahuan. rice s. lumbung.
storekeeper	kb. pengusaha/petugas toko.
storeroom	kb. gudang (penyimpanan), kamar gudang.
storied	ks. 1 bertingkat. two-storied house rumah yang bertingkat dua. 2 terkenal. the s. grand canyon grand canyon yang terkenal.
stork	kb. (bururng) bangau. to have a visit from the s. lahirnya seorang bayi.
storm	kb. 1 angin topan, badai. 2 semburan (of insults). 3 tepuk tangan orang dengan riuhnya (of applause). 4 keributan. -kkt. menggempur, menyerang (a fortification). -kki. datang/ada angin ribut. s. belt daerah angin topan.
stormproof	ks. tahan badai.
stormy	ks. 1 yang berangin keras (sea, weather). 2 heboh, ribut (meeting, session).
story	kb. 1 (j. -ries) cerita, cerita, kisah. 2 riwayat. 3 inf.: bohong. 4 tingkat, loteng, lenggek.
storybook	kb. buku cerita-cerita hikayat. their love affair had a s. ending percintaan mereka berakhir seperti dalam buku-buku roman.
storyteller	kb. 1 tukang cerita, pendongeng. 2 inf.: (liar) pembohong.
storytelling	kb. 1 bercerita, mendongeng. 2 membohong.
stout	kb. bir hitam. -ks. 1 gemuk, bayak (person). 2 kuat (wagon). 3 kokoh, kuat (fence). 4 gigih , kuat (opponent). 4 gagah berani. -stoutly kk. dengan keras.
stove	kb. 1 kompor. electric s. kompor listerik. 2 tungku, perapian. lih. stave.
stow	kkt. memuat (cargo). to s. away 1 menyimpan (goods, money). 2 menyelinap/menyelundup masuk, bersembunyi sebagai penumpang gelap (of a passenger).
stowage	kb. penyimpanan barang, pergudangan.
stowaway	kb. penumpang gelap.
straddle	kb. kangkang. -kkt. 1 mengangkang, menunggang dengan kaki terkangkang (horse, fence). 2 tak mau memihak dalam (an issue).
strafe	kkt. memberondong, menembaki, menghujani dengan peluru. -strafing kb. pemberondongan.
straggle	kki. 1 menggeluyur (of a person). 2 berjurai (of hair). -straggling ks. 1 yang terurai/terjurai (hair). 2 yang menggeluyur/berkeluyuran (soldiers).
straggler	kb. 1 tukang keluyur, orang yang tersesat. 2 hewan atau binatang yang suka memisahkan diri dari kelompoknya.
straight	ks. 1 lurus. 2 inf.: sebenar-benarnya. 3 jujur, sungguh-sungguh (answer). 4 bersungguh-sungguh. -kk. 1 langsung. 2 lurus-lurus. 3 terus. 4 terus-terang. 5 jujur.
straightaway	kb. bagian jalan pacuan yang lurus. -kk. dengan segera, saat itu juga.
straighten	kkt. meluruskan (rood, nail, picture, tie). to s. out a matter 1 memebreskan/menyelesaikan suatu hal. 2 menjadi baik lagi. to s. up 1 mengatur, memberes-bereskan (a room). 2 tegak, berdiri.
straightforward	ks. 1 berterus-terang (person). 2 yang terus-terang (approach to a problem).
strain	kb. 1 ketegangan. 2 rayuan, alunan (of music). 3 nada, bunyi. 4 keturunan (of casttle). -strained ks. 1 tegang, genting (relations). 2 tergeliat (back). 3 yang disaring (food). 4 keseleo (heart, muscle). 5 yang dipaksakan (of a laugh).
strainer	kb. saringan, penapis, tapisan, ayakan.
strait	kb. selat. the sunda s. selat sunda. -straits j. kesukaran. strait-laced ks. kaku, keras, teguh (opinion, attitude).
straitened	ks. susah, serbakurang. to live in s. circumstances hidup dalam keadaan miskin.
strand	kb. 1 pantai. 2 untai, unting. 3 helai. 4 helaian (of thread). -kkt. mengandaskan, mendamparkan (a ship).
strange	ks. 1 aneh, ganjil. 2 asing, canggung. 3 asing. 4 yang tak dikenal (of faces). -strangely kk. dengan cara yang aneh.
strangeness	kb. keadaan tidak dikenal.
stranger	kb. 1 orang yang tak dikenal. a s. came to the the door ada orang yang tak dikenal datang ke pintu. 2 orang baru. he's no s. to us dia bukan orang baru bagi kami.
strangle	kkt. 1 mencekik (s.o.). 2 menahan (a desire). -kki. he strangled to death ia mati tercekik.
stranglehold	kb. 1 pegangan mencekik (wrestling). 2 penghambat, perintang.
strangler	kb. pencekik.
strangulated	ks. terjepit. s. hernia burut yang terjepit.
strangulation	kb. (pen) cekikan, keadaan terbebang/kebebangan, strangulasi. economic s. kemacetan ekonomi.
strap	kb. 1 ambin, tali pengikat. shoulder s. ban/tali bahu, selempang. 2 tali pegangan, ikat pemegang (in a bus). -kkt. (strapped) 1 mengikat, melilit dengan ban pengikat. 2 mencambuk dengan ikat.
straphanger	kb. inf.: penumpang yang berdiri sambil berpegang pada tali pegangan.
strapless	ks. tak bertali bahu (gown).
strapped	ks. inf.: kurang/kekurangan uang. -strapping ks. inf.: kuat, tegap.
strata	lih stratum.
stratagem	kb. 1 tipu-daya. 2 muslihat.
strategic	ks. strategis. -strategically ks. secara strategis, menurut siasat/rencana.
strategist	kb. ahli siasat (perang), penyiasat.
strategy	kb. (j. -gies) 1 mil.: strategi, ilmu siasat (perang). 2 siasat, akal.
stratification	kb. stratifikasi.
stratifies	lih stratify.
stratify	kkt. (stratified) membagi atas tingkatan-tingkatan. highly stratified society masyarakat yang sangat bertingkat-tingkat.
stratosphere	kb. stratosfir.
stratum	kb. (j. strata) lapisan. social strata lapisan-lapisan sosial.
straw	kb. 1 jerami. s. hat topi jerami. 2 sedotan (for drinks). straw-colored ks. kekuning0kuningan, pirang.
strawberry	kb. (j. -ries) (buah) arbei. s. jam sele arbei.
strawboard	kb. kardus/karton jerami.
stray	kb. hewan yang tersesat. -ks. 1 sesat (animal). 2 kesasar, nyasar. -kki. 1 berkeliaran (of an animal). 2 menyimpang (from the right path, from the text).
streak	kb. 1 lapisan (of fat). 2 lintasan (of lightning). 3 coret, coreng (of dirrt, paint). 4 coreng. 5 rentetan (of good luck). 6 unsur, nada. -kkt. mencoreng, mencoret (o's face with s.t.).
streaky	ks. bergaris-garis, bercoreng.
stream	kb. 1 sungai (kecil). 2 cucuran (of blood, tears). 3 aliran. 4 aliran, urut-urutan. 5 berkas (of light). -kkt. mengalirkan, mengeluarkan (blood). -kki. 1 melambai-lambai (in the wind). 2 bercucuran, mengalir (of liquid).
streamer	kb. 1 ular-ularan. 2 pita (on gowns).
streamline	kkt. 1 melangsingkan (o's figure). 2 memepersingkat (an office). -streamlined ks. yang lancar, efisien (program, vehicle). -streamlining kb. pelurusan.
streamliner	kb. kereta api cepat.
street	kb. jalan. one-way s. jalan satu jurusan. s. accident kecelakaan di jalan. s. lamp/light lampu jalan. street-length ks. yang panjangnya biasa. s. level setinggi jalan. s. sign papan nama jalan.
streetcar	kb. trem.
streetwalker	kb. pelacur, wanita "p", kupu-kupu malam.
strength	kb. 1 kekuatan. s. of materials kekuatan materi. 2 tenaga. s. of mind tenaga/kekuatan pikiran. 3 daya. tensils s. daya regang. 4 jumlah, persentase (of alcohol).
strengthen	kkt. memperkuat. to s. a wall memperkuat dinding. to s. a solution memperkuat sesuatu campuran/larutan.
strenuous	ks. 1 berat (exercise). 2 sibuk. 3 kuat (opposition). to object strenuously berkeberatan kuat.
strep	kb. inf.: bakteri streptokokus. s. throat infeksi/sakit kerongkongan, sakit tenggorokan disebabkan bakteri streptokokus.
streptomycin	kb. streptomisin.
stress	kb. 1 ketegangan. mental s. ketegangan jiwa. 2 tekanan. -kkt. menitikberatkan, memberi tekanan pada (important issues, a syllable).
stretch	kb. 1 bidang, potong, trayek (of road). 2 jangkauan/uluran (of the arm). 3 bagian. 4 sl.: masa. -kkt. 1 merentangkan (a rope). 2 melonggarkan/melebarkan (shoes, hat, gloves). 3 memperlunak (the law). 4 inf.: melebih-lebihkan (the truth).
stretcher	kb. 1 usungan (for patients). stretcher-bearer pembawa usungan. 2 alat perengang (for clothes).
stretchy	ks. inf.: elastis.
strew	kkt. (strewed, strewed atau strewn). 1 menaburkan (s.t.). 2 menaburi (with s.t.). 3 bertebaran.
strewn	lih strew.
stricken	lih strike.
strict	ks. 1 keras (discipline, orders). 2 sempurna (neutrality). 3 tepat (meaning/tense of the word). 4 teliti, seksama (reasoning). -strictly kk. dengan keras. smoking is s. prohibited dilarang keras merokok.
strictness	kb. kekerasan.
stricture	kb. 1 med.: penyempitan. 2 kritik, kecaman. to pass strictures (up) on melontarkan/mengeluarkan kecaman-kecaman.
stride	kb. langkah. -kkt. melangkahi (a fence). -kki. melangkah.
strident	kb. lengking (voice).
strife	kb. perselisihan, percekcokan. domestic s. percekcokan rumah-tangga.
strike	kb. 1 pemogokan. the s. has been called off pemogokan sudah dihentikan. 2 penemuan (of gold). 3 mil.: serangan. -kkt. (struck, struck atau stricken) 1 melanggar, menabrak. 2 menemukan. 3 memukul, menampar. 4 menyambar. 5 membentur. 6 mencoret, menghapus
strikebreaker	kb. orang yang mencoba memecahkan pemogokan.
striker	kb. pemogok.
string	kb. tali, benang. 2 tali, senar (of a tennis racket). 3 untai. 4 rentetan (of victories, newspapers). 5 rangkaian, deretan (of radio stations). 6 syarat. -strings j. alat-alat musik gesek. -kkt. 1 menguntai (beads). 2 mengupas (beans). 3 memberi.
stringency	kb. (j. -cies) kekerasan.
stringent	ks. keras.
stringer	kb. 1 pengupas (of beans). 2 balok. 3 news.: wartawan setempat.
stringy	ks. menyerabut, berserabut.
strip	kb. 1 carik. 2 potong (of meat). 3 bidang (of land). 4 av.: landasan. 5 bilah, kepingan. -kkt. (stripped) 1 mengupas, menguliti. 2 menelanjangi, menggunduli. 3 merampok/mencuri. 4 mengosongkan. 5 mematahkan. 6 menggunduli. 7 mencopoti, melucuti.
stripe	kb. 1 belang (of a tiger). 2 garis (on cloth). 3 jalur (on a playing field, street, or highway). 4 mil.: strip, seterip. 5 garis-garis lebar, jalur-jalur (on a flag). -striped ks. berbelang (cat).
stripling	kb. pemuda (tanggung), teruna, remaja.
striptease	kb. tari-tarian tanpa memakai baju, tari-tarian telanjang.
strive	kki. (strove, striven) 1 berusaha/bekerja keras. 2 berjuang.
striven	lih strive.
stroke	kb. 1 pukulan (golf,tennis). 2 tembakan (of pistol). 3 gerak, gaya (swimming). 4 sambaran (of lightning). 5 med.: serangan otak, biasanya disertai kelumpuhan. 6 percobaan. 7 kayuhan. 8 coretan.
stroll	kb. jalan-jalan. to go for or take a s. berjalan-jalan, pergi makan angin.
stroller	kb. 1 orang yang berjalan-jalan. 2 kereta anak (untuk dibawa berjalan-jalan).
strong	kb. 1 kuat (of a current, evidence, electrical current). 2 keras. 3 keras, kuat. 5 bersemangat, yakin. 6 silau. 7 tengik. 8 keras, pekat hitam. strong-arm ks. tangan besi. strong-minded, strong-willed ks. berkemauan keras, tahan hati, keras kepala.
strongbox	kb. lemari/peti besi.
stronghold	kb. 1 kubu, benteng. 2 benteng (of concervation).
strongman	kb. (j. -men) 1 orang kuat (in a circus). 2 orang yang kuat, pemimpin.
strop	kb. kulit pengasah/asahan. -kkt. (stropped) mengasah dengan kulit.
strophe	kb. semacam bait.
strove	lih strive.
struck	lih strike.
structural	ks. yang berkaitan dengan struktur. s. change perubahan struktur. s. linguistics ilmu bahasa struktur. -structurally ks. dari sudut bangunannya.
structure	kb. 1 struktur. social s. struktur/susunan masyarakat. 2 bangunan, gedung. 3 susunan. 4 struktur/kerangka (of the economy). -kkt. menyusun. -structured ks. yang tersusun.
struggle	kb. perjuangan, (pe) rebutan. -kki. meronta-ronta. to s. long dengan susah payah maju terus. -struggling kb. perebutan. ks. yang hidup dengan susah payah.
struggler	kb. orang yang berusaha/bekerja keras, pejuang.
strum	kkt., kki. (strummed) 1 memetik (guitar). 2 main-main (piano). 3 mengetuk-ngetuk (on a table).
strung	lih string.
strut	kb. 1 jalannya sebagai seorang yang sombong. 2 (support) topangan. -kki. (strutted) mengigal. to s. o's stuff memamerkan kepandaian. -strutting ks. yang mengigal.
strychnine	kb. strychnin.
stub	kb. 1 puntung (of cigar, cigarette). 2 tumpulan (of a pencil). 3 potongan (of a check). 4 potongan kartu, sobekan (of a ticket). -kkt. (stubbed) menyandung.
