conjugal	ks. yang bertautan sebagai suami isteri, berhubungan dengan perkawinan. c. relation pertalian suami isteri.
conjugate	kkt. mentasrifkan, mengkonjugasikan.
conjugation	kb. tasrif, pentasrifan, konjugasi.
conjunct	ks. yang diperbantukan. c. professor profesor yang diperbantukan.
conjunction	conjunction
conjure	kkt. menyebabkan timbul dalam pikiran. to c. up menyulap(kan).
conjurer	kb. tukang sulap, sim-sala-bim.
conk	kkt. sl.: memukul (kepala). to c. out mogok. the engine suddenly conked out motor itu tiba-tiba mogok.
conn.	(connecticut) negara bagian as.
connect	kkt. 1 menyambung(kan). 2 menghubungkan. 3 menghubungkan, memasang. 4 bersambung. -connected ks. mempunyai koneksi. -connecting ks. yang menghubungkan/menyambung.
connection	kb. 1 hubungan, sambungan. 2 pertalian, sangkutpaut. 3 koneksi. 4 relasi. 5 saudara sepupu. to make connections menyambung perjalanan.
connective	kb. kata penyambung. c. tissue jaringan yang menyambung, jaringan penghubung.
connexion	kb. = connection.
conning	lih con.
conniption	c. fit kb. inf.: keadaan kena selap histeri, kemasukan setan.
connivance	kb. kerjasama secara diam-diam. this was done with his friend's c. ini dikerjakan dengan kerjasama secara rahasia dengan temannya.
connive	kki. berkomplot. to c. to carry out a burglary bekerja sama secara diam-diam untuk melakukan pencurian (dengan pembongkaran).
connoisseur	kb. ahli khususnya dalam meneliti karya-karya seni.
connotation	kb. arti (tambahan). pengertian tambahan, konotasi.
connote	kkt. mengandung arti. that word connotes s.t. quite different kata itu mengandung arti yang berlainan sama sekali.
connubial	ks. yang berhubungan dengan perkawinan. c. bliss kebahagiaan perkawinan.
cons.	(consonant) konsonan.
consanguinity	kb. pertalian/keturunan darah, famili kekerabatan.
conscience	kb. kata hati, suara hati, hati nurani. conscience-stricken ks. perasaan sangat bersalah.
conscientious	ks. berhati-hati, bersungguh. 2 teliti. c. student mahasiswa yang teliti. -conscientiously kk. dengan berhati-hati/bersungguh-sungguh/teliti.
conscientiousness	kb. sifat berhati-hati, sifat mendengarkan kata hati.
conscionable	ks. adil, tidak berat sebelah. he tends to be a c. man ia condong bersikap adil.
conscious	ks. 1 sadar. he was c. after his fall dia sadar sesudah ia jatuh. 2 disengaja. to tell a c. lie berdusta dengan sengaja.
consciousness	kb. kesadaran. to lose c. pingsan. to regain c. menjadi siuman kembali.
conscript	kb. wamil, wajib militer. -kkt. mewajibkan militer, mewamilkan. to c. s.o. for the home guard mewamilkan seseorang untuk hansip.
conscription	kb. 1 wajib/tugas militer, kewajiban dinas militer. 2 konskripsi, pengerahan.
consecrate	kkt. 1 mentahbiskan. 2 mengabdikan. -consecrated ks. suci. he lies buried in c. ground ia dimakamkan di tempat suci.
consecration	kb. rel.: pentahbisan. 2 pengabdian (diri).
consecutive	ks. 1 berturutan. 2 bertalian
consensus	kb. persetujuan umum, konsensus, mufakat (umum).
consent	kb. 1 izin. 2 persetujuan. -kki. 1 menyetujui. 2 mengabulkan, mengizinkan.
consequence	kb. 1 akibat, konsekwensi. 2 kemuliaan. in c. of berpegang pada, disebabkan oleh, sebagai akibat dari.
consequent	ks. berikut, sebagai akibat(nya). -consequently kk. sebagai akibat, maka dari itu, (oleh) karenanya.
conservation	kb. 1 pengawetan, pelindungan alam. natural c. pengawetan alam. 2 penyimpanan, kekekalan (of energy)
conservatism	kb. konservatisme, kekolotan.
conservative	kb., ks. konservatif, kolot. -conservatively kk. secara kolot.
conservatory	kb. (j. -ties) 1 sekolah musik, konservatori. 2 rumah kaca.
conserve	kkt. 1 mengawetkan, mengkalengkan. to c. fruit mengawetkan buah-buahan. 2 menghematkan (energy).
consider	kkt. 1 mempertimbangkan. 2 menganggap. 3 memikirkan, mengingat. -considered ks. betul-betul dipertimbangkan. -considering kd. mengingat.
considerable	ks. 1 sekali, amat. he's a man of c. wealth ia seorang yang kaya sekali. 2 sungguh-sungguh, sedapat mungkin. -considerably kk. sekali, sangat.
considerate	ks. baik budi, penuh perhatian. a c. person seorang yang baik budi.
consideration	kb. 1 pertimbangan. 2 perhatian, ketenggangan. 3 uang, upah. after due c. sesudah memikirkannya/menimbangnya baik-baik.
consign	kkt. 1 mengirimkan, menyerahkan. the books were consigned to him buku-buku itu dikirimkan kepadanya. 2 membuang, mengasingkan.
consignee	kb. penerima barang, sipenerima.
consigner	= consignor.
consignment	kb. pengiriman. these goods are for c. abroad barang-barang ini kiriman untuk luarnegeri. on c. sebagai penitipan, konsinyasi.
consignor	kb. pengirim barang.
consist	kki. terdiri, diperbuat (of dari,atas). the fabric consists of nylon and dacron kain itu terdiri dari nylon dan dacron.
consistency	kb. (j. -cies) 1 kemantapan dalam bertindak, ketetapan, konsekwensi. 2 kekentalan, konsistensi.
consistent	ks. 1 tetap, konsekwen. 2 cocok, bersesuaian. -consistently kk. terus-menerus, tetap.
consolation	kb. penghibur, hiburan, lipur. c. prize hadiah penghibur.
console	kb. tempat mata/tuts (of organ, piano). -kkt. menghibur. -consoling ks. yang menghibur. c. though pikiran yang menhibur.
consolidate	kkt. 1 menggabungkan. 2 mengkonsolidir, mengkonsolidasikan -consolidated ks. gabungan. c. school sekolah gabungan.
consolidation	kb. 1 penggabungan, konsolidasi. 2 gabungan. to form a c. membentuk gabungan.
consomme	kb. kaldu.
consonance	kb. persesuaian, kecocokan. c. of opinions persesuaian pendapat.
consonant	kb. konsonan, huruf mati. -ks. sesuai, cocok. this is not c. with our plans ini tak sesuai dengan rencana-rencana kami.
consonantal	ks. yang berhubungan dengan konsonan.
consort	kb. suami atau isteri. in c. with bersama-sama. -kki. berkawan bergaul (with dengan).
consortium	kb. perkongsian, konsortium.
conspectus	kb. ikhtisar, ringkasan.
conspicuous	ks. menyolok mata. he is c. by his absence kemangkirannya sangat menyolok. she's always trying to make herself c. ia senantiasa berusaha menarik perhatian orang.
conspicuousness	kb. kejelasan, sifat menyolok.
conspiracy	kb. (j. -ries) kongkalikong, komplot(an), sekongkolan, konspirasi.
conspirator	kb. konspirator, orang yang berkomplot.
conspire	kki. bersekongkol, berkomplot. to c. to embezzle government funds bersekongkol untuk menggelapkan uang pemerintah.
const.	(constituation) undang-undang dasar.
constable	kb. jagabaya, polisi.
constabulary	kb. (j. -ries) angkatan kepolisian.
constancy	kb. (j. -ties) 1 ketetapan, keteguhan. 2 kepatuhan, kesetiaan.
constant	kb. kesatuan yang konstan. -ks. terus-menerus. 2 tetap, konstan. c. value harga tetap, nilai yang tetap. -constantly kk. dengan terus-menerus, tak henti-hentinya. she was c. nagging ia tak henti-hentinya merengek.
constellation	kb. 1 konstelasi, perbintangan. 2 kumpulan. c. of scholars kumpulan sarjana-sarjana yang gemilang.
consternation	kb. 1 kelumpuhan, ketakutan yang melumpuhkan. 2 kekuatiran, ketakutan besar.
constipate	kkt. bread constipates him roti membuat dia sukar buang air (besar). -constipated ks. sembelit. -constipating ks. yang menyebabkan sembelit. some foods are c. beberapa jenis makanan menyebabkan sembelit.
constipation	kb. sembelit.
constituency	kb. (j. -ties) jumlah atau para pemilih.
constituent	kb. 1 pemilih. 2 unsur pokok. -ks. 1 unsur pokok. 2 konstituante.
constitute	kkt. 1 merupakan. 2 terdapat. 3 mengangkat. constituted authority pejabat/pembesar yang diberi kuasa
constitution	kb. 1 govt.: undang-undang dasar. 2 keadaan jasmani. he has a strong c. keadaan badannya kuat.
constitutional	kb. latihan penyehat badan, gerak badan. i went out for morning c. saya keluar berjalan-jalan untuk latihan penyehat badan waktu pagi -ks. bersifat dasar/pokok. this law is not c. undang-undang ini tidak berdasakan undang-undang dasar.
constrain	kkt. memaksa,mendesak. i feel constrained to tell you that... saya merasa terpaksa untuk mengatakan kepadamu bahwa...
constraint	kb. 1 ketidakleluasaan. 2 paksaan. he can't stand any sort of c. ia tak dapat menerima paksaan dalam bentuk apapun juga. 3 pembatas.
constrict	kkt. mengerut, menarik.
constriction	kb. 1 sesak, keadaan terdesak. c. in the chest may signify heart trouble rasa sesak dalam dada bisa menandakan penyakit jantung. 2 penyempitan.
construct	kb. gagasan, konsepsi. freedom is a c. kebebasan adalah sebuah paham yang abstrak. -kkt. mendirikan, membangun. to c. a building mendirikan gedung.
construction	kb. 1 pembuatan, pembangunan. 2 bangunan. 3 tafsiran. 4 susunan/bentuk.
constructor	kb. pembangun, insinyur pembangunan, pembina.
construe	kkt. menafsirkan, menguraikan. i don't know how to c. his statement saya tidak tahu bagaimana menafsirkan pernyataannya.
constuctive	ks. yang membangun/berguna. c. criticism kecaman yang membangun.
consul	kb. konsul. c. general konsul jenderal.
consular	ks. konsuler. c. affairs urusan konsuler.
consulate	kb. konsulat. c. general konsulat jenderal.
consult	kkt. 1 berunding dengan. 2 memeriksa, mencari keterangan dari. 3 menanyakan. -kki. berunding/berkonsultasi. -consulting kb. memberi nasihat.
consultant	kb. penasihat (ahli), konsultan. c. for an engineering firm penasihat pada sebuah firma tekhnik.
consultation	kb. konsultasi, perundingan. to hold a c. mengadakan konsultasi.
consultative	ks. (bertindak sebagai) penasihat. c. body badan penasihat.
consume	kkt. (me)makan, menghabiskan. to c. candy memakan gula-gula. this car consumes too much oil mobil ini terlalu banyak memakan oli.
consumer	kb. pemakai, konsumen.
consummate	ks. sempurna. c. skill keahlian yang sempurna. -kkt. 1 menjadi sempurna. 2 mewujudkan. 3 melaksanakan, menyelesaikan (a sale).
consummation	kb. 1 penyempurnaan (of marriage). 2 perwujudan. c. of o's dreams perwujudan impian-impiannya. 3 pelaksanaan (of a sale).
consumption	kb. 1 med.: sakit paru-paru. 2 konsumsi, pemakaian.
consumtive	kb. yang menderita penyakit paru-paru.
cont.	1 (contents) isi. 2 (continued) disambung.
contact	kb. 1 hubungan. 2 koneksi. 3 bersentuhan/bersinggungan dengan to make c. with berhubungan dengan. c. breaker alat pemisah/pemutus hubungan aliran listrik secara otomatis. c. lens. lensa kontak. -kkt. 1 berhubungan dengan. 2 av.: menghidupkan.
contagion	kb. 1 penularan. c. from infected patients penularan dari pasien yang menular. 2 pengaruh buruk. the c. of show business pengaruh buruk dari dunia kesandiwaraan.
contagious	ks. 1 menular. c. disease penyakit menular. 2 mudah menjalar. his good humor is c. kegembiraan hatinya mudah menjalar kepada orang lain.
contain	kkt. 1 berisi. 2 mengandung, mengetahui. 3 berisi, memuat. 4 menahan.
container	kb. 1 botol, kotak, kaleng. milk c. botol/wadah untuk (tempat) susu. 2 wadah. 3 stoples.
containment	kb. penahanan, pengurungan. c. of the enemy troops on the border penahanan pasukan musuh di perbatasan.
contaminate	kkt. 1 mengotorkan. this food was contaminated by flies makanan ini sudah dikotorkan oleh lalat. 2 mencemarkan, menjadi buruk. his association contaminated him ia menjadi buruk karena bergaul dengan dia.
contamination	kb. pengotoran, pencemaran. c. of food pengotoran makanan.
contemplate	kkt. 1 merenungkan (the future). 2 bermaksud. -kki. merenungkan, menatap.
contemplation	kb. 1 perenungan, bermenung-menung. 2 memikirkan, mengingat.
contemplative	ks. tafakur. he has a c. bent ia seorang yang tafakur.
contemporaneity	kb. kesezamanan.
contemporaneous	ks. sebaya, sejaman. he and i a c. ia dan saya adalah sebaya.
contemporary	kb. (j. -ries) sejaman, sebaya, seumur. he is a c. of mine ia hidup sejaman dengan saya. ia seumur dengan saya. -ks. jaman sekarang. c. writers pengarang jaman sekarang.
contempt	kb. jijik. i have only c. for that type of person jijik aku terhadap orang seperti itu. orang semacam itu hina sekali dalam pandanganku.
contemptible	ks. keji, rendah, jahat, hina. he is a c. liar ia pembohong yang keji.
contemptuous	ks. merendahkan, menghina. he tends to be c. of his friends ia cenderung memandang hina pada teman-temannya.
contend	kkt. berpendapat. -kki. 1 bertanding, berjuang (in a race). 2 melawan, menentang. to c. with menghadapi.
contender	kb. 1 pesaing, penyaing. he is definitely a c. for first place ia sudah pasti menjadi pesaing untuk memenangkan hadiah pertama. 2 lawan. 3 pendebat, pembantah.
content	kb. 1 isi, daya muat, kandungan. the c. of the radiator is half a gallon isi radiator mobil adalah setengah gallon. 2 kadar. that product has a law fat c. bahan makanan itu mengandung sedikit zat gemuk. -contents j. isi, muatan.
contention	kb. 1 pendirian, anggapan. 2 pernyataan, apa yang dikemukakan, usul. 3 pertikaian, perdebatan, perbantahan. 4 pertandingan, pertarungan.
contentious	ks. suka bertengkar/berdebat. he is a c. person ia seorang yang suka bertengkar.
contentment	kb. kesenangan, kepuasan hati, kesukaan.
contest	kb. pertandingan, kontes. -kki. 1 memperebutkan, memperjuangkan. 2 bercekcok, menggugat, mempertengkarkan (an election, a will). 3 menentang. to c. a case menentang perkara.
contestant	kb. 1 orang yang bertanding, pengikut pertandingan. 2 law : penggugat.
context	kb. 1 hubungan kata-kata, konteks. 2 suasana, keadaan.
contextual	ks. yang berhubungan dengan konteks, dilihat dalam hubungan dalam kalimat.
contiguity	kb. (j. -ties) kontak, hubungan. frequent c. of a man and woman may lead to marriage hubungan yang kerap antara seorang pria dan seorang wanita dapat menuju ke perkawinan
contiguous	ks. bersebelahan, berdampingan, berdekatan, berbatasan. the two houses are c. kedua rumah itu berdampingan.
continence	kb. pengawasan diri, pembatasan, tarak, pertarakan, perpantangan. the doctor advised c. in what he eats dokter menasehatkan supaya dia membatasi diri dalam hal makanannya.
continent	kb. benua. the c. benua eropa, tanpa kepulauan inggeris. -ks. bertarak.
continental	ks. yang bertautan dengan benua. not worth a c. tak berharga sepeserpun.
contingency	kb. (j. -cies) kemungkinan, hal yang kebetulan. we must be prepared for any c. kita harus bersedia-sedia terhadap segala kemungkinan.
contingent	kb. kesatuan, rombongan. -ks. bergantung, tergantung. my trip is c. upon funds perjalananku tergantung pada adanya keuangan.
continual	ks. 1 terus-menerus, terus-terusan. 2 tak/tanpa putus-putusnya. -continually kk. terus-menerus. it has rained c. month hari hujan terus-menerus selama sebulan.
continuation	kb. 1 (ke)lanjutan, sambungan. c. of a project kelanjutan proyek. 2 sambungan. c. on page 10 bersambung pada halaman 10.
continue	kkt. meneruskan, melanjutkan. -kki. 1 berjalan terus. 2 main terus. 3 meneruskan. 4 mengalir/membentang terus.
continuity	kb. (j. -ties) 1 kelancaran, kontinuitas kelestarian. 2 keterusan, urutan.
continuous	ks. terus-menerus. is the movie c. ? apakah filem itu terus-menerus ? -continuously kk. dengan terus-menerus, dengan tiada terhenti dengan tak henti-hentinya, terus-terusan.
continuum	kb. rangkaian kesatuan. this constitutes part of a c. ini merupakan sebagian dari rangkaian kesatuan.
contort	kkt. merubah bentuk. the clown contorted his face pelawak itu merubah-rubah air mukanya.
contortion	kb. 1 perubahan. 2 pemutar-balikan.
contortionist	kb. manusia karet.
contour	kb. garis bentuk/luar. c. map peta yang memperlihatkan garis tinggi permukaan laut.
contraband	kb. barang gelap, (barang) selundupan.
contrabass	kontrabas.
contracdistinction	kb. perbedaan karena berlawanan.
contraception	kb. kontrasepsi.
contraceptive	kb. alat/obat pencegah penghamilan.
contract	kb. kontrak, perjanjian. -kkt. 1 menyingkatkan. 2 kena, mengidap. 3 mengkerut. -kki. 1 mengkerut, menutup perjanjian/kontrak. contracting parties pihak-pihak yang mengadakan kontrak/perjanjian itu.
contraction	kb. 1 singkatan. "i'd" is a c. for "i would" "i'd" merupakan singkatan bagi "i would". 2 kepadatan, penyusutan, penciutan. cold causes c. dingin menyebabkan kepadatan.
contractor	kb. 1 kontraktor. 2 pemborong (pekerja bangunan).
contractual	ks. berdasar perjanjian, yang bertautan dengan kontrak. c. obligation kewajiban yang berdasar perjanjian.
contradict	kkt. 1 menyangkal. he likes to c. people ia suka benar menyangkal orang lain. 2 membantah.
contradiction	kb. kontradiksi, pembantahan, penyangkalan, pertentangan.
contradictory	ks. bertentangan, tidak cocok dengan. c. remark keterangan yang bertentangan.
contralto	kb. suara wanita yang terendah.
contraption	kb. inf.: alat atau pesawat yang aneh. what sort of machine is that c.? mesin macam apakah alat yang aneh itu ?
contrariness	kb. sifat suka menentang, sifat yang bertentangan. her c. made her on un pleasant friend sifatnya yang suka menentang menjadikan dia kawan yang kuramg menyenangkan.
contrariwise	kk. sebaliknya.
contrary	kb. kebalikan. -ks. 1 suka membantah/berlawanan/menentang. 2 bertentangan. 3 berlawanan.
contrashaft	kb. as/poros penggerak.
contrast	kb. perbedaan, kontras. -kkt. 1 memperbedakan. 2 membandingkan -kki. 1 merupakan kontras, berkontras 2 memperlihatkan kontras.
contrastive	ks. yang mempelihatkan perbedaan. c. studies of cultures penyelidikan perbedaan kebudayaan-kebudayaan.
contravene	kkt. bertentangan dengan, menentang, melanggar. this strike contravenes a well established agreement pemogokan ini bertentangan dengan persetujuan yang sangat kokoh.
contravention	kb. pertentangan, konflik, pelanggaran. this strik is in direct c. of an agreement pemogokan ini langsung bertentangan dengan (suatu) persetujuan.
contribute	kkt. menyumbang. 2 menambah, memperbesar.
contribution	kb. sumbangan, iuran. to take a c. menerima/mengumpulkan sumbangan.
contributor	kb. 1 penyumbang, penderma (to a magazine). 2 penderma (to a fund).
contrite	ks. perasaan patah hati karena dosa, menyesal yang dalam. he felt c. ia merasa sedih dan berdosa. with a c. heart dengan perasaan sedih dan berdosa.
contrition	kb. kesedihan yang mendalam, perasaan dosa yang mendalam, perasaan sedih karena dosa.
contrivance	kb. penemuan, alat. this c. is for opening cans penemuan ini adalah untuk membuka kaleng.
contrive	kkt. membuat, menyusun. -kki. berusaha, merencanakan.
control	kb. pengawas(an), penilikan, pengaturan, penguasaan, pembatasan. -controls j. 1 tombol-tombol kontrol. alat-alat kontrol. -kkt. (controled) 1 menguasai. 2 membatasi. 3 mengatur. 4 mengendalikan, menguasai, menahan. -controlling yang berkuasa.
controversial	ks. kontroversiil, yang sedang diperdebatkan/dipercekcokkan, yang menjadi sengketa.
controversy	kb. (j. -sies) 1 perdebatan, kontroversi. 2 persengketa, sengketa, percekcokan. c. over housing percekcokan mengenai perumahan.
controvert	kkt. berlawanan dengan, menyangkal, bertentangan dengan. the statement controverts the evidence pernyataan itu berlawanan dengan kesaksian.
contusion	kb. luka memar.
conundrum	kb. teka-teki berdasar permainan kata-kata.
convalesce	convalesce
convalescence	kb. pemulihan kesehatan sesudah sakit.
convalescent	kb. seorang yang sedang sembuh dari sakit. -ks sembuh, pulih. he has been placed in a c. home ia telah ditempatkan di rumah petirahan/penyembuhan.
convection	kb. konfeksi.
convene	kkt. memanggil rapat. the chairman convened the committee ketua memanggil rapat panitia itu. -kki. bersidang, berapat. congress convenes next week konggres mulai bersidang minggu depan.
convener	kb. seseorang yang mengadakan rapat.
convenience	kb. 1 alat yang menyenangkan hidup. 2 waktu yang sebaik-baiknya, waktu yang sempat.
convenient	ks. baik sekali, tepat. 2 sesuai, cocok. 3 tidak menyusahkan. 4 dekat, tidak jauh. -conveniently kk. dengan baik sekali.
convent	kb. biara (kesatuan atau kumpulan biarawati).
convention	kb. 1 rapat, konvensi. 2 adat (kebiasaan) 3 perjanjian, persetujuan. 4 (rule) kaidah, ketentuan.
conventional	ks. 1 menurut adat (yang berlaku), konvensional, biasa. 2 yang biasa/lazim.
converge	kki. bertemu, berkumpul, berjumpa. the opposing groups converged on the square kumpulan yang berlawanan itu bertmu di lapangan.
convergence	kb. tindakan bertemu/bersatu di suatu tempat, pemusatan pandangan mata ke suatu tempat yang amat dekat.
conversant	ks. mengenal, biasa, mempunyai pengetahuan. i am not c. with that subject saya tak banyak berpengetahuan dalam hal itu.
conversation	kb. percakapan, pembicaraan. an interesting c. percakapan yang menarik.
conversational	ks. bersifat percakapan. we are using the c. method in teaching languages kita memakai metode percakapan dalam mengajarkan bahasa-bahasa.
conversationalist	kb. seorang yang pandai sekali dalam percakapan, seorang yang pandai bercakap-cakap.
converse	kb. lawan, (barang atau hal yang ) terbalik, bertentangan dengan. -conversaly kk. sebaliknya.
conversion	kb. 1 perubahan, pengubahan, konversi. to undergo c. to christianity berubah masuk agama kristen. 2 penukaran. c. of dollars into rupiahs penukaran dolar menjadi rupiah.
convert	kb. orang masuk agama lain, muallaf, mualap. -kkt. merubah, mengubah. we want to c. this porch into a room kita ingin merubah serambi ini menjadi kamar.
convertible	kb. mobil touring. she drives a c. ia mengendarai mobil touring. -ks. dapat ditukar. the money of that country is not c. mata uang negara itu tak dapat ditukar.
convex	ks. cembung.
convey	kkt. 1 menyampaikan. please c. my best wishes tolong sampaikan salam eratku. 2 membawa. taxis c. passengers taksi-taksi membawa penumpang.
conveyance	kb. 1 kendaraan. 2 pengangkutan. 3 alat pengangkut/pembawa. atrunk is a handy c. koper adalh alat pengangkut barang-barang yang baik.
conveyor	kb. 1 alat pembawa barang-barang. 2 pembawa/pengantar.
convict	kb. narapidana, orang hukuman, pesakitan. -kkt. menghukum. he was convicted of theft ia dihukum karena pencurian.
conviction	kb. 1 pendirian. he's a man of strong convections ia seorang yang kuat pendiriannya. 2 keyakinan, kepastian-kepastian. 3 penghukuman.
convince	kkt. meyakinkan. 2 mempercayakan. -convincing ks. yang meyakinkan. c. argument alasan yang meyakinkan.
convivial	ks. ramah tamah (evening, friend).
conviviality	kb. (j. -ties_ keramahtamahan. kesenangan makan-makan bersama kawan-kawan.
convocation	kb. pertemuan, rapat. the university held its annual c. universitas itu mengadakan pertemuan tahunan.
convoke	kkt. mengadakan pertemuan, memanggil. a meeting of the board was convoked panggilan diadakan untuk mengadakan sidang dewan.
convoluted	ks. 1 sulit. 2 berbelit, kusut.
convolution	kb. 1 lilit, belit. 2 kekusutan (pikiran).
convoy	convoy
convulse	kkt. membuat tertawa, mengocek perut. he convulsed the audience with his antics ia membuat para penonton tertawa terbahak-bahak karena leluconnya.
convulsion	kb. 1 sawan. 2 ledakan. 3 ketawa yang terbahak-bahak.
convulsive	ks. berkejang. c. movement geraklan berkejang/ menggelepar-gelepar.
coo	coo
cook	kb. koki, tukang masak. -kkt. memasak (food). -kki. 1 memasak. 2 menjadi tukang masak. -coking kb. masakan. c. oil minyak goreng.
cookbook	kb. buku masak(an).
cooker	kb. panci pemasak makanan.
cookery	kb. keahlian pekerjaan memasak.
cookie	= cooky.
cookout	kb. masak-masak diluar.
cooky	kb. (j. -kies) kue. c. jar stoples untuk kue. sl.: c. pusher orang yang membuang-buang waktu di pesta-pesta sehingga pekerjaannya terbengkalai.
cool	kb. 1 kesejukan. 2 sl.: ketenangan. -ks. 1 sejuk. 2 tipis. 3 dingin. 4 sl.: yang mengagumkan. -kk. sl.: to play s.t. c. berlaku tenang. -kkt. 1 mendinginkan. 2 mengurangi. -cooling ks. yang mendinginkan, yang membuat sejuk.
cooler	kb. 1 alat pendingin. 2 sl.: penjara.
coolness	kb. 1 keadaan sejuk, kesejukan. 2 ketenangan. 3 kebebasab dari kegaduhan.
coon	inf.: = raccoon.
coop	kb. kandang ayam. -kkt. to c. up mengurung. the children felt cooped up in their room anak-anak merasa terkurung di kamar mereka.
cooperate	kki. bekerja sama. you should c. with me in this matter saudara seharusnya bekerja sama dengan saya dalam hal ini.
cooperation	kb. kerjasama, koperasi.
cooperative	kb. toko koperasi. -ks. 1 bekerjasama. he's in a c. mood ia sedang suka bekerjasama. 2 secara koperatip. c. apartment apartemen yang dibeli secara koperatip.
cooperator	kb. 1 pekerjasama secara koperasi. 2 koperator.
coordinate	kb. koordinat (dalam ilmu ukur). -ks. sederajat. -kkt. 1 menyelaraskan, mengkoordinir, mengkoordinasikan, menyerasikan. 2 berkoordinasi.
coordination	kb. koordinasi.
coordinator	kb. koordinator.
cop	kb. inf.: polisi. -kkt. (copped) sl.: merebut. to c. first prize in merebut hadiah pertama dalam. sl.: to c. out menolak tugas-tugas atau kewajiban-kewajiban.
copartner	kb. rekan, kompanyon.
cope	kki. to c. with 1 menanggulangi, mengatasi. 2 menguasai.
copied	lih copy.
copier	kb. 1 penyalin, peniru. he's a good c. ia penyalin buku yang baik. 2 pembuat turunan. this machine is a good c. mesin ini baik sekali untuk membuat turunan cetakan.
copies	lih copy.
copilot	kb. pembantu pengemudi pesawat, pengemudi pesawat yang kedua, pilot pembantu.
coping	kb. kepala dinding/tembok. c. saw gergaji pembuat lekukan.
copious	ks. berlebih-lebihan, banyak sekali. he drank c. amounts of beer ia minum bir berlebih-lebihan.
copper	kb. 1 tembaga. c. color warna tembaga. c. kettle kuali/belang besar dari tembaga. 2 sl.: polisi.
copperhead	kb. sejenis ular yang berbisa (kepalanya berwarna tembaga).
copperplate	kb. pelat/lempeng tembaga.
copra	kb. kopra.
copter	inf.: = helicopter.
copula	kb. kata kerja penghubung, kopula. the verb "to be" serves as a c. in english kata kerja "to be" adalah katakerja penghubung didalam bahasa inggeris.
copulate	copulate
copulation	kb. 1 persetubuhan. 2 perhubungan, pergabungan.
copulative	kb. 1 katakerja yang menghubungkan, pelantar. 2 katasambung yang menggabungkan
copy	kb. (j. -pies) 1 salinan, tembusan, turunan, kopi. 2 buah. 3 tiruan, seperti contoh. -kkt. (copied) 1 meniru. 2 menyalin. 3 menurun/meniru.
copyist	kb. 1 pembuat salinan, penyalin. 2 peniru.
copyright	kb. hak cipta, hak pengarang. -kkt. melindungi dengan hak cipta. this book has been copyrighted buku ini dilindungi hak pengarang.
coquette	kb. wanita yang suka mempermainkan, wanita genit.
coquettish	ks. genit, keletah, bersifat menarik perhatian. she has a c. manner about her sikapnya suka menarik perhatian kaum laki-laki, sikapnya genit.
coral	kb. (batu) karang. c. atoll pulau karang yang berdanau ditengahnya. c. snake semacam ular berbisa (berwarna merah kekuning-kuningan).
cord	kb. 1 kawat, snur. lamp c. kawat lampu. 2 tali. to wrap with c. mengikat dengan tali. 3 kord (ukuran kayu yang sudah dipotong, 128 kakikubik). a c. of wood setumpuk kayu bakar sebanyak satu kord.
cordage	kb. tali temali.
cordial	kb. minuman anggur manis. -ks. ramah tamah, peramah. she's s c. person ia seorang yang amat peramah. -cordially kk. dengan baik/kebaikan/hangat. c. yours, jane smith salam hangat dari temanmu, jane smith.
cordiality	kb. keramah-tamahan, kebaikan.
cordon	kb. 1 lingkaran penjagaan. 2 selempang, pita atau tali dsb. yang dipakai sebagai penghias di dada. -kkt. menutup dengan lingkaran. the area was cordoned off by tanks. daerah itu ditutup dengan lingkaran teng-teng.
corduroy	kb. semacam beledu, korduroi. c. trousers pantalon korduroi.
cordwood	kb. kayu bakar.
core	kb. 1 inti. 2 mata. 3 bagian tengah, biji. -kkt. membuang bagian tengah yang keras (an apple, pear).
coriender	kb. ketumbar.
cork	kb. 1 perop, gabus, sumbat. bottle c. perop botol. 2 pelampung. c. on a fishing line pelampung tali pancing. -kkt. menyumbat (a bottle).
corker	kb. sl.: orang atau hal yang luar biasa atau bukan main hebatnya. that story is a real c. cerita itu bukan main hebatnya.
corkscrew	kb. kotrek, (alat) pembuka sumbat botol.
cormorant	kb. sejenis burung laut.
corn	kb. 1 jagung. yield of c. hasil panen. 2 katimumul (on toe). 3 sl.: dangkal, dicari-cari. -kkt. mengawetkan dengan air garam atau dengan garam kering, mengasin(kan). -corned ks. yang diawetkan, dengan garam atau garam kering. c. beef daging kornet.
corncob	kb. tongkol jagung.
cornea	kb. selaput mata (bagian luar). selaput bening/tanduk.
corner	kb. 1 sudut, simpang. 2 pojok. 3 ruangan (in newspaper). 4 tempat yang menyendiri. 5 pelosok. 6 monopoli. -kkt. 1 mengepung (a thief). 2 memonopoli.
cornerstone	kb. 1 batu pertama. to lay the c. meletakkan batu pertama. 2 dasar, landasan. this bill is the c. of the government's economic policy ruu ini merupakan dasar kebijaksanaan ekonomi pemerintah.
cornet	kb. semacam terompet.
cornfield	kb. ladang/kebun jagung.
cornflower	kb. bunga berwarna biru (as).
cornhusk	kb. kulit/kelongsong jagung, kelobot.
cornice	kb. perhiasan diatas tembok (bagian atas tembok, pilar atau gedung yang menonjol keluar).
cornstalk	kb. batang jagung.
cornstarch	kb. kanji dari tepung jagung.
cornucopia	cornucopia
corny	ks. sl.: dangkal, rendah nilainya. his jokes are awfully c. kelakar-kelakarnya betul-betul dangkal.
corolla	kb. daun mahkota, penampung bunga.
corollary	kb. (j. -ries) akibat wajar. a sound mind is a c. of a sound body pikiran sehat adalah akibat wajar dari badan sehat.
corona	kb. 1 astr.: korona, lingkaran sinar yang mengelilingi matahari. 2 arch.: bagian yang menonjol dari bagian atas bangunan. 3 gigi bagian atas (of tooth).
coronary	kb. (j. -ries) inf.: serangan jantung. to have a c. menderita serangan jantung. c. thrombosis pembekuan darah dalam pembuluh darah/nadi, trombosa pembuluh darah.
coronation	kb. permahkotaan, penobatan.
coroner	kb. pegawai yang memeriksa sebab musabab kematian seseorang.
corp.	(corporation) perusahaan, badan hukum.
corporal	kb. kopral. -ks. badani(ah). c. punishment hukuman badani.
corporate	ks. yang berhubungan dengan badan hukum. c. company perusahaan yang bersifat badan hukum.
corporation	kb. badan hukum. state c. perusahaan negara (pn).
corporative	ks. korporasi. c. state negara korporasi.
corporeal	ks. memenuhi kebutuhanan badaniah. food is c. nourishment makanan adalah perawatan badaniah.
corps	kb. kesatuan, korps.
corpse	kb. mayat, jenazah.
corpsman	kb. (j. -men). perawat tentara atau angkatan laut.
corpulent	ks. gemuk, gendut.
corpus	kb. 1 tubuh badan. 2 bahan, kesatuan kumpulan tulisan-tulisan tentang sesuatu hal atau zaman.
corpuscle	kb. sel yang hidup, sel darah.
corral	kb. sebidang tanah berpagar kayu tempat ternak. -kt. 1 mengepung, mengelilingi. 2 mengumpulkan.
correct	ks. 1 benar, tepat, yang sebenarnya, betul. 2 baik. -kkt. 1 membetulkan, membenarkan, memperbaiki. 2 memeriksa. 3 memperbaiki, menukar. -correctly kk. dengan benar/tepat.
correction	kb. 1 pembetulan, koreksi. 2 perbaikan.
correctional	ks. c. facility penjara, lembaga pemasyarakatan.
corrective	kb. yang memperbaiki. exercise is a common c. for weak muscles gerak badan adalah suatu latihan yang bisa memperbaiki otot-otot lemah.
correctness	kb. cara yang benar, kebenaran. c. of speech berbicara dengan cara yang benar.
corrector	kb. korektor, pemeriksa.
correlate	kb. salah satu dari dua benda yang satu sama lain ada hubungannya. -kkt. menghubungkan, menyambung.
correlation	kb. pertalian, hubungan, korelasi.
correspond	kki. 1 cocok. 2surat-menyurat. 3 dapat disamakan. -corresponding ks. yang berhubungan dengan surat-menyurat. 2 sesuai, cocok, sama, bersamaan.
correspondence	kb. 1 korespondensi, surat-menyurat. 2 persesuaian.
correspondent	kb. 1 wartawan,(fem) wartawati. 2 penulis surat. she's a good c. ia rajin menulis surat.
corridor	kb. 1 gang, jalan beratap yang menghubungkan dua gedung. 2 sebidang tanah yang menghubungkan dua bagian negara.
corroborate	kkt. membenarkan, menguatkan. the facts c. the scientist's theory kenyataan-kenyataan itu membenarkan teori sarjana itu.
corroboration	kb. bukti-bukti yang membenarkan/menguatkan. the police seek c. of his statement polisi mencari bukti yang menguatkan pernyataannya.
corroborative	ks. nyata, bersifat benar, c. evidence bukti yang nyata.
corrode	kkt. merusak. rust corrodes cars karat merusak mobil.
corrosion	kb. kerusakan, karatan, hasil dari kerusakan.
corrosive	kb. bahan (peng)gigit, bahan perusak. -ks. 1 yang menggigit, yang memakan. 2 yang menghancurkan. 3 bersifat merusak. the c. effect of worry akibat yang bersifat merusak dari kerisauan.
corrugate	kkt. membengkok-bengkok seperti ombak, mengombak, berombak. -corrugated ks. berombak-ombak.
corrupt	ks. 1 korup, jahat, buruk. 2 rusak. -kkt. 1 menyuap. 2 merusak, mengubah. -kki. merusak.
corruptible	ks. dapat disuap. some people are c. beberapa orang dapat disuap.
corruption	kb. 1 korupsi, kecurangan. 2 perubahan. c. of a language perubahan bahasa dari susunan standarnya.
corruptor	kb. koruptor.
corsage	kb. korsase, bunga-bungaan yang dipakai wanita di pinggang atau bahunya.
corset	kb. korset.
cortege	kb. iring-iringan, arak-arakan. funeral c. iring-iringan pengantaran jenazah.
cortesan	kb. pelacur.
cortex	kb. 1 kulit/lapisan luar. 2 kulit otak.
cortisone	kb. kortison.
corundum	kb. korundum, aluminium okaida.
corvee	kb. korve, tobang.
corvette	kb. korvet.
cosecant	kb. kosekans.
cosine	kb. kosinus.
cosmetic	kb. alat/bahan kecantikan, perias. lipstick is a c. pemerah bibir adalah alat kecantikan.
cosmetician	kb. 1 ahli kecantikan. 2 pedagang alat-alat kecantikan.
cosmetology	kb. ilmu tata rias.
cosmic	ks. kosmik. c. rays sinar kosmik.
cosmogony	kb. (j. -nies) asal usul alam semesta.
cosmography	kb. (j. -phies) ilmu falak, kosmografi.
cosmology	kb. kosmologi.
cosmonaut	kb. angkasawan, kosmonot. woman c. angkasawati.
cosmopolitan	ks. international, tersebar di seluruh dunia. a c. city kota internasional.
cosmopolite	kb. kosmopolit, orang yang berpandangan internasional warga dunia.
cosmos	kb. kosmos.
cost	kb. 1 harga. 2 korban, kerugian. 3 ongkos. -kkt. (cost) 1 harganya, berharga. 2 meminta (korban) -costs j. ganti kerugian.
costly	ks. mahal. c. trip perjalanan mahal. 2 merugikan. c. mistake kesalahan yang merugikan.
costume	kb. 1 pakaian. national c. pakaian nasional. 2 baju. c. ball bal maske.
costumer	kb. penjahit/penjual pakaian.
cot	kb. pelbet.
cotangent	kb. kontangens.
coterie	kb. kalangan teman-teman yang sering bertamu.
cotillion	kb. semacam dansa.
cottage	kb. pondok, gubuk. c. cheese keju lembut. c. industry kerajinan tangan, perindustrian rakyat.
cotter	kb. c. pin pasak.
cotton	kb. kapas, katun. c. flannel katun halus. -kki. to c. (on) sl.: menyukai. c. candy harum manis, kembang gula.
cottonmouth	kb. sejenis ular besar berbisa (as).
cottonseed	kb. biji kapas. c. meal ampas biji kapas untuk makanan hewan. c. oil minyak biji kapas.
couch	kb. semacam dipan. -kkt. menuliskan. he couches his in blunt language ia menuliskan karangan-karangannya dalam bahasa yang terus-terang.
cough	kb. batuk. c. medicine obat batuk. -kki. (ber)batuk. to c. up 1 membatukkan (keluar). 2 sl.: mengeluarkan. -coughing kb. batuk. persistent c. batuk yang terus-menerus.
could	lih. can.
couldn't	(could not) lih can.
councel	kb. 1 nasihat.. 2 pengacara. to keep o's own c. berdiam diri dengan bijaksana, merahasiakan rencana. -kkt. menganjurkan, menasihatkan. -counseling kb. pemberian nasihat, perembukan, penyuluhan.
council	kb. dewan. municipal c. dewan kotapraja.
councilman	kb. (j. -men). penasihat, anggota dewan kotapraja.
counsellor	kb. penasihat.
count	kb. 1 (per)hitungan, jumlah. 2 pangeran. 3 tuduhan. -kkt. 1 menghitung, berhitung. 2 berarti. 3 berlaku. to c. for berharga. to c. on 1 mengharapkan. 2 memperhitungkan. to c. out. inf.: 1 menyatakan kalah. 2 sl.: mengeluarkan.
countdown	kb. perhitungan detik-detik terakhir. he began the c.: 3, 2, 1 ia memulai perhitungan detik-detik terakhir : 3, 2, 1.
countenance	kb. air muka, wajah, roman muka. -kkt. menyetujui. iwon't c. your marriage to that boy saya tak akan menyetujui perkawinanmu dengan anak itu.
counter	kb. 1 toonbank, meja pajangan/kedai, kasir. 2 alat penghitungan, kartu/keping penghitung. 3 juru hitung. 4 ling.: penolong bilangan. -ks. 1 berlawanan. 2 banding, tandingan. -kkt. membalas. -kki. menjawab.
counteract	kkt. meniadakan, menetralkan. to c. evil tendencies in the group meniadakan gejala-gejala jahat dalam golongan itu.
counterattack	kb. serangan balasan. -kkt., kki. mengadakan serangan balasan.
counterattraction	kb. hiburan bandingan/tambahan.
counterbalance	kb. (berat) imbangan, pengaruh imbangan. -kkt. mengimbangi. vacations c. work liburan mengimbangi pekerjaan.
counterblow	kb. pukulan balasan.
countercharge	kb. serangan balasan.
counterclaim	counterclaim
counterclockwise	ks., kk. berlawanan dengan jalan jarum jam.
counterdrive	kb. serangan balasan.
counterespionage	kb. kontra-spionase.
counterfeit	ks. palsu, tiruan. c. money uang palsu. -kkt. 1 memalsukan, meniru (money). 2 pura-pura, sok. she counterfeited sorrow she did not feel ia pura-pura sedih yang sebetulnya tidak dirasakan.
counterfeiter	kb. pemalsu, peniru.
counterintelligence	kb. kontraintelijen.
counterirritant	kb. alat/obat yang dipakai untuk menimbulkan suatu reaksi menghadapi sesuatu penyakit atau infeksi dsb.
counterirritation	kb. keadaan yang sengaja ditimbulkan sebagai reaksi terhadap sesuatu penyakit.
countermand	kkt. membatalkan (an order).
countermeasur	kb. tindakan balasan.
countermove	kb. langkah/tindakan balasan. c. in chess langkah balasan dalam main catur.
counteroffensive	kb. serangan balasan.
counterpane	kb. kain penutup tempat tidur (diatas sprei).
counterpart	kb. 1 rekan/teman imbangan. on technical missions abroad, the expert works with his local c. dalam misi-misi bantuan teknik diluar negeri seorang ahli bekerja dengan teman imbangan nya ( seorang ahli setempat).
counterpoin	kb. lagu tambahan yang mengiringi lagu lain.
counterrevolution	kb. kontrarevolusi.
countersign	kb. tanda balasan/jaga. -kkt. ikut menanda tangani. your wife must c. this note isterimu harus ikut menandatangani surat hutang ini.
counterthrust	kb. serangan balasan.
counterweight	kb. imbangan berat.
countess	kb. semacam pangeran wanita.
countless	ks. tak terhitung/terbilang. c. birds fly south burung-burung yang tak terbilang jumlahnya terbang ke arah selatan.
countrified	countrified
country	kb. (j. -ries) 1 negeri, negara. 2 tanah air. -ks. pedalaman, dusun, pedesaan. c. club perkumpulan biasanya diluar kota yang mempunyai gedung pertemuan dan perlengkapan untuk olahraga.
countryman	kb. (j. -men). orang senegeri/sebangsa. he's a c. of mine ia seorang teman senegeri saya.
countryside	kb. daerah pedalaman/daerah luar kota.
countrywide	ks. di seluruh negeri. the president made a c. trip presiden mengadakan perjalanan ke seluruh negeri.
county	kb. (j. -ties) 1 semacam kabupaten, wilayah. tompkins c. daerah (kabupaten) tompkins. 2 daerah. c. government pemerintah daerah.
coup	kb. 1 tindakan tangkas yang tiba-tiba, pukulan mendadak.
coupe	kb. mobil tertutup berpintu dua.
couple	kb. 1 pasangan, suami-isteri. 2 beberapa. -kkt. 1 merangkaikan (two coaches). 2 inf.: kawin. -coupled ks. gandeng, bergandeng(an). -coupling kb. kopeling, kopel, perangkai.
couplet	kb. bait, untai.
coupon	kb. kupon.
courage	kb. keberanian, keteguhan hati. he's a man of great c. ia seorang yang sangat berani.
courageous	ks. berani.
courier	kb. kurir, pesuruh.
course	kb. 1 jalan. 2 (subject) rangkaian pelajaran, matapelajaran. 3 kursus. 4 bagian. -kki. mengalir.
court	kb. 1 pengadilan. 2 halaman yang mengelilingi dinding. 3 lapangan. 4 istana. 5 penerimaan tamu. -kkt. 1 pacaran dengan. 2 menghendaki, mencari (danger).
courteous	ks. sopan (santun).
courtesy	kb. (j. -sies) 1 kesopan-santunan, kesopanan. 2 rasa hormat. 3 kebaikan.
courthouse	kb. gedung pengadilan.
courtier	kb. orang yang termasuk anggota istana.
courtliness	kb. kesopan-santunan, kesopanan.
courtly	ks. bersifat sopan-santun. c. demeanor tingkah laku yang sopan-santun.
courtmartial	kb. mahkamah tentara/militer, pengadilan tentara. -kkt. mengadili dimuka pengadilan tentara. -kkt. mengadili dimuka pengadilan tentara.
courtroom	kb. ruangan pengadilan.
courtship	kb. masa bercumbu-cumbuan/kenal- mengenal.
courtyard	kb. halaman gedung yang dikelilingi tembok.
cousin	kb. (saudara) sepupu. bill and mary are my cousins bill dan mary sepupu saya.
couturier	kb. penjahit pakaian, modiste.
cove	kb. teluk kecil.
covenant	kb. perjanjian. c. of marriage akad nikah.
cover	kb. 1 tutup. 2 penutup. 3 kain penutup. 4 sampul. 5 lindungan. 6 perlindungan. -kkt. 1 menutupi. 2 meliputi, mencakup. 3 menutup. 4 menempuh. 5 melindungi. -covering kb. tutup, penutup. c. letter surat pengantar/penyertai.
coverage	kb. ulasan, cara pemberitaan, pencakupan. news c. ulasan pemberitaan/pers. insurence c. jumlah jaminan asuransi.
coverall	coverall
coverlet	kb. tutup diatas seprai tempat tidur.
covert	ks. tersembunyi, samar. c. acts tindakan-tindakan tersembunyi.
covet	kkt. 1 iri hati. to c. another's possessions iri hati terhadap milik orang lain. 2 mendambakan, merindukan. to c. another's wife mendambakan isteri orang lain.
covetous	ks. 1 bersifat iri hati. she tends to be c. ia cenderung untuk iri hati. 2 tamak.
covey	kb. kawanan. a c. of birds sekawanan burung.
cow	kb. lembu, sapi. -kkt. menakutkan. she was cowed by her husband's threats ia ditakutkan oleh ancaman-ancaman suaminya.
coward	coward
cowardice	kb. perasaan pengecut, kekecutan (hati).
cowardliness	kb. kekecutan hati, sikap pengecut.
cowardly	ks. secara pengecut. he is c. by nature ia sifatnya/bersifat pengecut.
cowboy	kb. koboi, gembala sapi.
cower	kki. gemetar ketakutan. the victim cowered in the corner korban yang malang itu gemetar ketakutan di pojok.
cowhide	kb. kulit sapi.
cowl	kb. topi runcing (pendeta).
cowlick	kb. rambut seperti ijuk.
cowling	kb. pelindung/penutup mesin dari baja.
cowpox	kb. cacar sapi.
coxswain	kb. 1 pengemudi sekoci. 2 kepala kelasi.
coy	ks. pura-pura/sok malu, malu-malu kucing, pemalu. she tends to be c. around men ia kelihatannya pura-pura malu kalau ada laki-laki.
coyote	kb. sejenis anjing hutan.
coziness	kb. kesenangan. the c. of the room kesenangan kamar.
cozy	ks. menyenangkan, senang, enak. this is a c. room ini kamar yang menyenangkan.
cp.	(compare) bgk (bandingkan).
cpd.	(compound) gabungan, senyawa.
cpl.,  cpl.	(corporal) kopral.
crab	kb. 1 kepiting, ketam, yuyu. 2 pengeluh, pengumpat. -kki. (crabbed) 1 inf.: mengeluh, mengumpat. 2 menangkap kepiting kecil. c. grass semacam rumput alang-alang yang merusak halaman.
crack	kb. 1 retak. 2 celah. 3 letusan. -ks. inf.: jagoan. -kkt. 1 sl.: memecahkan. 2 meretakkan (a nut). 3 inf.: memperlihatkan (a smile). 4 sl.: membuka. -cracerked ks. 1 inf.: gila. 2 retak.
cracker	kb. kueh, semacam biskuit yang tidak manis.
crackerjack	kb. semacam jagung rendang yang diberi gula. -ks. sl.: jagoan, ulung. a c. swimmer seorang perenang yang ulung.
crackle	kb. dedas (of a rife). -kki. 1 meretih, gemercik. the fire crackled api meretih. 2 mendedas (of a rife).
crackpot	kb. inf.: seorang aneh/sinting. -ks. inf.: aneh. a. c. suggestion saran yang aneh/gila.
crackup	kk. 1 tabrakan (of a car). 2 kehancuran. inf.: mental c. kehancuran rohani.
cradle	kb. 1 ayunan, buaian. 2 tempat lahir. -kkt. membuai.
craft	kb. 1 keahlian, keprigelan. the writer's c. keahlian mengarang. 2 (boat) kapal (kecil).
craftsman	kb. (j. -men). 1 tukang, ahli, juru. 2 seniman yang mempunyai ketrampilan tehnik.
craftsmanship	kb. keahlian, ketrampilan.
crag	kb. tebing batu yang terjal.
crakiness	kb. sifat lekas tersinggung.
cram	kkt. (crammed) menjejalkan, memasukkan dengan paksa. -kki. inf.: belajar tergesa-gesa, dipompa. c. course kursus kilat.
cramp	kb. kejang, kram. -cramps j. 1 kejang. 2 sl.: datang bulan/haid. 3 ngeri perut. -kkt. mengekang. i feel cramped in this chair saya merasa kaku dalam kursi ini.
cranberry	kb. (j. -ries) semacam berry.
crane	kb. 1 burung bangau. 2 derek. -kkt., kki. mengulurkan (leher).
cranial	ks. yang bertautan dengan tengkorak.
cranium	kb. tengkorak, tempurung kepala.
crank	kb. 1 engkol. 2 inf.: orang yang aneh. -ks. aneh. -kkt., kki. mengengkol (a car).
crankcase	kb. bak/rumah mesin.
crankshaft	kb. poros engkol/ mesin, krukas.
cranky	ks. 1 lekas marah/tersinggung. you're so c. kmu lekas benar marah. 2 ngambek, dongkol, jengkel.
cranny	kb. (j. -nies) sela-sela, celah-celah. we looked in every nook and c. kami telah menyelidiki semua sela dan celah.
crape	kb. kain yang berkerut dari wol, sutera, kain krep dsb.
craphanger	kb. sl.: seorang yang muram. he's a real c. ia betul-betul seorang yang muram.
crash	kb. 1 tubrukan, tabrakan. 2 dentaman (of falling dishes or trees). 3 jaman meleset. -ks. besar-besaran. -kkt. 1 menabrakkan. 2 inf.: masuk tanpa diundang/bayar (a party). -crashing ks. benar-benar, sungguh- sungguh.
crate	kb. 1 peti kayu. 2 sl.: mobil. -kkt. memetikan, mempak(furniture).
crater	kb. kawah (of volcano). 2 lubang (from shelling).
crave	kkt. 1 sangat membutuhkan/mengharapkan. 2 candu akan. -craving kb. idaman. she had c. for pickles during her pregnancy ia mengidam acar selama ia hamil.
craw	kb. tembolok, empedal. inf.: my statement stuck in my c. apa yang saya katakan itu tak sanggup saya ucapkan.
crawfish	kb. = crayfish. -kki. inf.: mundur. we were prepared to carry out the agreement but he crawfished kami siap menjalankan perjanjian itu, tapi ia mundur menarik diri.
crawl	kb. 1 gerak yang pelan sekali. 2 sport : gaya renang bebas. -kki. 1 merangkak. 2 maju dengan pelan-pelan. 3 dijalari. 4 merayap (of insects).
crayfish	kb. udang karang.
crayon	kb. krayon, pensil lilin yang berwarna. -kkt., kki. menggambar dengan krayon.
craze	kb. sifat keranjingan/kegila-gilaan, kegemaran. the twist is the latest c. dansa twis adalah kegemaran terbaru.
crazy	ks. 1 gila, sinting. 2 inf.: gemar benar. 3 sl.: hebat. 4 tergila-gila.
creak	kki. berbunyi k(er)iat-k(er)iut. these steps c. anak tangga ini berbunyi keriat-keriut.
creaky	ks. berbunyi keriat-keriut (of stairs,floor).
cream	kb. 1 kepala susu. 2 yang terbaik. -kkt. 1 mengambil kepala susu dari susu. 2 sl.: menggunduli. -creamed ks. bersaus susu. c. peas kacang polong yang bersaus susu.
creamer	kb. tempat kepala susu.
creamery	kb. (j. -ries) pabrik mentega dan keju.
creamy	ks. berwarna krem.
crease	kb. 1 lipatan (sterika) (in trousers). 2 kusut. -kkt. don't c. my trousers janganlah membuat lipatan di pantalonku.
create	kkt. 1 menciptakan (a new dress). 2 menimbulkan (a problem). 3 membuat. he created a scene ia membuat kehebohan.
creation	kb. 1 ciptaan. 2 dunia.
creative	ks. memiliki daya cipta. he's a c. individual ia seorang manusia yang berdaya cipta.
creativity	kb. daya cipta.
creator	kb. pencipta. he's the c. of the new hair style ia pencipta model rambut gaya baru itu.
creature	kb. 1 makhluk. 2 orang yang patuh.
credence	kb. kepercayaan. i place no c. in his statement saya tak percaya pada ucapannya . letter of c. surat kepercayaan.
credentials	kb., j. 1 surat kepercayaan. 2 (surat) mandat.
credibility	kb. kepercayaan, keadaan dapat dipercaya. we questioned his c. kami sangsikan apakah ia dapat dipercaya.
credible	ks. dapat dipercaya. it doesn't seem c. that he is nineteen hampir tak dapat dipercaya bahwa ia sudah berumur 19 tahun.
credit	kb. 1 piutang, kredit. 2 penghargaan, pujian, kebanggaan. 3 daftar penghargaan. 4 mata ujian. -kkt. 1 memasukkan kedalam daftar penerimaan. 2 percaya.
creditable	ks. yang dapat dipuji. to do a c. job melakukan pekerjaan yang patut dipuji..
creditor	kb. orang yang memberi pinjaman / piutang, kreditor.
credo	kb. kepercayaan/paham.
creed	kb. pernyataan kepercayaan / keyakinan, syahadat, iman.
creek	kb. sungai kecil anak sungai.
creel	kb. kembu, kepis.
creep	kb. sl.: orang yang tidak disukai, penjilat. -creeps j. inf.: yang menggelikan/mengerikan. -(crept) 1 merangkak. 2 bergerak dengan pelan-pelan. 3 timbul pelan-pelan. -creeping ks. maju pelan-pelan.
creeper	kb. orang/barang yang menjalar, virgina c. semacam tumbuhan yang menjalar.
creese	kb. keris.
cremate	kkt. membakar mayat, memperabukan mengabukan, mengkremasi.
cremation	kb. pembakaran mayat.
crematorium	kb. tempat pembakaran mayat.
creole	kb. 1 orang kulit putih keturunan penetap-penetap bangsa perancis di negara bagian louisiana. 2 bahasa perancis di louisiana.
creosote	kb. semacam cairan seperti minyak yang dibuat dari ter kayu.
crepe	kain sutera tipis, katun rayon atau kain wol yang kerisut, kain krep. c. paper kertas kerisut. c. de chine / da'syien/ kain sutera yang tipis.
crept	lih creep.
crescendo	kb., ks. lambat laun menjadi keras.
crescent	kb. sabit. c. moon bulan sabit.
cress	kb. semacam seledri.
crest	kb. 1 kepala. 2 puncak. -kkt. merupakan puncak. -kki. meluap.
crevice	kb. retak, celah.
crew	kb. 1 awak kapal. 2 regu dayung. 3 pekerja-pekerja, pegawai-pegawai. c. cut potongan rambut laki-laki yang pendek sekali.
crewman	kb. (j. -men). anggota awak kapal, awak pesawat, pegawai pada kereta api.
crib	kb. 1 tempat tidur bayi. 2 tempat penyimpanan. -kkt. (cribbed) menjiplak, menyontek. -cribbing kb. penjiplakan.
cribbage	kb. semacam permainan kartu.
cricket	kb. 1 jengkerik. 2 sport : olah raga inggeris yang dimainkan oleh kesebelasan dengan bola dan alat pemukul. inf.: that's not c. itu tidak sportip.
cried	lih cry.
cries	lih cry.
crime	kb. 1 kejahatan. 2 kesalahan, salah. crime-ridden ks. penuh (dengan) kejahatan
criminal	kb. penjahat, narapidana. -ks. 1 kriminal, pidana. c. court pengadilan perkara-perkara pidana. 2 yang bersifat kejahatan, kriminal. c. behavior tingkah laku kriminil.
criminology	kb. kriminologi.
crimp	kb. kerut. inf.: to put a c. in a's style menghambat/ mengganggu seseorang.
crimson	ks. merah tua.
cringe	kki. ngeri. i c. at the thought that he... ngeri aku jika kuingat bahwa ia...
crinkle	kkt. mengerutkan. -kki. berkerut. this paper crinkles when i fold it kertas itu berkerut ketika saya melipatnya.
cripple	kb. 1 (si)pincang. 2 timpang (one leg shorter than the other). -kky. 1 melumpuhkan, membuat pincang. 2 melumpuhkan. a crippling strike pemogokan yang melumpuhkan.
crises	j. lih crisis.
crisis	kb. (j. -ses). 1 masa gawat. 2 saat genting. 3 kemelut, kegentingan, kegawatan.
crisp	kt. 1 garing. 2 segar dan kering. 3 yang kena dan singkat. a c. speech pidato yang kena dan singkat.
crispiness	kb. kegaringan.
crispy	= crisp.
crisscross	ks., kk. berselang-seling, silang, menyilang. -kkt. menjelajahi (daerah).
cristalline	ks. terdiri dari kristal. diamonds and snowflakes are c. intan dan serpih salju terdiri dari kristal.
criteria	j. lih criterion.
criterion	kb. (j. -ria). standar, ukuran, patokan, norma. what c. is being used ? standar apakah yang dipakai.
critic	kb. pengecam, pengeritik, pengupas pembahas.
critical	ks. 1 genting. 2 bersifat selalu mencela. 3 genting, kritis. 4 yang mengupas secara kritis. 5 kekritisan.
criticism	kb. 1 kecaman. the c. has done him good kecaman itu baik baginya. 2 kupasan, keritik. c. of a book kupasan suatu buku.
criticize	kkt. 1 mencela. 2 mengecam, mengupas.
critique	kb. kupasan, tinjauan. he wrote a c. of the dictionary ia menulis suatu kupasan kritis tentang kamus itu.
croak	kb. 1 bunyi kuak (of a frog). 2 gaok. (of a crow or raven) -kki. 1 berkuak-kuak. 2 menggaok. 3 berteriak dengan suara parau. 4 sl.: mati. he finally croaked ia akhirnya mati.
crochet	kki. mengait. c. needle jarum kait.
crock	kb. wadah, tempayan, periuk dari tembikar/tanah.
crockery	kb. barang-barang tembikar.
crocodile	kb. buaya. c. tears airmata buaya, kesedihan yang dibuat-buat. to weep c. tears pura-pura sedih.
crocus	kb. semacam bunga yang putih, kuning atau ungu dan yang berdaun seperti rumput.
crony	kb. (j. -nies) teman/sahabat karib.
crook	kb. 1 inf.: bajingan. 2 lekuk. c. of the elbow lekuk siku. -kkt. melengkungkan (a finger around s.t).
crooked	ks. 1 bengkok, tidak lurus, berliku-liku. this road is very c. jalan ini sangat berliku-liku. 2 tidak jujur. he's a c. dealer ia seorang pedagang yang tidak jujur.
croon	kkt., kki. menyanyi (dengan suara rendah dan merayu).
crooner	kb. penyanyi lagu-lagu hiburan.
crop	kb. hasil, panen. 2 tembolok (of a bird). 3 kumpulan. -kkt. (cropped) 1 memotong pendek. 2 menggigit menjadi pendek.
cropper	kb. keruntuhan, kehancuran, kegagalan. inf.: to come a c. menghadapi kesukaran, menemui nasib buruk.
croquet	kb. olahraga yang mendorong-dorong bola dari kayu di lapangan hijau kedalam gawang.
croquette	kb. kroket.
cross	kb. 1 rel, : kayu salib. 2 palang. 3 campuran, persilangan. 4 beban.-ks.1 marah, jengkel -kkt.1 menyebrang 2 menyebrangi, melintasi. 3 melintasi. 4 merintangi. 5 bersilang. 6 menarik garis melintang. 7 mengawinkan, menyilangkan. 8 membuat tanda salib.
crossbones	kb., j. tulang bersilang. skull and c. tengkorak dan tulang bersilang (tanda bahaya pada botol-botol yang mengandung obat beracun dsb).
crossbreed	kb. keturunan campuran, peranakan, bastar, hibrida.
crosscut	lih saw.
crosshantching	kb. penggarisan silang.
crossover	kb. penyebrangan jalan.
crossroad	kb. persimpangan (jalan). we are at the crossroads kami harus memilih. kami harus menentukan pilihan.
crosstie	kb. besi bersilang, balok melintang, alas rel.
crossways	kk. = crosswise.
crosswise	kk. dengan bersilang, potong - memotong.
crossword	c. puzzle teka-teki silang. to do/work c. puzzles mengisi teka-teki silang.
crotch	kb. sela pukang, kangkang, kelangkang.
crouch	kb. to be in a c. ready to leap membungkukkan badannya siap untuk melompat. -kki. 1 meringkukkan/merundukkan badan. 2 meringkuk. 3 berdekam, mendekam. (of a cat).
croup	kb. penyakit batuk yang disertai dengan sesak napas.
croupier	kb. bandar.
crouton	kb. roti garing dalam potongan kecil-kecil (biasanya dimasukkan dalam sup).
crow	kb. 1 (bird) burung gagak. 2 kokok ayam jantan. -kki. 1 berkokok. 2 bangga. crow-foot (j. -feet). kerisut di pojok luar mata. crow's-nest mercu tiang, menara pengintai.
crowbar	kb. perejang, perunjang, linggis.
crowd	kb. orang banyak/ramai. 2 banyak penonton. 3 pergaulan, kelompok. -kkt. mendesak. -kki. 1 berdesak - desak. 2 berkerumun. -crowded ks. penuh , sesak, ramai.
crown	kb. 1 mahkota. 2 kejuaraan. 3 puncak. 4 kepala gigi. -kkt. 1 menobatkan. 2 mengurniai. 3 inf.: memukul pada kepala.
crucial	ks. penting sekali, kritis, gawat. the result of the examination are c. hasil-hasil ujian itu menentukan.
crucible	kb. 1 wadah tempat melebur logam. 2 (test) ujian, percobaan.
crucifix	kb. salib/silang dengan patung kristus.
crucifixion	kb. penyaliban.
crucify	kkt. (crucified) menyalibkan.
crude	ks. 1 kasar. 2 mentah. 3 sederhana, bersahaja. 4 kira-kira.
crudeness	kb. kekasaran, kementahan.
crudity	kb. (j. -ties) kekasaran. the play was filled with crudities sandiwara itu penuh dengan kekasaran - kekasaran.
cruel	ks. kejam, bengis, lalim. he is c. to his dog ia kejam terhadap anjingnya.
cruelty	kb. (j. -ties) kekejaman, kebengisan.
cruise	kb. 1 pelayaran. 2 pesiar. -kki. 1 menjelajah. 2 meluncur. -cruising ks. yang berhubungan engan penerbangan pada kecepatan menjelajah.
cruiser	kb. 1 kapal penjelajah/pesiar. 2 mobil polisi.
crumb	kb. 1 remah-remah, repih-repih (on a table). 2 sl.: sampah masyarakat. he's a c. ia sampah masyarakat.
crumble	kkt. meremukkan. -kki. 1 ambruk. 2 remuk. 3 menjadi hancur, pecah bercerai. the cookie crumbled easily kue itu dengan mudah hancur.
crumbly	ks. rapuh, mudah hancur. the cake was quite c. kue tartnya rapuh benar.
crummy	ks. sl.: tak memuaskan/bagus. the movie was c. filem itu tidak memuaskan. i got a c. deal saya mendapat perlakuan yang tidak bagus.
crumple	kkt. menggumalkan, mengisutkan, menggumpalkan. -kki. rebah, rubuh. -crumpled ks. kusut, kerisut. he wore an old, c. hat ia memakai topi tua yang kusut.
crunch	kb. sl.: kegentingan. kkt. mengerkah. -kki. berjalan dengan menimbulkan bunyi berderak (through the snow).
crunchy	ks. inf.: garing. c. candy gula-gula yang garing.
crusade	crusade
crusader	kb. 1 seorang yang ikut serta dalam perang salib. 2 seseorang yang mengusahakan sesuatu perbaikan dengan giat.
crush	crush
crusher	kb. penghancur.
crust	kb. 1 kulit (yang garing), kerak. 2 lapisan kulit. 3 sl.: kekurang ajaran, tidak tahu menahu. -kki. mengeras, menjadi keras permukaannya.
crustacean	kb. semacam binatang air yang berkulit keras, seperti udang, kepiting dsb, binatang berkulit keras.
crusty	ks. 1 berkulit keras. c. bread roti yang berkulit keras. 2 tidak ramah - tamah. he's a c. old man ia seorang kakek yang tidak ramah-tamah.
crutch	kb. tongkat ketiak. 2 penolong. 3 penyokong, penopang.
crux	kb. hal yang terpenting, pokok inti soal. that's of the matter itulah hal yang pokok dari persoalan itu.
cry	kb. 1 teriakan. 2 jeritan, pekik. 3 raungan (of a wolf). 4 tangisan. -kki. (cried) 1 menangis. 2 berteriak.
crybaby	kb. (j. -bies) cengeng.
crypt	kb. ruangan dibawah tanah.
cryptanalysis	kb. pemecahan/pembacaan tulisan-tulisan rahasia.
cryptic	ks. 1 samar, tidak jelas. c. statement ucapan yang samar. 2 tidak terang. c. message pesan yang maksudnya tidak terang, pesan yang mempunyai arti tersembunyi.
cryptography	kb. ilmu pembacaan sandi, tulisan-tulisan atau angka-angka rahasia.
cryptorgram	kb. tulisan rahasia. tulisan dalam kode.
crystal	kb. 1 hablur, kristal. 2 kaca. 3 butir, hablur, kristal. 4 piring dan gelas. cristal-clear ks. 1 bening jelas. 2 jelas/terang sekali. c. gazing meramalkan masa depan dengan memandang kedalam bola kristal, mereka-reka masa depan.
crystallization	kb. 1 penghabluran, kristalisasi. 2 perwujudan (of an idea).
crystallize	kkt. 1 menghablur(kan). 2 direalisasikan.3 menjadi kenyataan, memperoleh bentuk yang jelas.
ct.	1 (count) pangeran. 2 (connecticut) negara bagian as.
ctr.	(center) pusat.
cu.	(cubic) kubik.
cub	kb. 1 anak. bear c. anak beruang. 2 muda, baru. c. reporter wartawan baru. c. scout kurcaci, pandu remaja, pemula.
cubbyhole	kb. 1 ruangan kecil/sempit. 2 kamar sempit.
cube	kb. 1 kubus. 2 pangkat tiga. -kkt. 1 memotong-motong dalam bentuk kubus. 2 memangkatkan tiga. c. root akar pangkat tiga.
cubeb	kb. kemukus, lada berekor.
cubic	ks. kibik, kubik. c. measure susunan ukuran kubik. c. meter meter kubik.
cubicle	kb. kamar/ruangan kecil.
cuckold	kb. suami yang isterinya tidak setia.
cuckoo	kb. semacam burung tekukur, burung elang malam. -ks. sl.: gila, tolol. you're c. if you believe that kamu gila kalau percaya itu.
cucumber	kb. ketimun. cool as a c. a) tenang dan tidak tergopoh-gopoh. during the fighting he was cool as a c. selama pertempuran itu ia tenang saja. b) sejuk.
cud	kb. kunyahan, (rumput) mamahan.
cuddle	kkt. mengemong. amother cuddled her baby seorang ibu mengemong anaknya. to c. together berbaring berdekatan. to c. up 1 duduk berdekatan. 2 tidur melekuk.
cuddlesome	ks. suka diemong/disayangi, menyenangkan untuk dipangku dan dipeluk. the kitten is very c. anak kucing itu menyenangkan untuk dipangku dan dipeluk.
cuddly	ks. menyenangkan untuk disayangi / diemong. c. pup anak anjing yang menyenangkan untuk disayangi.
cudgel	kb. gada, pentung. -kkt. mementung dengan gada.
cue	kb. 1 isyarat. 2 sport : kiu, tongkat bilyar. -kkt. inf.: perkenalkan.
cuff	kb. manset. c. button/link kancing manset. off the c. tanpa persiapan. on the c. memasukkan dalam bon/sebagai hutang.
cuisine	kb. masakan, santapan. chinese c. masakan tionghoa. french c. santapan perancis.
culinary	ks. yang berhubungan dengan dapur atau masakan. he is skilled in the c. art ia pandai memasak.
cull	kb. sisihan. -kkt. 1 memisahkan, menyisihkan. 2 memilih. to c. out the significant data memilih kenyataan-kenyataan yang penting.
culminate	kki. mencapai puncak, memuncak.
culmination	kb. puncak. the c. of o's ambitions puncak cita-cita hidup seseorang.
culpable	ks. bersalah, patut dicela. he was judged c. of the deed ia dinyatakan bersalah dalam perkara itu.
culprit	kb. orang yang telah melakukan kejahatan.
cult	kb. cara memuja.
cultivate	kkt. 1 mengolah, menanami, mengusahakan. 2 mempererat, memperkuat. -cultivated ks. 1 sopan, terlatih. 2 tajam, terlatih. 3 yang diolah dan ditanami.
cultivation	kb. 1 pengolahan, pencangkulan, pengusahaan, penanaman. 2 perkembangan, pengembangan, perkuatan, pereratan.
cultivator	kb. 1 petani, penanam,peladang, pengusaha tanaman. 2 (machine) mesin pengolah tanah, mesin penyiang.
cultural	ks. kebudayaan. -culturally kk. dengan adat istiadat, yang berhubungan dengan kebudayaan.
culture	kb. 1 kesopanan, kebudayaan. 2 pemeliharaan. 3 biol.: biakan. -cultured ks. 1 terpelajar. 2 piaraan.
culvert	kb. urung-urung.
cumbersome	ks. tidak praktis, susah untuk dipakai. he was wearing a c. outfit ia mengenakan pakaian yang tidak praktis.
cumulative	ks. 1 kumulatif. 2 bertimbun, bertumpuk. the . effect of overwork can be dangerous akibat yang bertimbun dari terlalu banyak bekerja dapat membahayakan.
cumulus	kb. kumulus. c. cloud awan kumulus/kemawan.
cuneiform	kb. tulisan-tulisan kuno berbentuk baji.
cunning	kb. 1 kelicikan. 2 kecerdikan. -ks. pintar, cerdik, licik, trampil. c. fox rubah yang licik.
cup	kb. 1 cangkir, mangkok. 2 piala. -kkt. (cupped) 1 melikukkan. 2 menutupkan. 3 melengkungkan.
cupboard	kb. lemari (untuk makanan).
cupcake	kb. kue yang dimasak didalam cetakan kue berbentuk mangkok.
cupful	kb. secangkir, semangkok. three cupfuls of milk tuangkanlah tiga mangkok susu.
cupid	kb. dewa/dewi asmara.
cupidity	kb. keinginan besar (untuk memiliki sesuatu., nafsu besar untuk mempunyai).
cupola	kb. kubah, kupel, atap lengkung.
cur	kb. 1 (dog) anjing kampung/bastar. 2 bajingan, orang jahat.
curative	ks. yang menyembuhkan. this herb possesses c. powers daun-daunan ini mengandung daya menyembuhkan.
curator	kb. kurator, kepala (of museum).
curb	kb. pinggiran jalan. -kkt. mengekang. c. your tongue kekanglah lidahmu.
curbstone	kb. batu pinggiran jalan.
curd	kb. dadih.
curdle	kkt. membekukan. -kki. mengentalkan, menjadi dadih. the milk was old and finally curdled susu itu sudah lama dan akhirnya mengental.
cure	kb. 1 obat. 2 perawatan, pengobatan. -kkt. 1 menyembuhkan penyakitnya. 2 mengawetkan, mengasapi. 3 menghilangkan. cure-all kb. obat manjur untuk segala penyakit. cured ham daging ham yang sudah diasini dan diasapi.
curfew	kb. jam malam.
curio	kb. barang ajaib/suvenir.
curiosity	kb. (j. -ties) 1 keinginantahu. 2 barang aneh.
curious	ks. 1 ingin tahu, melit. 2 aneh. 3 heran, aneh.
curl	kb. 1 keriting. 2 lingkaran. -kkt. 1 mengeritingkan (the hair). 2 mencibirkan, memonyongkan (the lips). -kki. 1 melengkung, menggulung. 2 melengkung. curling iron(s) alat pengeriting rambut.
curler	kb. alat pengeriting.
curlicue	kb. lengkungan pada tulisan sebagai perhiasan.
curly	ks. keriting, berombak. he has c. hair ia berambut keriting.
currant	kb. kismis.
currency	kb. (j. -cies) 1 mata uang. 2 peredaran.
current	kb. arus. -ks. 1 (zaman) sekarang , mutakhir. a) elec.: alat/neraca pengukur arus listrik. b) fin.: jumlah uang yang ada di bank sekarang. 2 (sekarang) ini. the bill for the c. month rekening untuk bulan ini. 3 sedang beredar.
curriculum	kb. rencana pelajaran, kurikulum. c. vitae riwayat hidup.
curry	kb. (j. -ries) kari. c. powder bumbu kari. -kkt. (curried) 1 membuat masakan kari. 2 menyikat. 3 menjilat. -curried ks. dibumbui dengan kari. c. rice nasi kari.
curse	kb. kutukan, seranah, sumpah. -kkt. 1 mengutuk. 2 memaki -kki. mengutuk, memaki. -cursing kb. kutukan, kutuk-mengutuk. makian.
cursive	ks. kursif. c. writing tulisan kursif.
cursorily	kk. lih cursory.
cursory	ks. sambil/sepintas lalu. the police made a c. search polisi mengadakan penyelidikan sambil lalu. -cursorily kk. dengan sambil lalu.
curt	ks. 1 kaku, kasar. 2 pendek. his remaks were c. ucapan - ucapannya pendek.
curtail	kkt. membatasi, mengurangi. after his escape his activities were curtiled sesudah pelariannya itu kegiatannya dibatasi.
curtailment	kb. pembatasan, pengurangan.
curtain	kb. 1 korden, gorden, tirai. 2 lindungan tirai. -kkt. menabiri, menggantungkan gorden (a room, windows).
curtsy	kb. (j. -sies) cara wanita menghormat dengan membungkukkan badan. -kki. (curtsied) menghormat dengan membungkukkan badan.
curvaceous	ks. montok. she's quite c. badannya montok sekali.
curvature	kb. 1 lekukan, pembungkukan. 2 lengkungan.
curve	kb. 1 tikungan, liku. 2 garis. -kkt. membelokkan. -kki. membelok.
cushion	kb. bantal, kasur kecil,alas duduk. -kkt. 1 melindungi dengan bantalan. 2 melengkapi dengan bantalan.
cushy	ks. sl.: enak, mudah, senang. he has a c. job pekerjaannya enak.
cuspid	kb. gigi taring.
cuspidar	kb. tempat (me)ludah.
cuss	kb. inf.: 1 kutukan, serapah. 2 bung, bang. lih curse. -kkt. i nf.: menyumpahi, mengutuk. -cussed ks. inf.: keras kepala.
cussedness	kb. inf.: sifat keras kepala.
custard	kb. semacam podeng, terbuat dari telur, gula, susu dsb. chocolate c. podeng coklat.
custodian	kb. penjaga, pemelihara, petugas.
custody	kb. (j.-dies) 1 tahanan, penjagaan.. the police took him into c. polisi menahan dia. 2 pemeliharaan, penjagaan. the mother was given c. of the children ibu itu diserahi pemeliharaan anak-anaknya.
custom	kb. 1 adat. 2 kebiasaan. 3 adat-istiadat. custom-built ks. dibuat menurut pesanan. -customs j. 1 bea, cukai. 2 pabean, duane.
customary	ks. biasa. c. law hukum adat. -customarily kk. biasanya. c. i don't drive to the office biasanya, saya tak naik mobil ke kantor.
