penambalan	act of patching.
penambang	1. miner. 2. 1) ferryman. 2) ferry. 3) s.o. engaging in transporting a small number of passengers (taxi drivers, pedicab drivers, etc.).
penambangan	1. the activity of mining. 2. ferrying, transport.
penambat	s.t. to tie with.
penambatan	act of tethering or mooring.
penambul	threatrical performer, artiste.
penampakan	appearance.
penampan	penampan
penampang	1 diameter or longitudinal plane through the center. 2 longitudinal section.
penampangan	profile.
penampar	s.t. or s.o. that slaps.
penamparan	action of slapping.
penampi	winnowing basket.
penampikan	act of refusing or rejecting.
penampilan	1 presentation. 2 making o.'s appearance.
penampung	1. cross-section. 2. s.t. or s.o. who intercepts.
penampungan	1 collecting and saving water, etc. 2 place that receives. 3 act of receiving or accommodating.
penanakan	s.t. to boil rice in.
penanam	planter.
penanaman	1 planting. 2 (fin.) investment.
penanda	1 s.t. used as a sign. 2 (ling.) marker.
penandaan	1 signaling, giving a sign, designating. 2 (ling.) markedness.
penandak	female dancer in this dance.
penandasan	emphasizing.
penandatangan	the signer, signatory.
penandatanganan	the signing.
penanganan	handling.
penangas	steam bath.
penangasan	steaming.
penanggalan	1. 1) stripping, removal (of a cover, etc.). 2) (lit.) k.o. ghost whose head separates and flies independently. 2. 1) calendar, almanac. 2) dating.
penangguhan	postponement, deferment.
penangguk	1 fisherman who uses such a device. 2 o. who takes unfair advantage.
penanggul	o. who tackles a problem, etc.
penanggulangan	tackling.
penanggung	1 guarantor, backer. 2 sufferer. 3 o. who is insured.
penanggungan	1 trials and tribulationas. 2 assumption of responsibility.
penangis	a crybaby.
penangkal	1 amulet, charm. 2 preventive.
penangkalan	preventive measure, esp. refusal of entry to a country to a potentially dangerous foreigner.
penangkap	captor, capturer, s.t. that catches.
penangkapan	1 catching. 2 arrest, seizure. 3 haul, catch (fish).
penangkis	s.t. which ward off.
penangkisan	1 repelling. 2 fending off (blows, etc.).
penangsel	s.t. used to fill s.t. up.
penanjakan	ascending, climbing.
penantang	challenger.
penantangan	act of challenging..
penantian	1 (process of) waiting. 2 waiting room.
penanya	interrogator, questioner.
penapaian	fermentation.
penapis	a filter, sieve.
penapisan	filtering.
penarahan	a plane.
penari	dancer.
penarik	1 s.o. or s.t. that pulls, extracts, drags, etc. 2 s.t. interesting.
penarikan	1 drawing, pulling. penarikan-picu pulling of a trigger. 2 collection, drawing in. penarikan-pajak taxation. penarikan-diri withdrawal from an activity.
penaruh	s.o. who places s.t.
penaruhan	money box, strongbox.
penarung	obstacle.
penasak	styptic pencil.
penasaran	1 angered (but suppressed), embitered. 2 be anxious to do or find out s.t.
penat	tired, weary, exhausted.
penata	s.t. or s.o. that puts s.t. in order.
penataan	ordering, structuring.
penatahan	carving, inlaying s.t.
penatapan	gazing, staring.
penatar	trainer, upgrader.
penataran	1 upgrading. 2 refresher course.
penatu	laundryman.
penatua	church elder.
penautan	act of linking up.
penawan	o. who arrests or subdues.
penawanan	captivation.
penawar	1. 1) magic or charm to remove effects of black magic. 2) antidote, disinfectant. 3) neutralizer. 2. bidder, bargainer.
penawaran	1. 1) cure. 2) treatment of magic by incantation, etc. 3) neutralization. 2. 1) offer, bid, deal. 2) bargaining.
penayub	the dancer.
penc-	see also entries with c-.
penca	[penderita cacat] disabled person.
pencak	1. system of self-defense. 2. m-(p)encak-mencak jump up and down in a tantrum.
pencaka	see pancaka.
pencangkul	o. who hoes.
pencangkulan	hoeing.
pencar	disperse.
pencaran	1distribution made. 2 dispersion.
penceng	skew.
pencet	crushed, smashed.
pencil	1 isolated, secluded. 2 desolate, remote.
pencoleng	see pancoleng.
pencong	slanted, skewed. pencong-mencong crisscross.
pencurian	1 robbing. 2 looting.
pencut	(java) fall in love, be attracted to.
pend-	see also entries with d-.
penda	mem-penda correct s.t.
pendahuluan	preface, introduction.
pendakian	1 pass, defile. 2 path or steps up which o. climbs. 3 climbing.
pendam	bury, hide away.
pendamen	see fondamen.
pendapa	see pendopo.
pendar	phosphorescent. /pe`ndar/ turn, go around.
pendaringan	(java, jakarta) place to store rice.
pendega	see pandega.
pendek	short.
pendekar	see dekar. 1 master of swordmanship or martial arts 2 champion .
pendengar	1 listener, audience. 2 (sense of) hearing. 3 telephone receiver.
pendepokan	camp, dormitory.
pendet	balinese dance of welcome.
pendeta	1 protestant clergyman, hindu or budhist priest. 2 (lit.) pundit, scholar.
pending	ornate belt buckle.
pendirian	1 building, founding. 2 stand(point), convictions. 3 (mil.) installation.
pendita	see pendeta.
pendopo	large open structure in front of java mansion, or attached open veranda that serves as an audience hall.
penduduk	inhabitant.
penebah	(rug) beater.
penebak	guesser.
penebalan	process of thickening.
penebang	o. who fells trees.
penebangan	felling of trees.
penebar	(phys.) s.t. that disperses.
penebaran	1 spread, spreading. 2 (phys.) dispersion.
penebas	1 middleman who buys crops still standing in the field and who employs his own labor. 2 wholesale buyer of a product.
penebatan	damming up of s.t.
penebus	1 ransom. 2 o. who pays a ransom of makes compensation.
penebusan	1 redemption. 2 compensation.
peneduh	s.t. that shades or shelters.
peneduhan	providing shade or shelter.
penegahan	prohibition.
penegak	upholder.
penegakan	maintenance.
penegalan	cultivation without irrigation.
penegasan	confirmation.
peneguhan	1 confirmation. 2 the act of strengthening.
penegur	o. who addresses a meeting.
penekan	s.t. or s.o. that stresses or emphasizes.
penekanan	1 pressing, pressuring. 2 stressing, emphasizing.
penekun	s.o. who is diligent about s.t.
penekunan	acting diligent about s.t.
penelaah	researcher.
penelaahan	research.
penelah	prophesier, forecaster.
penelahan	prophecy, prediction.
penelanan	swallowing.
penelanjangan	stripping, denudation.
penelepon	caller.
peneliti	researcher.
penelitian	1 thorough, detailed examination. 2 research.
peneluran	egg laying, egg production.
penelusur	o. who traces paths.
penelusuran	investigation.
penembak	rifleman, marksman.
penembakan	1 bombardment, shooting. 2 firing (of a missile).
penembang	singer with gamelan orchestra.
penembusan	penetration.
penempa	smith.
penempaan	forging. penempaan-mental forging of the intelect.
penempatan	1 appointment, placement 2 stand, place to set s.t. 3 occupying, settling. 4 placing.
penempel	instrument or person that sticks s.t. up.
penempelan	attachment, sticking.
penempuh	o. who attack, assumes some difficult task, or goes a certain distance.
penempuhan	the traveling of a certain distance, the undertaking of a difficult task.
penempur	assailant.
penemu	discoverer.
penemuan	1 invention, innovation. 2 discovery.
penenang	s.o. or s.t. that soothes and calms. penenang-saraf sedative.
penendang	s.t. to kick with.
peneng	peneng
penengah	1 mediator, arbiter. 2 o. with neutral attitude. 3 s.t. used to separate two sections.
penenggala	plowman.
penenggelaman	sinking, torpedoing..
penengok	1 visitor. 2 observer.
penentang	the opposition, opponent.
penentangan	1 resistance. 2 opposition, conflicting.
penenteram	s.t. that soothes.
penentu	1 o. who determines s.t. 2 s.t. determining.
penentuan	act of determining s.t.
penenun	weaver.
penenung	fortune-teller.
penepatan	adjustment, correction.
penepisan	(act of) warding off.
penera	inspector of weights and measures.
peneraan	calibration.
penerang	o. who explains.
penerangan	1 providing information. 2 explanation, clarification. 3 illumination, lighting.
penerap	o. who applies s.t.
penerapan	1 assembling. 2 application.
penerbang	flyer, aviator.
penerbangan	(av.) flight.
penerbit	publisher.
penerbitan	1 publication. 2 publishing house. 3 edition, issue.
penerima	1 receiver. 2 (coll.) resigned, acquiescent.
penerimaan	1 acceptance. 2 revenue. 3 reception. 4 receipt.
penerjangan	act of lunging.
penerjun	jumper.
penerjunan	jumping
penerka	o. who guesses.
penerkaan	guess, conjecture, supposition.
penerobos	1 piercer. 2 burglar. 3 o. who cuts into a line or breaks a regulation.
penerobosan	1 a break-in, burglary. 2 breakthrough, act of penetration.
peneror	terrorist.
penertib	s.o. who keeps order.
penertiban	control, curb.
penerus	s.o. or s.t. that continues s.t.
penerusan	1 continuation, sequel, resumption. 2 continuity.
penetak	o. who chops or hacks.
penetakan	hacking.
penetalan	making s.t. compact.
penetapan	1 determining, decision, decree. 2 fulfillment.
penetasan	hatching.
penetes	dropper.
penetesan	sprinkling, dispensing drop by drop.
penetrasi	penetration.
peng-	see also entries with k-, ng-, or beginning with a vowel.
pengabadian	perpetuation.
pengabai	1 careless or neglectful person. 2 nonchalant or indifferent person.
pengabaian	1 carelessness, indifference. 2 neglect. 3 disobedience.
pengabaran	1 spreading the news. 2 evangelism.
pengabdi	official.
pengabdian	1 service. 2 subservience, submission. 3 servitude. 4 devotion, dedication.
pengabenan	cremation.
pengabjadan	alphabetization.
pengabsahan	1 endorsement, approval. 2 legalization.
pengacakan	1 randomization. 2 messing up, beating.
pengacara	1 lawyer, attorney. 2 master of ceremonies.
pengacau	agitator, disturber of the peace.
pengacauan	commotion, disturbance, stir.
pengadaan	1 stock. 2 supplying, provisioning. 3 provisions. 4 procurement.
pengadilan	1 the court. 2 trial, session. 3 courthouse. 4 jurisdiction.
pengadu	informer.
pengaduan	1 accusation, complaint. 2 denunciation, information (against). 3 indictment.
pengaduk	stirring spoon or rod.
pengadukan	mixing, stirring (of).
pengagungan	1 exalting (of). 2 glorification.
pengairan	irrigation, watering.
pengajak	inducement.
pengajar	instructor, teacher.
pengajaran	1 instruction. 2 doctrine. 3 teaching (of). 4 warning, reminder, admonition.
pengajuan	submission, offer, tender.
pengaktifan	activation.
pengakuan	1 confession (of faith). 2 acknowledgment. 3 avowal. 4 admission (of guilt).
pengakuran	harmonization.
pengalaman	experience.
pengalap	abductor.
pengalapan	abduction.
pengalas	base.
pengalihan	transfer of s.t.
pengaliran	1 flow (of money). 2 trend, drift.
pengamalan	1 doing of good deeds. 2 sincerity in doing s.t. 3 implementing of.
pengaman	1 safeguard. 2 pacifier, peacemaker, conciliator.
pengamanan	1 (mil.) pacification. 2 efforts to achieve security.
pengamat	observer.
pengamatan	1 supervision. 2 monitoring, tracking. 3 observation.
pengambil	taker.
pengambilan	1 removal, withdrawal. 2 interpretation, understanding.
pengamen	singing beggar.
pengampun	forgiver.
pengampunan	1 amnesty. 2 mercy.
pengamuk	o. who runs amuck.
penganalisa	analyst.
penganalisaan	analyzing, examining.
penganan	snacks.
pengancaman	posing a threat.
pengandaian	supposition, assumption.
penganggaran	budgeting.
penganggrekan	orchid growing.
penganggur	unemployed person.
pengangguran	unemployment, joblessness.
pengangkat	1 support. 2 instrument for lifting. 3 lifter, o. who lifts.
pengangkatan	1 appointment. 2 adoption (of child). 3 elevation.
pengangkut	1 transport, carrier. 2 transporter, truck, van.
pengangkutan	transportation, transport.
pengangonan	pasture.
pengangsuran	1 process of paying installments. 2 process of moving gradually.
pengangut	indolent person.
penganiaya	tyrant, maltreater.
penganiayaan	1 mistreatment, cruel treatment. 2 oppression, tyrannical treatment. 3 battering.
pengantar	1 companion, escort. 2 o. who delivers. 3 porter. 4 bellboy. 5 (elec.) conductor. 6 introduction.
pengantara	1 intermediary, mediator, go-between. 2 agent. 3 agency, expediter.
pengantaraan	intercession, mediation.
penganten	/pengantin/ bride (and) bridegroom.
penganugerahan	bestowal, conferral, presentation.
penganut	1 follower, adherent. 2 o. who goes along with others without sticking up for o.'s own ideas.
penganutan	taking up (a religion, political philosophy, etc.).
penganyaman	plaiting.
pengap	close, stuffy, stale, musty.
pengapa	see mengapa.
pengapit	1 clamp. 2 paperclip. 3 flanker. 4 maid of honor or best man at wedding.
pengapkiran	condemnation (of house, building etc.).
pengapung	1 buoy. 2 float, raft.
pengapungan	floating (of a boat, etc.).
pengar	have a hangover.
pengarah	1 (thea.) manager, director. 2 o. who sets the direction.
pengarahan	1 briefing. 2 direction, instruction, guidelines.
pengarak	o. who participates in a procession, parader.
pengarakan	1. arrack distillery. 2. procession.
pengarang	1 author, writer, composer. 2 arranger.
pengaron	(java) large earthenware pot for cooking rice, etc.
pengarsipan	filing, system for keeping archives.
pengartian	1 understanding. 2 meaning, sense.
pengaruh	influence. pengaruh-sampingan side-effect.
pengasah	1 sharpener. 2 grinder. 3 whetstone.
pengasahan	1 honing. 2 sharpening, grinding, scraping.
pengasuh	1 nurse,nursemaid 2 guardian , caretaker .
pengat	1 fish or meat stewed in spicy sauce. 2 a porridge of tuber, squash, or bananas in coconut milk.
pengeboman	see bom 1.
pengecap	1 sense of taste. 2 taster, user.
pengecatan	see cat1.
pengecoran	see cor.
pengecut	coward.
pengedokan	see dok 1.
pengejaran	pursuing of.
pengelola	1 manager, organizer. 2 executive (power). 3 organizer.
pengeluaran	1 disimissal, expulsion. 2 release (of a new movie), edition. 3 expending of. 4 export. 5 excretion.
pengembalian	1 return (of s.t.). 2 restitusion. 3 reversion .
pengembungan	inflation (of tire, balloon, etc.).
pengemudi	1 helmsman, driver, pilot. 2 director.
pengemukaan	presentation, putting forward of s.t.
pengen	(coll., jakarta) want s.t.
pengendali	1leader, o. who holds the reins. 2 manage
pengendalian	1.restraint , curb 2.control.
pengendara	1 driver, rider. 2 horseman.
pengeng	migraine headache.
pengenyahan	1 fleeing. 2 expulsion. 3 abolition.
pengepakan	1. packaging up. 2. leasing.
pengepung	besieger.
pengerah	o. who mobilizes, recruits, or drafts.
pengerahan	conscription.
pengeretan	1 puller, dragger. 2 (jakarta) o. who is clever at winning another's favor for personal gain.
pengerjaan	1 execution, working on s.t. 2 processing, working.
pengertian	1 understanding, way s.o. understands s.t. 2 explanation, interpretation.
pengestu	see pangestu.
pengesyahan	1 ratification, confirmation. 2 legalization, authorization.
pengetahuan	1 knowledge. 2 skill, ability.
pengetrapan	see terap 2.
penggal	1 piece, lump. 2 fragment.
penggalang	1 o. who provides leadership. 2 a boy or girl scout on the 2d level (age 12-15).
penggandaan	1) multiple, double. 2) reduplication. 3) (tel.) multiplexing.
penggarapan	the process of making.
penggaris	ruler.
penggawa	see punggawa.
penggedoran	1 looting, plundering. 2 burglary.
penggelapan	1 blackout (as a precaution). 2 darkening. 3 embezzling. 4 tampering with legal papers, coverup.
penggemar	devotee, lover, fan.
penggertak	1 s.o. who snarls 2 intimidator,threat eaning person.
penggiliran	rotating s.t.
penggodog,godokan	1 cook by boiling (e.g.poach egg, boil stew, etc.0. 2 train intensively. 3 discuss, debate, thing over deeply.
penggorengan	1 wok. 2 process of preparing food in a wok or skillet.
penggubah	1) arranger. 2) composer. 3) author.
penggugat	plaintiff, litigant.
pengguguran	1 abortion. 2 discharging (of athletes, students, etc.).
penggulingan	overthrow, deposer.
penggumpalan	1 clotting. 2 (ling.) agglutination. 3 (phys.) agglomeration.
penggunaan	employing, using, utilizing.
penggundulan	1 shaving s,o, bald. 2 denudation (of land, etc.).
pengguratan	inscribing, relief-making.
penggurdian	drilling, boring.
penghabisan	run out of, no more left.
penghalauan	1 driving, chase, expelling. 2 herding.
penghancur	destroying force or agent.
penghancuran	1 smashing. crushing of. 2 annihilation, total destruction.. 3 dissolving of, disintegration.
penghapusan	1 wiping out, erasing. 2 abolition.
penghargaan	appreciation, respect. 2 valuation.
penghasut	agitator, provocateur.
penghayatan	full and total comprehension.
penghentian	bring to a halt, ceasing.
penghianat	traitor.
penghianatan	comming of treason.
penghijauan	1 greening of s.t. 2 planting, us. on implanted land. 3 reforesting, reforestation.
penghilng	1 removal. 2 eradication, elimination.
penghinaan	degradation, causing humiliation.
penghindaran	1 avoidance, prevention. 2 evasion (of taxes, etc.).
penghubung	s.o. or s.t. which connects.
penghulu	1 village chief. 2 muslim leader.
penghuni	1 occupant, inhabitant, dweller. 2 denizen, inmate. 3 guardian spirit.
penghutang	debtor.
pengimaman	leading prayer service .
pengin	see kepingin.
penginapan	1 lodging for the night. 2 inn.
penginderiaan	sensation.
penginjakan	treading , trampling.
pengintai	look out, observer, scout.
pengintaian	1 observation, reconnaissance. 2 espionage.
pengirim	1.sender 2.transmitter.
pengiriman	shipping , dispatch.
pengisap	1 s.t. that sucks. 2 extortionist. 3 o. who smokes.
pengisapan	1 exploitation, gouging. 2 smoking.
pengistirahatan	1 giving s.o a rest 2 putting s.o intro retirement.
pengkabutan	1) sprayer. 2) atomizer. 3) carburetor.
pengkar	crooked (of legs).
pengkedikan	retroflex ion ( of tongue ) .
pengkerukan	1 dredging. 2 exploition
pengkhotbah	1 preacher. 2 s.t. to preach with.
pengki	open basket for carrying dirt, garbage, etc.
pengkikisan	1 erosion. 2 erasure. 3 loss, disappearance.
pengkokoan	ulat sutera raising of silk worm.
pengkol	bent.
pengkolan	curve.
pengkor	crippled, having a shriveled leg.
penglaris	1 the first item sold in a work day, throught to stimulate later sales. 2 s.t. that sells well, best seller.
penglihatan	1 sight, vision, eyesight. 2 sight, scene.
pengobatan	medicinal treatment, therapy.
pengocok	shaker.
pengocokan	1 shaking. 2 rubbing. 3 mixing, suffling.
pengolahan	1 preparation, manufacture. 2 processing. 3 tabulation (of data).
pengompreng	s.o. who uses an official car for public transportation.
pengoperan	1 taking over. 2 tranferal. 3 delegation (of powers).
pengrajin	craftsman, artisan.
pengser	pincers.
penguangan	cashing of checks, money orders, etc.
penguapan	1 evaporation. 2 distillation process.
pengubah	1 o. who changes. 2 corrector.
pengubahan	process of altering, modification.
penguberan	pursuit.
penguburan	burial, interment.
pengucapan	pronouncing.
pengudaraan	1 airing. 2 releasing s.t. into the air.
penguji	examiner.
pengujian	trial, testing.
pengujung	extreme end.
pengukir	engraver, carver.
pengukiran	act of carving.
pengukur	1 meter, gauge. 2 o. who measures.
pengukuran	measuring, gauging.
pengulang	1 s.o. who repeats. 2 coach, tutor.
pengulangan	repeating s.t.
pengulas	reviewer.
pengulikan	investigation.
pengulit	lullaby singer.
pengulu	see penghulu.
pengumban	missile, sling.
pengumbuk	swindler.
pengumpan	o. who uses a bait.
pengumpat	s.o. who curses.
pengumpil	lever, crowbar.
pengumpul	collector, gatherer.
pengumuman	announcement, notification.
pengundang-undang	legislator.
pengundangan	enactment (of a law).
pengundi	o. who draws (a lot, ticket, etc.).
pengundian	lottery, raffle.
pengunduran	retreat, withdrawal, putting or setting back, postponement.
pengungkapan	act of expressing.
pengungkil	lever.
pengungkilan	leverage.
pengungkit	lever.
pengungkitan	leverage.
pengungsi	refugee, evacuee.
pengungsian	1 evacuation. 2 asylum, refuge.
pengunjuk	o. who presents or points out.
pengunjukan	1 offer, presentation. 2 indication.
pengurai	1 o. who analyzes or disentangles. 2 chemicals used for decomposing.
penguraian	the action of disentangling or analyzing.
pengurup	money-changer.
pengurus	1 board, management. 2 manager.
pengurusan	1 management handling, treatment. 2 arrangement.
pengusaha	industrialist, entrepreneur.
pengusahaan	effort, exertion.
pengusik	1 disturber. 2 meddler.
pengusir	s.o. or s.t. that chases away.
pengusiran	eviction, expulsion.
pengusul	proposer.
pengusulan	inquiry, examination.
pengusung	o. who carries s.t. on his shoulders.
pengusungan	act of carrying s.t. on the shoulders.
pengusut	investigator.
pengusutan	examination, investigation.
pengutak-atik	/pengutak-utik/ o. who tinkers.
pengutamaan	act of giving priority to s.t.
pengutaraan	1 explanation. 2 communication.
pengutuhan	process of unifying.
pengutusan	mission.
peniadaan	1 negation. 2 abolition, discontinuance.
penidur	o. who sleeps a great deal.
penikam	1 o. who stabs. 2 s.t. o. stabs with.
penikaman	a stab, stabbing.
penikmat	lover, devotee.
penilai	1 appraiser, assessor. 2 grader, judge (in competition).
penilik	1 fortuneteller. 2 supervisor, inspector.
penilikan	1 supervision, control. 2 observation.
penimba	1 a container for scooping liquids. 2 o. who scoops out water, etc.
penimbaan	scooping, dipping.
penimbang	1 pair of scales. 2 counselor.
penimbangan	1 (act of) weighing, balancing. 2 considering.
penimbun	a hoarder.
penimbunan	1 accumulation, piling up. 2 hoarding. 3 process of reclaiming land from the sea by piling up earth.
penindakan	taking measures.
penindas	oppressor, tyrant.
penindasan	1 oppression. 2 suppression.
penindih	oppressor.
penindihan	1 applying pressure or weigh on s.t. 2 suppressing.
pening	1 dizzy. 2 upset, rattled. /pe`ning/ badge, license (for bicycles, dogs, and pedicabs).
peninggalan	1 estate, inheritance. 2 relic, archaeological remains. 3 remainder, rest.
peninggian	heightening, raising, enhancement.
peningkatan	1 raising (a level), upgrading. 2 rise, increase, excalation.
peningset	(java) bride price (paid upon engagement or upon marriage).
peninjau	observer.
peninjauan	1 observation, survey. 2 consideration, contemplation. reconnoitering.
penipu	deceiver, impostor.
penipuan	deception.
penirisan	place for draining.
peniru	imitator, simulator.
peniruan	imitation.
penisilin	penicillin.
peniti	1 safety pin. 2 brooch to pin. a kebaya together.
penitip	[uang] depositor.
penitipan	1 depositing. 2 stroge place. penitipan-pakaian cloakroom.
penitisan	(java) reincarnation.
peniup	o. who blows.
penj-	see also entries with j-.
penjadan	misprint.
penjagaan	1 guarding, security. 2 surveillance. 3 guardpost.
penjahat	criminal, crook, felon.
penjahit	tailor, seamstress.
penjajak	s.t. which probes, sounds out.
penjajakan	sounding out, plumbing.
penjak	1. starled. 2. glow.
penjangak	libertine, rake.
penjangat	skinner, flayer.
penjara	jail, prison.
penjasmanian	1 materialization. 2 embodiment.
penjata	heraldry.
penjatur	1 sorcerer. 2 (snake) charmer.
penjebrolan	ejection.
penjegal	o. who interferes with.
penjelajah	1 exploration. 2 examination.
penjenisan	grouping, classification.
penjernihan	purification.
penjiplak	1 plagiarist. 2 duplicator, duplicating machine.
penjiplakan	plagiarism.
penjiwaan	1 animism. 2 inspiration .
penjol	swollen.
penjumlahan	penjumlahan
penjunan	o. who makes pots.
penjurit	see prajurit.
penjuru	1 corner, angle. 2 direction from which s.t. comes.
penobatan	coronation, installation.
penodong	hold-up man.
penodongan	hold-up.
penojos	perforation.
penokoh	cheater, deceiver.
penolak	1 rejecter. 2 repellent.
penolakan	1 refusal, rejection. 2 warding off.
penolok	1 an equal. 2 standard.
penolong	1 helper, auxiliary. 2 rescuer.
penongkat	assistant.
penonjolan	1 making s.t. stand out. 2 conspicuousness.
penonton	1 spectator. 2 onlooker.
penopang	support, prop, abutment.
penoreh	1 scoring or slitting tool. 2 o. who taps rubber.
penorehan	process of rubber tapping.
penpres	[penetapan presiden] presidential decision or directive.
penset	see pinset.
pensil	1 pencil. 2 small brush for drawing.
pensip	[pegawai negeri sipil] civil servants.
pensiun	pension, retired.
penskoran	suspension.
penstrep	penicillin tablets.
pentafsir	1 commentator, exegete. 2 evaluator.
pentafsiran	1 explanation, interpretation. commentary, exegesis.
pentahapan	arranging in phases.
pentahbisan	consecration or ordination ceremony.
pentakik	o. who makes such incisions.
pentaklikan	collation.
pentaklukan	subjection, submission.
pental	ke-, ter-pental flung away.
pentan	definite.
pentanaman	1 planting. 2 (fin.) investment.
pentang	open, extend, spread out.
pentarafan	ranking, grading in ranks.
pentas	raised platform, stage. pentas-an stage performance.
pentasbehan	praising god.
pententeraman	reassurance.
penterjemah	translator.
penterjemahan	translating.
penteroran	terrorizing.
pentil	1. teat. 2. mem-pentil pinch s.t. /pe`ntil/ valve.
penting	1. important, significant.
pentokohan	characterization.
pentol	/pentul/ knob.
pentolan	1 prominent. 2 leader of a gang. 3 leader. 4 bulb.
pentorpedoan	torpedoing.
pentraktoran	bulldozing.
pentranskripsian	the process of transcribing s.t.
pentransmigrasian	process of relocating s.o.
pentrasean	tracing.
pentunangan	act of becoming engaged, betrothal.
pentung	club, cudgel.
pentunu	o. who roasts.
pentunuan	roasting.
penturbaan	going down to the people.
penuaan	aging.
penuai	1 rice harvest knife. 2 o. who reaps or gathers in a harvest.
penuaian	harvesting of rice.
penuangan	pouring, molding, casting.
penubrukan	colliding, crashing, striking.
penuduh	1 (leg.) prosecutor. 2 accuser, plaintiff.
penuduhan	accusation.
penudung	cover.
penudungan	covering.
penugasan	giving an assignment.
penuh	1 full (of), loaded. 2 complete.
penukaran	1 alteration, process of making a change. 2 exchange.
penukul	hammerer.
penulangan	erecting a framework.
penular	infector, infecting agent.
penularan	spreading.
penulis	1 writer (of letter, etc.). 2 secretary (of association).
penulisan	process of writing.
penumbangan	causing s.t. to crash down.
penumbuh	s.t. that stimulates growth.
penumbuhan	1 the act of growing. 2 emergence.
penumbuk	crusher, pounder.
penumbukan	1 pounding, crushing. 2 blow, stroke. 3 act of colliding.
penumpahan	1 act of spilling or shedding. 2 concentration.
penumpang	1 passenger. 2 boarder, hotel guest.
penumpangan	1 act of being over s.t. 2 place to stay.
penumpas	destroyer.
penumpasan	annihilation, extermination.
penumpu	support.
penumpukan	accumulation, hoarding.
penunaian	1 (cash) payment. 2 settlement. 3 fulfillment.
penundaan	postponement, deferment, adjournment.
penundukan	1 submission, subjection. 2 subjugation.
penunggak	o. who is arrears in payments.
penunggalan	concentration.
penunggang	rider, passenger. pengunggang-kuda horseman.
penunggu	1 watchman, guard. 2 attendant. 3 tutelary spirit.
penungguan	act of waiting.
penunjang	s.t. supporting.
penunjangan	the act of supporting.
penunjuk	1 s.t. which indicates. 2 o. who indicates.
penunjukan	1 indication. 2 reference, pointing to s.t. 3 appointment, assignment.
penuntun	1 guide. 2 manual, guide.
penuntunan	1 leading with a line, etc. 2 providing guidance.
penuntut	1 o. who demand s.t., petitioner. 2 (leg.) claimant, prosecutor. 3 o. who strives after.
penuntutan	1 demanding. 2 pursuit, study. 3 (leg.) prosecution.
penurunan	1 slope, descent. 2 discharge, unloading. 3 lowering, taking down. 4 derivation, deriving. 5 reduction, decline (of cost, prices, etc.).
penurut	1 s.o. obedient and docile. 2 a follower.
penusuk	s.t. to perforate or stab with.
penusukan	1 stabbing, jabbing. 2 perforation.
penutup	1 cover, lid, casing. 2 closing.
penutupan	1 covering. 2 closing, shutting, occlusion, shut down.
penutur	speaker, narrator, pronouncer.
penuturan	1. 1) talk, speech. 2) discussion, narrative. 3) announcement, information. 2. (lit.) descendant.
peny-	see also entries with c-, s-, or ny-.
penyabet	(purse) snatcher.
penyablon	1 copier. 2 plagiarist.
penyair	poet.
penyajian	presentation.
penyakit	1 disease, illness. 2 trouble. 3 bad habit.
penyalin	1 copyist. 2 translator.
penyalinan	translating, copying.
penyamarataan	treating the same, generalization, leveling.
penyambut	s.o. that welcomes.
penyambutan	reception, welcoming.
penyampai	o. who conveys.
penyampaian	delivery.
penyamun	robber.
penyangkulan	hoeing.
penyanyi	singer.
penyayang	1 charitable, merciful lord. 2 lover, amateur, devotee.
penyebar	disseminator.
penyebaran	distributing, spreading, disseminating.
penyebut	1 o. who calls, mentions. 2 (math.) denominator.
penyebutan	addressing, mentioning.
penyedap	s.t. used as flavoring.
penyederhanaan	simplification.
penyediaan	1 act of preparing. 2 equipping, supplying.
penyedot	instrument to absorb.
penyedotan	suction.
penyejuk	cooler.
penyek	/penyet/ flattened out, squeezed flat.
penyelaman	1 diving. 2 immersion, submersion.
penyelamatan	rescuing, redemption.
penyelenggara	1 caretaker. 2 executor. 3 organized, operator.
penyelenggaraan	1. implementation. 2 organization, coordination.
penyelesaian	1 arrangement. 2 solution, settlement, completion.
penyeleweng	crook.
penyelewengan	1 deviation (from task or duty). 2 irregularity, corruption.
penyelidik	1 investigator, research worker. 2 examiner, detective. 3 scout.
penyelidikan	1 research. 2 inquiry, investigation. 2 survey.
penyeling	alternative.
penyelundup	smuggler.
penyelundupan	smugling.
penyelusup	1 infiltrator. 2 s.t. that infiltrates.
penyelusupan	penetration.
penyemaian	process of raising seedlings.
penyematan	1 pinning (of medals, etc.). 2 (ling.) embedding.
penyembah	worshipper.
penyembahan	adoraditon , worship.
penyembelih	a butcher.
penyembelihan	slaughter, butchering.
penyembuhan	healing.
penyembur	instrument for spraying.
penyempitan	constriction, stricture.
penyemprot	syringe, sprayer.
penyemprotan	spraying.
penyempurnaan	action of perfecting, completing, finishing (articles, products).
penyendiri	solitary, liking to be alone, loner.
penyendirian	isolation.
penyengat	1 s.t. that stings. 2 wasp.
penyepuhan	1 gilding s.t. 2 (phys.) plating.
penyerahan	1 transfer, deliverry. 2 surrender, yielding. 3 resignation to a situation.
penyerang	attacker, aggressor.
penyerangan	attack, aggression.
penyerap	1 absorbent. 2 absorber.
penyerapkan	hold in reserve, lay aside.
penyerasian	adaptation, harmonization.
penyerbakan	smelling good.
penyerbuan	attacking, invasion.
penyerbukan	pollination.
penyergapan	attack on s.o. or s.t.
penyerimpungan	act of tripping up or impeding.
penyerobot	1 o. who snatches. 2 o. who acts highhandedly.
penyerobotan	illegal occupancy or annexation, snatching away of s.t.
penyerongan	beveling, act making s.t. go at an angle.
penyertaan	1 participation. 2 attaching s.t., enclosing s.t.
penyeru	announcer.
penyeruan	1 calling, crying. 2 appeal.
penyesalan	1 regret, remorse. 2 reproach.
penyesuaian	adaptation, adjustment, accommodation.
penyetekan	grafting.
penyetir	driver.
penyetopan	stopping.
penyetor	1 purveyor, supplier. 2 depositor.
penyetoran	depositing, payment.
penyewa	1 tenant, lessee. 2 rental payment.
penyialang	honey gatherer.
penyiar	1 announcer. 2 publisher. 3 (tech.) transmitter.
penyiaran	broadcasting.
penyiasat	1 (lit.) investigator. 2 strategist, tactician.
penyiasatan	1 (lit.) investigation. 2 bringing tactics or stratagems to bear.
penyidik	(leg.) investigating officer.
penyidikan	police investigation.
penyikatan	1 brushing, combing, etc. 2 stealing. 3 abrupt removal.
penyiksa	tormentor, torturer.
penyiksaan	torturing, mistreating.
penyiku	1 s.t. to square off. 2 (math.) complementary.
penyilangan	crossing, mutation (in agriculture).
penyimak	good listener.
penyimakan	listening attentively, monitoring.
penyimpan	1 o. who saves, a depositor. 2 storage place.
penyimpanan	storage, laying away.
penyimpangan	deviation, divergence.
penyimpul	s.o. or s.t. which bring s.t. (discussion, etc.). to a conclusion.
penyimpulan	process of drawing a conclusion.
penyinaran	1 illumination. 2 radiation.
penyingkapan	uncovering, disclosure..
penyingkiran	1 evacuation. 2 elimination, purge. 3 exclusion.
penyiraman	pouring of liquids, watering.
penyirian	taking revenge because of humiliation.
penyisian	movement to the side.
penyisihan	1 isolation. 2 elimination.
penyisipan	1 insertion. 2 (ling.) infixation.
penyiul	whistler.
penyjelasan	explanation, clarification.
penyobek	o. who takes (and tears) tickets, ticket-taker.
penyodok	shovel, spade.
penyodor	o. who hands in s.t.
penyodoran	offer.
penyogokan	bribery.
penyok	/penyot/ dented.
penyokong	supporter, contributor.
penyondong	net for catching shrimp.
penyongsong	1 greeter. 2 greetings.
penyongsongan	greeting, welcoming.
penyorak	o. who yell, vocal supporter.
penyorot	1 reflector, projector. 2 commentator, reviewer.
penyorotan	1 illumination, spotlighting. 2 elucidation.
penyosohan	process of hulling rice.
penyu	1 turtle. 2 tortoise shell.
penyuapan	1 feeding or eating with the hand. 2 bribery.
penyuaraan	1 declamation. 2 dubbing. 3 (ling.0 voicing.
penyubakan	s.t. used to mix with, or subsitute s.t. else.
penyubur	s.t. that makes fertile.
penyudetan	cutting between canals, diverting (water).
penyuguhan	presentation.
penyulapan	conjuring, methods of sleight of hand.
penyuling	instrument to refine.
penyulingan	distilling, refining.
penyuluh	1 o. who provides elucidation. 2 (lit.) investigator, spy.
penyuluhan	1 illumination. 2 information, elucidation.
penyumbang	contributor, supporter.
penyumbatan	clogging, obstruction, blockage.
penyungkit	tool for prying.
penyungkup	1 concave cover. 2 bell jar.
penyuntik	1 s.o. who gives injections. 2 syringe.
penyuntikan	injecting, vaccinating injection.
penyuplai	supplier.
penyusun	composer, compiler.
penyusunan	1 arranging, compiling. 2 composing.
penyusup	infiltrator.
penyusupan	penetration, infiltration.
penyusur	o. who follows up.
penyusuran	act of tracing.
penyusutan	1 shrinkage, contraction. 2 reduction, decrease.
penyutradaraan	1 play or film direction. 2 directing.
penyuwukan	action of blowing to heal magically.
peok	1 lame. 2 flat.
peon	messenger boy.
peot	1. 1) dented. 2) old and battered. 2. see peok.
pepadang	see padang.
pepak	complete, full. se-pepak all of them.
pepal	concentrated, terse, compact.
pepantan	group of christians in new community who combine with existing church temporarily until they can form their own church.
peparu	lungs.
pepas	fish, angle.
pepat	flattened, level, smooth.
pepatah	aphorism.
pepaya	see papaya.
pepe	(java) expose s.t. to sun, dry in sun.
peped	see pepet.
pepek	(vulg.) vagina.
peper	paper, essay.
peperda	[penguasa perang daerah] regional war administrator.
peperpu	[penguasa perang pusat] central war administrator.
peperti	[penguasa perang (ter)tinggi] supreme military administrator.
pepes	meat or fish wrapped in a banana leaf and roasted.
pepet	1. stopped up (of nose). 2. see bunyi. /pe`pe`t/ dead end, no way out.
pepindan	metaphor.
pepohonan	1 trees. 2 reforestation.
peptida	peptide.
peptidase	peptidase.
peptidisasi	peptization.
pepuju	womb.
pepunden	/pepundi/ (java) object of worship.
pepura	mock, sham.
per	1 per, by the. per-kapita per capita.. 2 as of such and such a date.
per-	see also entries with pr-.
per.	[perusahaan] enterprise, firm, concern.
pera	the taste of rice that is dry.
perabot	1 utensils. 2 tools. 3 furniture.
perabotan	household furnishings.
perabu	see prabu.
perabuan	1 urn for ashes of cremated person. 2 crematorium.
perabukan	application of fertilizer.
perada	1. 1) tin coasting. 2) gold leaf. 2. review, parade.
peradaban	culture, civilization.
peradangan	(med.) infection, inflammation.
peradilan	judicature.
peradin	[persatuan advokat indonesia] indonesian lawyer's association.
peraduan	1. contest, clash. 2. royal bed.
peraga	1. visual aid. 2. 1) boaster. 2) a model. 3) mock-up, visual aid.
peragaan	1. show. 2. 1) ostentation. 2) show, exhibittion. 3) modeling. 4) visual display.
peragawan	male model or mannequin.
peragawati	female model or mannequin.
peragenan	agency.
perah	1 squeeze. 2 milk.
perahan	1 milch cow. 2 s.t. squeezed out.
perahu	boat.
perai	1. 1) free. 2) empty (of a seat). 3) unhampered. 4) broke (whitout money). 2. loose, apart.
perairan	1 waters. 2 waterworks.
perajin	craftsman, artisan.
perajurit	see prajurit.
perak	1 silver. 2 (jakarta) rupiah.
perakan	a rupiah coin or bill.
perakit	assembler.
perakitan	assembling.
peraktik	see praktek.
peralatan	1. 1) instrumentation. 2) equipment, tools. 2. feast, celebration.
peralihan	transfer, shift, change.
peram	shut o.s. off from society.
peramal	oracle, fortune-teller.
perampas	robber.
perampasan	1 robbery, holdup. 2 expropriation.
perampok	robber, plunderer.
perampokan	robbery, looting.
peran	1 actor. 2 character (in novel, play, etc.).
peranakan	see anak.
peranan	peranan
perancah	scaffolding.
perancang	planner, planning body.
perancis	see prancis.
perandaian	1. assumption. 2. matters pertaining to this folk drama.
perandi	(tech.) ware. perandi-lunak software. perandi-keras hardware.
perang	war, battle. /pe`rang/ colors ranging from reddish blond to auburn (hair of plants, animals or humans).
perangah	agape.
perangai	1 nature, disposition. 2 behavior, attitude.
perangas-perongos	(java) make a wry expression.
peranggi	see perenggi.
peranggrekan	orchid matters, orchidology.
peranginan	1 ventilation. 2 balcony.
perangkaan	statistics.
perangkap	1. a person who holds two jobs. 2. trap, pitfall.
perangkat	sets of equipment.
perangkatan	1 equipment. 2 forces.
perangko	see prangko.
perangsangan	1 act of exciting, stimulation. 2 anger, irritation. 3 incentive, motivation.
peranjak	fall on o.'s behind.
peranjakan	transfer, removal.
peranjat	starled, surprised.
perantara	1 intermediatery, mediator, go-between. 2 agent. 3 agency, expediter.
perantaraan	1 intercession, mediation. 2 middleman, intermediary (individual or a body). 3 intervention. 4 relationship.
peranti	1 apparatus, instrument. 2 means. 3 in order to. 4 remedy.
peranye	fringe.
perapatan	see prapatan.
perapian	1 fireplace, brazier. 2 ignition. 3 oven, range. 4 furnace.
peras	1 press, swueeze. 2 milk. 3 blackmail, put the squeeze on.
perasa	1 sense of touch. 2 sensitive person.
perasaan	1 opinion, feeling. 2 sentiment. 3 experience, sensation.
perasan	distillation.
perasat	see firasat.
perasian	1 horoscope. 2 fate.
perasman	see prasman.
perawan	1 virgin, girl. 2 brand new to s.t.
perawat	nurse.
perawatan	1 treatment. 2 nursing, care.
perawian	exposition.
perawira	see perwira.
perawis	ingredients.
perayaan	celebration.
perbagai	see pelbagai.
perbahasa	see peribahasa.
perbal	1 official report. 2 ticket. 3 police warrant, summons. memp-perbal process a criminal charge.
perban	bandage.
perbanas	[perhimpunan bank-bank nasional swasta] association of national private banks.
perbani	see bulan, pasang 3.
perbatasan	border, division.
perbawa	influence, prestige.
perbegu	heathenish.
perbekel	(bali) village chief.
perbelanjaan	1 expenses, (national) budget. 2 financing. 3 shopping.
perburuan	1 the hunt. 2 prey, game. 3 persecution.
perc.	[percetakan] printing establishment.
perca	1. rag. perca-kertas scraps of paper. 2. see getah, pulau.
percak	make rushing noise (of water).
percapita	/per kapita/ per capita.
percaya	1 belief, faith. 2 trust, believe.
percik	stain, spot.
percikan	sprinkling, fragment.
