padri	see paderi.
padu	1 solid, compact, fused. 2 in harmony. 3 resolute.
paduan	fusion, combination, blend, synthesis.
paduk	baseline.
paduka	(lit.) excellency.
padusi	(m) woman, female.
paedah	see faedah.
paes	(java) makeup (cosmetics).
paga	(java) basket (hung up to preserve food).
pagan	firm, solid.
pagar	1 fence. 2 hedge.
pagarisasi	program to provide fences.
pagelar	put on a show, present.
pagelaran	show, presentation.
pager	see pagar.
pagi	morning.
pagina	page (of a publication).
pagu	ceiling.
pagut	1 peck. 2 bite (of snake). 3 embrace
paguyuban	(java, sunda) association.
pah	see pak 2.
paha	thigh.
pahala	merit, reward for moral conduct.
paham	1 understanding. 2 view, concept. 3 understand, know.
pahar	teacart, tea wagon.
pahat	chisel.
pahatan	carving, relief.
pahing	see paing.
pahit	1 bitter (in taste).
pahlawan	hero, patriot.
pahlawati	heroine.
pai	1. pie. 2. (m) go.
paidah	see faedah.
paido	(java) m-paido disparage, belittle.
paidon	(java) cuspidor.
pailit	see palit1.
paing	2d day of java week.
pair	1. pair-jantung (med.) pulse deviation. 2. see payar.
pais	cook in banana leaves over coals.
pait	see pahit.
paitua	1 (ambon) husband. 2 (coll.) old man.
pajajaran	name of kingdom in west java.
pajak	1 tax. 2 monopoly or franchise given by colonial gvt.
pajang	mem-(p)ajang dress window, display. mem-(p)ajang-i decorate.
pajar	see fajar.
paju	see aju.
pajuh	stuff, gorge.
pak	1./pa`, pak/ 1) package, parcel. 2) pack. 2. lease, rent a right. 3. /pak/ charter, pact. 4. see bapa.
pakai	1 involve the use of, with, by means of. 2 take (a certain food). 3 wear.
pakaian	1 clothes, suit, uniform, dress.
pakal	putty, caulking.
pakam	see pakem 1.
pakan	woof.
pakansi	holiday, vacation.
pakar	expert in certain field.
pakarya,pakaryan	(blue-collar) worker, artisan, crafisman.
pakat	1. 1) agreement. 2) discussion, convention. 2. see pekat.
pakcik	uncle (younger brother or younger cousin of parent).
pakde	(java) uncle (older brother or older cousin of o.'s parent).
pake(k)	see pakai.
pakem	1. taking hold well (of brakes). 2. source book for the java shadow play stories.
paket	1 parcel. 2 package, set of proposals that go together.
pakih	see fakih.
paking	1 gasket. 2 packaging.
pakir	see fakir.
pakis	k.o. edible fern.
pakking	see paking.
pakne	(java) term of address to o.'s husband.
pakpue	/pakpui/ (china) divination.
paksa	1.1) force. 2) necessity, compulsion. 2. favorable opportunity.
paksi	1 axis. 2 pivot.
paksina	north.
pakta	pact.
pakter	stall selling palm wine.
paktor	see faktor.
paktur	see faktur.
paku	1. nail, spike. 2. k.o. edible fern.
pakuk	hit or cut with an axe.
pakum	a vacuum.
pal	1 lenght of about o. mile. 2 milestone. 3 pole.
pala	1. nutmeg. 2. /sepala-pala/ if and so has already gotten started, been done to a certain extent (o. might as well go ahead and finish it, do it the whole way).
palagan	(java) battleground.
palai	stew until tender.
palaikat	see pelekat.
palak	1. 1) angry. 2) passionate, easily excited. 3) hot, feverish. 2. penis. 3. see falak.
palam	1. stop a leak. 2. see palem.
palang	1 crossbar. 2 bolt. 3 barrier.
palapa	name of fruit gajah madah swore not to eat until kingdom of majapahit was united.
palar	1 consider sufficient, all right. 2 count on, hope for.
palawija	crops planted as 2d crop in dry season.
paleh	(sunda) take care of a fighting or racing animal.
palem	palm.
palen	sundries, ready-made merchandise.
paleolitik	(geol.) paleolithic.
paleontologi	(geol.) paleontology.
palet	palette.
palindrom	palindrome.
paling	1. the most. 2. turn.
palis	1. avert o.'s eyes, turn o.'s face away. 2. polish.
palit	1. bankrupt. 2. ointment.
palka	(naut.) hold of a ship.
palma	palm (tree).
palsu	false, counterfeit.
paltu	1 assistant. 2 acting, temporary holder of position.
palu	1 hammer. 2 blow. 3 gavel.
paluh	deep pool.
palun	embrace, hug e.o.
palung	1 pool. 2 trough. 3 riverbed. palung-an manger.
palupuh	pounded bamboo.
palut	wrapped.
pam	[perusahaan air minum] municipal water corporation.
paman	uncle (esp. younger brother or younger cousin of parent).
pamarta	(rel.) savior, redeemer.
pambek	(java) pride.
pamegat	patron.
pamen	(mil.) an officer of the middle ranks.
pameo	1 slogan. 2 saying, proverb.
pamer	show off. pamer-an exhibition.
pamflet	pamphlet.
pamili	1 family. 2 relative.
pamit	1 farewell. 2 say goodbye. ber-pamit take leave.
pamong	1 guardian, o. who takes care of (us. gvt. official). 2 tutor.
pamor	1 pattern inherent in blade of good kris. 2 luster, prestige.
pampang	1 wide, broad. 2 obvious.
pampas	reimbursement, indemnity.
pampasan	reparations payment.
pampat	press, squeeze.
pamplet	see pamflet.
pamrih	1 profit, reward o. gets for doing s.t. 2 purpose, what o. is after.
pamungkas	1 (java) final (part). 2 deadly, s.t. that finishes s.t. off.
pamur	see pamor.
pan	1. oven heated with charcoal. pan-pan-an baked in a charcoal oven. 2. (jakarta) see kan 1.
pana	1 stupified, stunned. 2 stunned, impressed.
panah	bow (and arrow).
panahan	archery.
panakawan	see punakawan.
panar	stunned, surprised.
panas	1 warm, hot, heat. 2 fever, feverish. 3 critical. 4 fierce.
panasaran	see penasaran.
panatik	see fanatik.
panatisme	see fanatisme.
panau	skin fungus causing white blotches.
panca	1 penta-, quinti-, five. 2 hand. ber-panca wrestle by pushing o.'s opponent with the hands.
pancaindera	the five senses.
pancaka	crematorium.
pancal	press down on with foot, step on (the gas).
pancalan	pedal.
pancalogi	(spo.) five principles.
pancalomba	pentathlon.
pancamuka	multifaceted.
pancang	1 pole, stake, pile. 2 boundary pole.
pancaragam	various, motley, all k.o.
pancaran	pancaran
pancargas	jet.
pancaroba	transition period, esp. between monsoons, periods of life, etc.
pancasila	the five basic principles of the republic of indonesia: the belief in o. god almighty, humanity that is just and civilized, the unity of indonesia, democracy guided by the wisdom of referensentative deliberation, social justice for all indonesians.
pancasilais	o. who is an enthusiastic follower or supporter of pancasila.
pancasona	invulnerability to death.
pancawarna	multicolored.
pancawarsa	five-year period.
pancawindu	a period of 40 years.
pancer	1 keep s.o. waiting. 2 leave s.t. going.
panci	pan.
pancing	1 fishing rod. 2 fishhook. pancing-an elecitation, provocation, inducement.
pancit	squirt little by little.
panco	arm wrestling.
pancoleng	thief.
pancong	see kue.
pancung	1 train of dress, shirttail. 2 angular, cut off sharply.
pancur	gush, spout, pour out or down.
pancuran	1 shower. 2 jet, spray. 3 tap.
pancut	gush.
pancutan	spray, gush, spurt.
pandai	1. 1) bright, smart. 2) capable. 3) know, know how. 2. goldsmith.
pandak	short.
pandan	pandanus.
pandang	a look.
pandangan	1 view, opinion. 2 s.t.o. sees.
pandega	1 employees on a fishing vessel. 2 boy or girl scouts of highest rank (aged 15-17 years).
pandemen	see fondamen.
pandir	stupid, naive.
pandita	1 (bali) hindu priest. 2 (lit.) title of a palace rank.
pandom	compass.
pandu	1 guide. 2 boy or girl scout (in former times).
panduan	1 escort. 2 pilot (project).
panekui	(m) see panekuk.
panekuk	crepe, pancake.
panel	1. panel (discussion). 2. panel of wood.
panelis	panelist.
panembrama	(java) song welcoming a celebrity opening an important event, etc.
panen	1 harvest. 2 reap a nice profit.
pang	sound of drum.
panga	wide open.
pangab	[panglima angkatan bersenjata] commanderin chief of the armed forces.
pangabekti	(java) homage.
pangad	[panglima angkatan darat] commander in chief of the ground forces.
pangah	open the mouth in astonishment.
pangalungan	(sunda) money thrown by spectators to actors or dancers.
pangan	food.
pangdam	[panglima daerah militer] territorial military commander.
pangeran	1 prince, lord. 2 (crd.) jack.
pangestu	(java) 1 blessing. 2 spiritual movement originating in central java.
panggak	proud of s.t. or s.o.
panggang	1 baked, roasted. 2 toasted.
panggar	raised framework, us. used for drying fish.
panggeng	(jakarta) constant, regular, unchanging.
panggih	(java) ritual meeting at the wedding of a couple being married.
panggil	1 call, summon, send fors.o. 2 name, call.
panggul	(anat.) hip, pelvis.
panggung	1 stage, raised platform. 2 grandstand. 3 scaffolding.
pangkal	1 base, beginning, starting point. 2 cause. 3 base point. 4 (elect.) pole.
pangkalan	1 place to start out from, bridgehead. 2 quay, anchorage. 3 (mil.) base (for armed forces).
pangkas	get a haircut.
pangkasan	haircut or other trim given.
pangkat	1 rank, position. 2 step, grade (in advancement). 3 floor, story. 4 platform. 5 (math.) degree, power.
pangkeng	/pangking/ raised area in room for sleeping.
pangkon	(java) wooden base of gamelan.
pangkopkamtib	[panglima komando pemulihan keamanan dan ketertiban] commander for the restoration of peace, security, and order.
pangku	lap.
pangkung	hit with a club.
pangkur	1 pickax. 2 mattock, hoe.
panglima	(mil.) commander.
pangling	(java) fail to recognize.
panglong	lumber mill.
pangon	shepherd.
pangonan	pasture.
pangreh-praja	civil service.
pangsa	segment, section (of fruit).
pangsan	see pingsan.
pangsi	1. reel, drum, shaft. 2. 1) k.o. collarless shirt. 2) (china) k.o. black silk.
pangsit	(china) k.o. wonton or ravioli.
pangsiun	see pensiun.
pangti	[panglima tertinggi] (mil.) commander in chief.
pangur	1 rasp, file. 2 tooth filing.
pangus	dashing, handsome.
panguyuban	see paguyuban.
panik	panic.
panil	see panel 2.
panili	vanilla.
panitera	1 clerk of court. 2 registrar.
paniteratama	chief secretary.
panitia	/panitya/ committee.
panjak	a player in gamelan.
panjang	long, length.
panjar	cash advance.
panjaran	down payment.
panjat	climb.
panji	/panji-panji standard, banner, pennant.
pano	see panau.
panorama	panorama.
panser	(mil.) armored vehicle.
pansiun	see pensiun.
pantai	beach, coast, seashore.
pantak	mem-pantak penetrate.
pantalon	(lit.) long trousers.
pantang	1 prohibition, forbidden by taboo. 2 avoidance of s.t. taboo.
pantar	being of the same age as.
pantas	1 proper, suitable. 2 reasonable, fair, proper. 3 alert, smart. 4 of course ! no wonder !.
pantat	1. 1) behind, bottom, buttock. 2) back part of s.t. 3) base. 2. mem-pantat getah gather rubber.
pantau	monitor s.t., observe.
pantek	see pantik 1.
pantekosta	(rel.) 1 whitsuntide, pentecost. 2 pentecostal sect.
pantes	see pantas.
panti	1 (lit.) house, residence. 2 institution, home.
panti-asuhan	orphanage.
pantik	1. 1) strike fire. 2) snap o.'s fingers. 2. drill (a well).
panting	1. fall away in numbers. 2. see pontang-panting.
pantis	mascara.
panto	(biol.) annual growth ring (on trees).
pantofel	/pantopel/ slippers (with closed toes).
pantok	the endmost, bottommost, furthest point.
pantomim	pantomime.
pantul	bounce back, bounce off.
pantulan	1 reflection. 2 rebound.
pantun	k.o. traditional poetry, each verse of which consists of two couplets: the first suggests the 2d by sound or other similarity. it is often sung in contests where a boy addresses a quatain to a girl who must answer with a quatrain of her own.
panu	(java) see panau.
panus	holder for candle or lamp.
panutan	s.t. to follow, guide, leader.
paohi	see pauhi.
pap	popping sound.
papa	1. poor, destitute. 2. father, esp in westernized families.
papah	supported. papah-an a support to lean on.
papak	1. flat, level, smooth. 2. ber-papak meet.
papakan	1 meeting. 2 welcome, reception. 3 run into, meet.
papan	1. 1) board, plank. 2 shelf. 3 (road) sign. 2. housing, shelter (as basic human need).
papar	flat, level.
paparan	1 shelf. 2 explanation.
papas	1. 1) remove, take off. 2) take everything away. 3) resist. 4) criticize. 2. meet without stopping.
papaya	papaya.
papeda	(ambon) sago porridge.
papi	(coll.) father.
papilyun	see pavilyun.
papirus	papyrus.
papras	trim, cut to even out.
papua-nugini	papua new guinea.
para	1. rubber. 2. collective marker referring to people who comprise a group. 3. (mil.) 1) paratrooper. 2 specially trained troops.
para-para	loft, shelf over the hearth.
parabola	(math.) parabola.
parabolis	(math.) parabolic.
paradam	see perdom.
parade	parade.
paradigma	paradigm.
paradoks	/paradoksal/ paradoxical.
paradom	see perdom.
paraf	initials.
parafin	paraffin.
parafrase	paraphrase.
paragraf	paragraph.
parah	in serious condition.
paraji	(sunda) midwife.
parak	1 difference. 2 partition. 3 interspace. 4 entering a time or era.
paralel	parallel.
paralelogram	(math.) parallelogram.
param	medicinal powder or ointment, or liquid to rub on body.
parama-arta	see ambeg-parama-arta.
paramanusia	human race.
paramasastera	grammar.
parameter	parameter.
paran	1 direction. 2 goal, aim. approach, go to.
parang	1. short machete, chopping knife. 2. k.o. fish, the wolf-herring.
parap	1. hammer, pound. 2. see paraf.
paraplegia	(med.) paraplegia.
paras	1 face, countenance. 2 looks, appearance. 3 smooth.
parasit	1. parasite. 2. see parasut.
parasitisme	parasitism.
parasitologi	(biol.) parasitology.
parasut	parachute.
parasutis	parachutis.
parau	hoarse.
pardon	clemency, pardon.
pare	bitter melon or momordica, a green bitter and warty squashlike vegetable which grows on vines.
parem	see param.
parewa	street-corner loafer.
parfum	perfume.
pari	1. rayfish, skate. 2. see bintang.
paria	pariah.
parik	in line, in a queue.
parikan	/pari'an/ (java) aphorism.
paripurna	1 perfect, pure. 2 complete. 3 plenary.
parisadha-hindu-dharma-pusat	highest administrative council of the hindu-bali religion.
parit	1 moat, ditch, trench. 2 furrow, slit, groove.
paritas	parity.
pariter	having to do with a parity.
pariwara	advertisement.
pariwisata	1 tourism. 2 a tour. ber-pariwisata make a trip.
pariwisatawan	tourist.
parji	see farji.
parket	parquet.
parkindo	[partai kristen indonesia] indonesian christian party.
parkir	1 be parked. 2 be placed s.w. for a period of time.
parkiran	parking place.
parkit	parakeet.
parlemen	parliament.
parlementer	parliamentary.
parlementerisme	parliamentarism
parlente	1. (ambon) liar. 2. see perlente.
parmasi	see farmasi.
parmusi	[partai muslim indonesia] indonesian muslim party.
paro,paroh	half. se-paroh half, a part.
paroki	(rel.) parish.
paron	anvil.
parpol	[partai politik] political parties.
parpostel	[pariwisata, pos, dan telekomunikasi] tourism, postal, dan telecommunications department.
parsi	persia(n).
parsial,parsiil.	partial (not complete).
partai	1. (pol.) party. 2. 1) (sport) event. 2) a quantity of.
partikel	(ling.) particle, function word.
partikelir	private.
partisipasi	participation.
partitur	musical score.
partner	partner.
partus	(med.) delivery.
paru-paru	lungs. paru-paru-basah pleurisy.
paruh	1. beak. 2 see paro.
parun	burn bushes or weeds to clear.
parut	1 rasp, file. 2 scrape, grate. 3 scraper or grater.
parutan	1 board for scraping or grating. 2 s.t. scraped.
parvinu	parvenu, nouveau riche.
parwa	chapter of the mahabharata.
pas	1. 1) fit, be the right size. 2) exact, exactly. 3) axactly at. 2. pass, document. 3. (bri.) pass.
pasah	(islam) divorce granted by religious court at wife's request.
pasahan	shavings, excelsior.
pasak	1 pin, peg, dowel. 2 bolt. 3 pivot, axis. 4 turning point.
pasal	1 paragraph, section. 2 (leg.) article. 3 concerning, regarding, about.
pasamuan-suci	the catholic community.
pasang	1. pair, set. 2. 1) show off. 2) pose, be on o.'s best behavior. 3. rise (of tide).
pasang-aksi	1 show off. 2 pose, be on o.'s best behavior.
pasanggrahan	resthouse for travelers.
pasar	market.
pasara	see pusara 1. 1) cemetery 2) grave 2 reins .
pasaran	1 market. 2 (java) five-day week. 3 hold a market, be market day. 4 of market quality, not of good enough quality to be sold in a specialty store.
pasarean	(java) cemetery, grave.
pasasi	fare (on a bus, atc.)
pasasir	passenger.
pasca	/paska, pasca/ pasca-sarjana postgraduate work. pasca-panen time after rice harvest.
paseban	(java) audience hall.
paseh	see fasih.
paser	(tech.) compass to measure distance or describe a circle.
pasfoto	photo of passport size.
pasi	very pale.
pasibraka	[pasukan pengibar bendera pusaka] group of model high school students recruited to raise. national flag on independence day.
pasien	medical patient.
pasif	passive.
pasifik	the pacific.
pasifikasi	pacification.
pasih	see fasih.
pasik	1 criminal, bad. 2 crazy. ke-pasik-an sin.
pasilan	1 tree epiphyte. 2 (coll.) freeloader, parasite.
pasilitas	see fasilita.
pasip	see pasif.
pasir	1 sand. 2 beach or place covered with sand. pasir-an sandy.
pasirah	(s. sumatra) village chief.
pasisir	see pesisir 1, pasasir.
paska	/paskah/ easter.
paska-sarjana	see pasca.
pasmen	lace.
paso	see pasu.
pasok	supply (a certain commodity).
paspal	[ilmu pasti dan pengetahuan alam] (acad.) mathematics and natural sciences.
paspor	passport.
pasrah	submit to o.'s fate.
passi	passion.
passiva	liabilities.
pasta	paste. pasta-gigi toothpaste.
pastei	pate.
pastel	meat-filled turnover.
pasti	definite, certain. .
pastiles	lozenges.
pastir	memp-pastir pasteurize.
pastor	/pastur/ catholic priest.
pastoral	pastoral.
pastoran	pastoran
pastori	parish house.
pasu	bowl, basin.
pasukan	1 (mil.) troops. 2 group. 3 formation.
pasundan	sundanese area.
pasung	prisoner's stocks.
pat	(golf) putt.
pat-gulipat	/patpat gulipat/ 1 shady deal. 2 (love) affair.
patah	broken.
patahan	1 facture. 2 broken fragment. 3 (geol.) fault.
pataka	standard, banner.
patal	[pabrik pemintalan] spinning factory.
patas	[cepat terbatas] fast semi-express bus or train.
patatas	[ambon) yams.
patek	frambesia, yaws.
paten	1 patent. 2 (sl.) admirable, tops.
pater	(rel.) priest.
pateri	see patri.
paternalisme	paternalism.
paternalistis	paternalistic.
pateroli	see patroli.
pati	1. 1) starch. 2 core, essence. 2. [perwira tinggi] (mil.) high-ranking officer.
patih	1. 1) governor. 2) vice regent, chief minister to a king. 2. meek, submissive, docile.
patihah	see alfatihah.
patik	1 slave. 2 (lit.) i, me (very humble).
patil	1 pole, shaft. 2 small adze. 3 stinger of a fish.
patok	pole, stake.
patokan	1 pole. 2 directive, standars, criterion. 3 postulate.
patologi	pathology.
patologik	/patologis/ pathologic.
patri	solder.
patriot	patriot.
patriotik	patriotic.
patriotis	patriotic.
patriotisme	patriotism.
patroli	patrol.
patrum	cartridge.
patrun	1. cartridge. 2. (dress) pattern.
patuh	obedient, submissive.
patuk	1 peck, bite. 2 grab with the beak. 3 manage to achieve s.t.
patukan	bill, beak.
patung	1. 1) image, statue. 2) sculpture. 2. chip in together to pay for s.t.
patungan	joint venture.
patus	drain.
patut	1 proper, fitting, decent, in line. 2 should, ought to.
pauh	(lit.) mango.
pauhi	(china) abalone.
pauk	1. hook. 2. see lauk.
paus	1. (rel.) pope. ke-paus-an papacy. 2. see ikan.
pause	(thea.) intermission, entr'acte.
paut	closely joined.
pauze	see pause.
pav.	[pavilyun]
pavilyun	annex, portion (us. an extension) of home set aside as unit for rent.
pawai	parade.
pawaka	(lit.) fire.
pawana	(lit.) wind.
pawang	1 o. endowed with magic powers. 2 o. with a special skill. 3 animal tamer.
pawiyatan	school, training center.
paya	swamp, marsh.
payah	1 tired. 2 difficult, troublesome. 3 finding. s.t. troublesome.
payang	1. large net. support s.o. in walking.
payar	cruise back and forth.
payau	1 brackish. 2 salty, briny.
payit	see palit 1.
payon	shed, lean-to.
payu	(java) in demand, sought after.
payudara	(lit.) (female) breast.
payung	1 umbrella. 2 parachute.
pb	[pengurus besar] executive board.
pbb	[perserikatan bangsa-bangsa] united nations.
pbe	[pasaran bersama eropah] european common market.
pbf	[pedagang besar farmasi] major pharmaceutical supplier.
pbh	[pemberantasan buta huruf] literacy campaign.
pc.	[pour condoleance] legend written on cards expressing condolences.
pd	1. [perang dunia] world war. 2. [pejabat] acting. 3. [pendidikan jasmani] physical education. 4. [perusahaan dagang] trading company.
pd&k	[(departmen) pendidikan dasar dan kebudayaan] department of basic education and culture.
pdam	[perusahaan daerah air minum] municipal waterworks.
pdank	[pendidikan dan kebudayaan] department of education and culture.
pdi	[partai demokrasi indonesia] indonesian democratic party.
pdn	[perusahaan dagang negara] state commercial enterprise.
pdt.	[pendeta] (rel.) minister.
peang	1 flat (of head). 2 (jakarta) worn off.
pebean	/pebian/ see pabean.
pebila	see apabila.
pebruari	february.
pecah	1 broken, smashed. 2 be divided (in opnion). 3 crockery.
pecahan	1 piece, frament, splinter. 2 fraction.. 3 utensils made of glass or porcelain. 4 s.t. broken up on s.t. else.
pecai	vegetable similar to mustard greens.
pecak	1 damaged, dented, flat. 2 blind in o. eye.
pecal	1. squeeze, massage. 2. see pecel.
pecat	fired, dischaged.
peceklik	see paceklik.
pecel	salad made of blanched vegetables served with peanut sauce.
peci	see pici.
pecik	arise.
pecinan	(coll.) chinatown.
pecok	1. dented. 2. (java) axe.
pecomberan	see comberan.
pecun	see pekcun.
pecundang	be beaten (in a contest).
pecut	whip.
peda	fish preserved in wet salt.
pedadah	chest (of medicine, cosmetics).
pedagang	see dagang 2.
pedagog	pedagogue.
pedagogi	/pedagogik/ pedagogy.
pedagogis	pedagogical.
pedah	see faedah.
pedal	pedal.
pedalaman	see dalam.
pedanda	balinese priest.
pedang	sword.
pedar	rancid.
pedas	1 hot, highly seasoned and spiced. 2 severe, biting.
pedat	see padat.
pedati	horse-drawn cart.
pedato	see pidato.
pede	see pd3.
pedel	marshall, leader of an academic procession. /pe`de`l/ (jakarta) flat.
pedengan	1 screen, cover. 2 pseudonym. 3 hypocrisy.
pedes	see pedas.
pedet	(java) calf, heifer.
pediatri	/pediatrik/ (med.) pediatrics.
pediatris	pediatrician.
pedih	1 smarting. 2 poignant.
pedis	1. pedas. 2. see pedih.
pedit	see medit.
pedoman	1 compass. 2 orientation. 3 manual, directive. 4 catalog, bulletin of a university.
pedot	(java) broken off, in two.
pedu	see empedu.
peduli	1 pay attention, care about. 2 i do not care.
pedulian	indifferent.
pedupan	see dupa.
pedusi	(m) woman, female.
pedut	1. sticky rice. 2 (java) mist, fog.
peduta	see duta.
peer	see pr 2.
peg.	1. [pegunungan] mountains. 2. [pegawai] employee.
pegagan	vine with edible leaves, often planted on sides of rice field bunds to prevent erosion..
pegal	1 stiff, painful (of muscles after overuse). 2 weary, weariness. 3 annoyed, vexed, fed up.
pegang	hold on.
pegar	pheasant.
pegari	visible.
pegas	1 spring. 2 carpet beater. 3 pedal in car. 4 brake.
pegat	mem-pegat 1 stop, block. 2 intercept, interrupt. 3 divorce, break off engagement with.
pegawai	1 official, gvt. employee. 2 employee, worker.
pegel	see pegal.
pegepe	see pgp.
pegi	see pergi.
pegimana	(coll.) see bagaimana.
pegon	javanese written in arabic characters.
pegulat	wrestler.
pegunungan	mountain range.
peguyuban	see guyub 1.
pehak	see pihak.
pehcun	see pelcun.
pehong	1 nasty. 2 k.o. venereal disease.
pejabat	functionary, official.
pejajap	buginese war prow.
pejajaran	(jakarta) 1 evil spirit. 2 damn it !.
pejal	1 solid, firm (esp. of earth). 2 massive.
pejam	closed (of eyes).
pejera	sight of a weapon.
pejet	see pijat.
pejompongan	see jompong.
peju	semen, sperm.
pejuang	pejuang
pek	1. (china) hundred (mainly used in commercial transactions). pek-go 150. pek-go ceng 150,000. 2. /pi/ see pik. 3. see empek.
peka	sensitive.
pekah	see nafkah.
pekaja	(lit.) lotus.
pekak	deaf.
pekakak	kingfisher.
pekakas	see perkakas.
pekam	brake.
pekan	1 (weekly) market. 2 week. 3 period certain events are held or the events themselves.
pekarangan	yard.
pekasam	relish made of meat, fish, or fruit preserved in vinegar or salt and kept for some time.
pekat	1 thick, concentrated. 2 tough. 3 strong (of coffee).
pekau	scream.
pekban,pekcap,pekceng	see pik.
pekcun	(china) the dragon-boat festival on 5th day of 5th lunar month.
pekerja	worker, laborer, employee.
pekerjaan	1 work, task, activity. 2 job, occupation. 3 operation, working, action (of medicine, a chemical, liquor).4 celebration, feast (a wedding, anniversary, etc.). 5 endeavor. 6 employment.
pekerti	1 character, nature. 2 bad character.
pekgo	see pek 1.
pekik	yell, scream.
peking	whine, howl.
pekir	see apkir, fakir.
pekis	utter a shrill cry.
pekiwan	(java) toilet.
pekojan	1 arab trader. 2 area where merchants live.
pekoleh	efficient.
pektai	(china) leukorrhea.
pektiau	see pik.
pekuburan	cemetery. graveyard.
pekuk	deformed (of hand or foot).
pekung	1 foul-smelling ulceration. 2 tumor.
pekuper	[pelaksana kuasa perang] military authority under wartime conditions.
pekur	muse, meditate.
pel	1. field. 2. kain-pel mop. 3. see pil.
pel-	see also entries with pl-.
pelabaya	hangman, executioner.
pelabi	1 excuse, alibi. 2 dishonest trick.
pelabuhan	1 anchorage. 2 harbor, port, dock.
pelabur	ration, portion.
pelaburan	recurfacing (of road, street).
pelacur	whore, prostitute.
pelacuran	prostitution.
peladang	o. who works or owns such a field.
peladen	waiter, servant.
pelaga	see kapul.
pelah	speech impediment.
pelajar	/pelajaran/ secondary school student.
pelajaran	1 lesson, course. 2 training.
pelak	1. k.o. evil spirit. 2 there is no mistake. 3 not be able to escape from. /pe`lak/ see pelek.
pelakat	see plakat.
pelakon	1 actor, actress. 2 performer. 3 doer.
pelaksana	1 implementer, executor, organizer. 2 producer. 3 manager, director.
pelaksanaan	1 carrying out of s.t., realization. 2 implementation.
pelaku	1 doer, agent. 2 (ling.) subject. 3 (thea.) performer, cast.
pelali	o. who is forgetful.
pelamar	1 suitor. 2 applicant.
pelambung	pitcher, thrower.
pelaminan	dais on which the bridal couple sits.
pelampang	pavilion for outdoor entertainment.
pelampiasan	release.
pelampung	1 float (on fishing line). 2 float, buoy.
pelan	1 slow. 2 soft (of voice). see perlahan. /pe`lan/ see pel1.
pelana	saddle.
pelanan	slower, more slowly.
pelancong	tourist, sight-seer.
pelanduk	mouse deer.
pelanel	flanel.
pelang	see plang.
pelanggaran	1 infraction, violation (of a rule, law). 2 trespass. 3 infringement (on a patent).
pelangi	rainbow.
pelangki	/pelangkin/ palanquin.
pelangkin	tar, pitch.
pelantak	1 piston rod. 2 ramrod. 3 ram, jackhammer.
pelantar	platform.
pelantaran	1 unroofed platform attached to house. 2 long bench. 3 scaffolding.
pelanting	roll everywhere.
pelapah	see pelepah.
pelapor	1reporting. 2 commentary.
pelapukan	1 weathering. 2 corrosion.
pelas	tie ropes together.
pelastik	see plastik.
pelasuh	lazy person.
pelat	1 metal sheet. 2 license plate. 3 (coll.) phonograph record. /pe`lat/ 1 speech defect. 2 speak with an accent.
pelata	mackerel.
pelatah	see latah 1.
pelatnas	[pemusatan latihan national] centralization of national training (for sports).
pelatuk	1 woodpecker. 2 trigger.
pelawak	comedian, jokester.
pelayan	1 waiter, waitress. 2 sales clerk. 3 attendant.
pelayat	o. who pays his respects to the family of the deceased.
pelayatan	condolence visit.
pelbagai	various, all sorts of. see bagai.
pelbak	refuse bin.
pelbed	/pelbet/ see felbet.
pelbegu	pagan, animist.
pelda	[pembantu letnan dua] lower second lieutenant.
pelebaya	see pelabaya.
peleceh	flatterer.
pelecehan	act of despising, insulting.
pelecok	sprained.
peledakan	explosion.
pelek	/pele`k/ see plek. /pe`lek/ rim of wheel.
pelekat	see plakat. /pele`kat/ sarong with plaid pattern.
pelekok	twisted.
pelekuh	crooked.
pelembungan	(java) 1 balloon. 2 blown up gizzard.
pelembutan	softening, toning down.
pelempap	breadth of the hand.
pelemparan	1throwing, hurling. 2 ejection.
pelencit	1 being pressed. 2 be projected by being filiped.
pelengak	(jakarta) surprised.
pelengan	(anat., jakarta) temples.
pelengkap	1 complement. 2 supplement.
pelengsong	(jakarta) deviate.
pelepah	stem and midrib of palm, banana leaves, stem of the banana bunch.
peler	see pelir.
pelerai	1 o. who moderates. 2 o. who breaks up fights.
peleraian	1 separation . 2 (mil.) disengagement.
peles	see ples.
pelesapan	deletion.
pelesat	dart away.
peleset	see leset.
pelesir	1 take a trip. 2 go out for pleasure. 3 pleasure, amusement.
pelesit	1 locust. 2 a spirit that sucks blood of unborn or newborn children.
pelestarian	1 perpetuation. 2 preservation, conservation.
pelet	k.o. magic whereby a person is made to fall in love.
peletak-peletik	make high-pitched knocking noise.
peletak-peletok	make a knocking noise.
peleton	platoon.
pelihara	1 take care of, protect. 2 raise, rear. 3 keep, maintain.
peliharaan	1 things to be protected, cared for . 2 mistress. 3 pet, inmate (of zoo).
pelik	1 peculiar, remarkable. 2 complicated.
pelikan	1. mineral. 2. pelican.
pelikat	see pelekat.
peliket	(java, jakarta) sticky.
pelimbahan	garbage dump, junkyard.
pelincir	lubricant.
pelinggam	colored marble.
pelintang	(java) catapult.
pelintat-pelintut	see plin-plan.
pelintir	twist.
pelipir	edge.
pelipis	/pelipisan/ (anat.) temples.
pelipit	hem.
peliput	reporter.
pelir	penis.
pelisir	pleat, pleated.
pelit	stingy.
pelita	1 oil lamp. 2 light (in metaphorical sense).
pelitur	varnish, polish furniture.
pelni	[pelayaran nasional indonesia] national shipping lines.
pelo	1 lisp, bable. 2 have a speech defect.
pelog	(java) seven-tone gamelan scale.
pelojok	see pelosok.
peloksok	see ploksok.
pelolosan	escape.
pelomba	1 contestant, competitor. 2 athlete.
pelonci	freshman girl.
pelonco	o. who is about to get a new status (e.g. as member of entering class, fraternity, etc.), freshman, pledge.
pelonggaran	relaxing.
pelonjakan	rise, jump (in production, price, etc.).
pelontos	bald and shiny (head).
pelopor	1 pioner. 2 vanguard, forerunner. 3 (mil.) shock troops. 4 ranger, scout.
pelor	bullet.
pelosok	1 outlying place, remote spot. 2 corner.
pelosot	1 fall down. 2 go down in price.
pelota	jai-alai ball.
pelotaris	jai-alai player.
peloton	see peleton.
pelotot	m-(p)elotot be big (of eyes). mem-pelotot-i look at with big eyes.
pelpen	measurement used by bricklayer to straighten wall.
pelples	canteen, water container.
pelpolisi	rural constabulary.
pelu	see peluh 1.
peluang	1 opportunity. 2 quiet (of wind).
peluberan	overflowing (of water, etc.).
pelucu	wag, wit, jokester.
pelud	[pelabuhan udara] airport.
peluh	1. impotent. 2. perspiration, sweat.
peluit	1 a whistle (device). 2 whistle (sound).
peluk	1 embrace. peluk-cium a hug and a kiss. 2 measurement of length of approximately o. fathom.
pelumur	lubricant.
pelumuran	1 staining, smearing. 2 pollution.
peluntur	laxative.
pelupa	forgetful person, s.o. absent-minded.
pelupuk	cover, wrapper. kelopak-mata eyelid.
peluru	1 bullet. 2 projectile, missile. 3 (sport) shot-put.
peluruh	emetic.
pem-	see also entries with p-, m-.
pemabuk	drunkard, a drunk.
pemadah	religious person.
pemadam	s.t. that extinguishes.
pemadaman	extinguishing, putting out (of fire).
pemahaman	comprehension.
pemahatan	sculptor, carver.
pemain	player, actor.
pemakai	1 user, consumer. 2 wearer.
pemakaian	1 use, consumption. 2 application, usage.
pemakaman	funeral, burial, interment.
pemakan	1.eater 2.consumer.
pemalas	sluggard, lazy person
pemali	pemali
pemampas	compensation.
pemanah	archer.
pemanas	heater.
pemancar	1 fountain. 2 radio or tv transmitter. 3 radiator.
pemancaran	action of broadcasting, radiating, emitting.
pemandian	bathing place.
pemangkas	barber.
pemangku	1 manager. 2 functionary.
pemanis	1 sweetener. 2 cosmetics. 3 decoration.
pemantapan	stabilization, consolidation.
pemantik	pemantik
pemasaran	marketing.
pemasok	supplier.
pemasukan	1 registration, entering. 2 import. 3 introduction. 4 income.
pematah	see pepatah.
pematang	bund, dike between rice fields.
pemb-	see also entries with b-.
pembabaran	1 spread, development. 2 account, statement. 3 expose.
pembagian	1 distribution. 2 (math.) division. 3 allotment, division. 4 sharing, share.
pembalap	racer.
pembalasan	1.reply,replying,response,responding2.recompense 3.revenge, retribution,retaliation,reprisal.
pembangkitan	generation (of energy).
pembantu	1 helper, assistant. 2 (domestic) servant. 3 (leg.) accessory, accomplice. 4 stringer (in journalism).
pembatak	1 plunderer, pillager, robber . 2 soldier of fortune , adventurer .
pembatas	1 diveider, circuit breaker. 2 restraint (of trade).
pembatasan	1 restriction. 2 delimitation. 3 curtailment.
pembawaan	1 nature , character , temperament. 2 talent , gift 3 transporting , delivery 4 result , consequence .
pembayatan	hazing.
pembela	protector.
pembelaan	1 act of caring for s.o. 2 protection.
pembelanja	shopper.
pembelanjaan	financing.
pemberangkatan	sending off, dispatch.
pemberhentian	/pembrentian/ 1 discharge, disimissal. 2 stoppage.
pemberi	giver, donor, bestower.
pemberian	1 gift, present. 2 conferral, awarding, bestowal (of degree). 3 distiibution, act of distributing. 4 issue. 5 giving, extending.
pemblokiran	blockading.
pemda	[pemerintahan daerah] local gvt.
pemelihara	1 caretaker. 2 nurseryman.
pemeliharaan	1 care, maintenance.2 rearing, cultivation. 3 safeguarding.
pemenang	winner.
pemenggalan	cutting off the top or head.
pementasan	1 showing, presentation. 2 staging.
pemeo	see pameo.
pemeragaan	exhibit.
pemerah	1. milker. 2. reddening agent.
pemeras	1 press. 2 exploiter.
pemerasan	1 pressing, squeezing. 2 extortion. 3 exploitation.
pemerata	s.t. that causes even distribution.
pemerataan	even distribution.
pemerhati	observer (for the purpose of study, etc.).
pemeriksa	1 investigator, inspector. 2 ( leg.) cross-examiner.
pemeriksaan	1(leg.) investigation, inspection. 2 (leg.) cross-examination, interrogation. 3 checkup, examination.
pemerintahan	gvt, administration.
pemetaan	1 cartography. 2 mapping.
pemetik	1 picker. 2 switch, trigger.
pemetikan	picking, gathering.
pemikatan	s.t. that entices, decoy.
pemilah	sorter.
pemilahan	process of sorting.
pemilik	owner, proprietor.
pemilikan	ownership, possession.
pemilu	[pemilihan umum] general elections.
pemimpi	1 dreamer. 2 escapist.
peminat	devotee, interested person.
peminta-minta	begger.
pemintal	1 o. employed in making thread or twine. 2 spinning wheel.
pemintalan	1 spinning. 2 spinning wheel.
pemisah	1 arbiter. 2 referee. 3 s.t. that separates.
pemisahan	1 separation (of coiple). 2 isolation. 3 discrimination.
pemogok	striker.
pemogokan	strike.
pemondok	boarder, tenant.
pemondokan	lodgings.
pemotongan	1 butchering, slaughtering. 2 process of cutting, truncation.
pemotret	photographer.
pemotretan	photography.
pemp-	see also entries with p-.
pemrasaran	see prasaran.
pemuaian	expansion.
pemuda	see muda.
pemudah	1 easygoing. 2 o. who is easygoing.
pemudi	young woman, girl.
pemujaan	1 place of sacrifice, temple. 2 worship, veneration.
pemuka	leader, promoter.
pemukul	1 hammer, cudgel, beater. 2. o. who strikes.
pemula	1 initiator, originator. 2 beginner.
pemulangan	1 return, restitution. 2 repatriation.
pemunduran	pulling s.t. back.
pemungut	collector.
pemungutan	1.harvest 2.collection 3.adoption.
pen	1. 1) pin for holding s.t. together in surgery. 2) peg or dowel for joining wood or bamboo. 3) grenade pin. 2. pen-atom ballpoint pen.
pen-	see also entries with t-, n-.
pena	1 writing pen. 2 quill.
penabrak	s.o. who collides, esp. a driver.
penabuh	o. who strikes such a drum.
penabung	a depositor.
penabungan	1 savings. 2 process of saving money, setting aside s.t.
penabur	sower, spreader.
penaburan	diffusion, strewing.
penad	[penerangan angkatan darat] army information (office).
penadah	1 container, receptacle. 2 buyer of stolen goods. 3 (sport) catcher. 4 (sport) a bat.
penadahan	1 process of storing liquids, etc. 2 passing on or buying of stolen goods.
penadbir	manager.
penadbiran	administering, managing.
penaga	see kayu 1.
penagih	creditor, dunner.
penagihan	pressing a claim.
penahan	s.o. or s.t. that restrains or resists.
penahanan	1 restraint. 2 detention, arrest.
penajaman	1 sharpening. 2 exacerbation.
penak	see enak.
penaka	as, for instance.
penakaran	act of measuring out.
penakawan	see punakawan.
penakluk	conqueror, subjugator.
penaksir	appraiser.
penaksiran	appraising, evaluation.
penakut	coward, s.o. fainthearted.
penal	[penerangan angklatan laut] navy information (office).
penala	tuning fork.
penalaran	reasoning, intellectual activity.
penali	1 binder. 2 (lit.) conclusion.
penalti	(sport) penalty.
penambah	1 (math.) enumerator, counter. 2 addition, extra..
penambahan	increment, increasing.
penambal	1. o. who patches. 2 s.t. to patch with.
