payroll	kb. daftar gaji/upah.
pct.	1 [per cent] persen. 2 [precinct] seksi.
pd.	[paid] telah dibayar, lunas.
pea	kb. kacang polong/arab. green peas kacang ijo/buncis, ercis.
peace	kb. 1 perdamaian. world p. perdamaian dunia. peace-loving ks. yang cinta akan perdamaian.
peaceable	ks. suka damai. -peaceably kk. dengan tenang/damai.
peaceful	ks. 1 tenang. it's so p. here sangat tenang disini. 2 tenteram, damai. by p. means dengan cara-cara damai.
peacemaker	kb. pendamai.
peacetime	kb. masa damai. p. army tentara dalam masa damai.
peach	kb. 1 (buah) persik. 2 sl.: yang ulung, hebat, sangat baik.
peachy	ks. sl.: hebat, bagus benar.
peacock	kb. merak.
peak	kb. 1 puncak (of a mountain, career). 2 ujung (of flagpole). 3 bubungan, nok (of roof). -ks. tertinggi, maksimum. -kki. mencapai puncak. p. hours puncak kesibukan.
peal	kb. 1 gemuruh (of thunder). 2 gelak tertawa. 3 bunyi. -kkt. mengumandangkan, -kki. berdentang-dentang (of bells).
peanut	kb. kacang tanah. p. brittle rempeyek, kacang gula. p. butter pindakas, sele kacang. sl.: p. gallery balkon. roasted peanuts kacang goreng.
pear	kb. buah per. pear-shaped ks. berbentuk buah per, bulat.
pearl	kb. mutiara. p. barley beras belanda. p. diver penyelam mutiara. p. diving penyelaman mutiara. p. oyster kerang mutiara.
pearly	ks. seperti mutiara (of teeth).
peasant	kb. tani, petani.
peasantry	kb. kaum tani.
peat	kb. tanah gemuk yang dipakai sebagai bahan pembakar. p. moss lumut bahan pembakar.
pebble	kb. batu kerikil/koral.
pecan	kb. semacam kemiri.
peccadillo	kb. dosa kecil.
peck	1 takar (=71/2 liters). 2 inf.: cium cepat. 3 banyak. -kkt. mematuk (a hole). 2 mematuk-matuk (of a bird).
pectoral	ks. yang berkaitan dengan dada. p. fin sirip dada. p. muscle otot-otot dada.
peculiar	ks. 1 ganjil. 2 aneh. 3 khas. -peculiarly kk. secara khusus/istimewa.
peculiarity	kb. (j. -ties) 1 sifat yang aneh. 2 keganjilan, keanehan. 3 kepelikan.
pecuniary	ks. yang berkaitan dengan uang. p. p.needs kebutuhan-kebutuhan keuangan.
pedagogical	ks. yang berkaitan dengan pedagogi/pendidikan. a p. device sebuah alat mendidik.
pedagogue	kb. ahli mendidik.
pedagogy	kb. pedagogi, ilmu mendidik.
pedal	kb. pedal. gas p. pedal/tancapan bensin. 2 injak-injakan, dayung (of bicycle). -kkt., kki. mengayuh.
pedant	kb. 1 orang yang bersifat keilmu-ilmuan. 2 orang yang suka menonjolkan ketinggian ilmunya.
pedantic	ks. suka menonjolkan keilmuannya.
pedantry	ks. (j. -ries) sifat suka menonjolkan keilmuan.
peddle	kkt. menjajakan. -kki. berjaja, berjual-keliling. -peddling kb. penggalasan keliling.
peddler	kb. penjaja, penjual/penggalas keliling.
pederasty	kb. semburit, perjantanan.
pedestal	kb. tumpuan, lapik, alas. to place women on a p. memuja kaum wanita.
pedestrian	kb. pejalan kaki. p. cross-walk tempat menyeberang (jalan). -ks. biasa saja. his writing is p. karangannya biasa saja.
pediatrician	kb. dokter anak-anak.
pediatrics	kb. ilmu kesehatan anak-anak.
pedicab	kb. becak.
pedicure	kb. pengobatan dan pemeliharaan kaki.
pedigree	kb. silsilah, asal-usul. pedigreed horse kuda keturunan baik.
pee	kki. vulg.: kencing.
peek	kb. pengintipan(sejenak). take a p. at the baby tolong tengok bayi itu. -kki. mengintip, menengok (sejenak).
peek-a-boo	kb. main cilukba/sembunyi-sembunyian.
peel	kb. kulit (of banana, orange). -kkt. mengupas, menguliti (apple, orange). -kki. mengelupas. -kki. 1 (undress) menanggalkan diri. 2 menggelekak (of paint). 3keluar (of a plane from formation). -peeling kb. kupasan.
peeler	kb. alat pengupas.
peep	kb. 1 tengok. to take a p. at melihat. 2 ciapan, ciak (of a bird, chick). -kki. 1 mengintip (at kepada). 2 mencicit, menciak (of a bird). to p. out muncul.
peeper	kb. 1 pengintip. 2 inf.: kaca. 3 inf.: teropong. 4 inf.: kacamata.
peephole	kb. lubang mengintip/intipan.
peer	kb. kawan sebaya. without p. tak berbanding. -kki. memandang dengan tajam. to p. at memandang dengan tajam, menatap(i). to p. over mengintai dari.
peerless	ks. tak ada bandingannya/taranya. p. performance pertunjukan yang tak ada taranya.
peeve	kb. sesuatu yang menjengkelkan. -kkt. mengesalkan. to be peeved by merasa kesal terhadap.
peevish	ks. kesal, jengkel, marah, suka mengeluh.
peewee	kb. orang kecil. -ks. kecil, kerdil, katek.
peg	kb. 1 pasak. 2 taraf. -kkt. (pegged) 1 memancangkan (a net, pole). 2 menetapkan (the price of s.t.). 3 melemparkan.
pejorative	ks. merendahkan, memburukkan.
pelican	kb. burung undan.
pellagra	kb. penyakit disebabkan makanan yang kurang baik, menyebabkan kulit gatal, gugup, dan kadang-kadang agak gila.
pellet	kb. 1 pil, butir (of food). 2 peluru, mimis (of shot).
pellmell	kb. kacau-balau, pontang-panting. -kk. to rush p. for the exit berlari dengan kacau balau menuju jalan keluar.
pelt	kb. kulit bulu. -kkt. 1 melempari (seseorang). 2 menghujani (s.o. with questions). 3 memukuli (of hail, sleet, rain).
pelvic	ks. yang mengenai panggul. p. region bagian tubuh pada panggul.
pelvis	kb. panggul, rongga (tulang) pinggul.
pen	kb. pena. 2 kandang (of children, hogs). 3 sl.: penjara. -kkt. (penned) 1 menulis. 2 mengurung (a dog).
pen., pen	[peninsula] semenanjung.
penal	ks. mengenai hukum. p. code undang-undang/hukum pidana. p. servitude hukuman kerja keras/paksa.
penalize	kkt. menghukum, memidanakan.
penalty	kb. (j. -ties) 1 hukuman. 2 sport : penalti.
penance	kb. penebusan dosa. to do p. menjalankan penebusan dosa.
penchant	kb. kecondongan, kegemaran.
pencil	kb. potlot, pensil. eyebrow p. penghitam alis. -kkt. menulis (a note).
pendant	kb. anting-anting.
pending	ks. menunggukan, menantikan. -kd. seraya menantikan (keputusan/kedatangan seseorang). p. his return seraya menantikan kedatangannya kembali.
pendulous	ks. terjumbai, tergantung.
pendulum	kb. bandul, buaian.
penetrable	ks. 1 dapat ditembus/diselami. 2 dapat diduga/dipahami.
penetrate	kkt. 1 menembus (of sound). 2 merembes (of water). -kki. merasuk. -penetrating ks. tajam, menusuk (of wind, sound, criticism).
penetration	kb. 1 penembusan (of a bullet). 2 perembesam (of water, of people). (into ke). 3 (economic, cultural) penetrasi.
penguin	kb. semacam angsa di lutub selatan, penguin.
penicillin	kb. penisilin.
peninsula	kb. semenanjung, jazirah. the malay p. semenanjung malaya.
peninsular	ks. merupakan sebuah semenanjung/jazirah.
penis	kb. 1 zakar, batang kemaluan lelaki, batang pelir. 2 burung (of boys).
penitence	kb. rasa sesal, sesalan.
penitent	ks. (sangat) menyesal.
penitentiary	kb. (j. -ries) penjara.
penknife	kb. (j.-knives) pisau lipat.
penmanship	kb. keahlian menulis indah, tulisan indah.
penn(a).	[pennsylvania] negarabagian a.s.
pennant	kb. panji.
penniless	ks. tanpa/tak beruang sepeserpun.
penny	kb. (j. -nies) sen dolar. penny-wise ks. hemat, hidup berhemat.
penology	kb. ilmu pidana, penologi.
penpoint	kb. ujung/mata pena.
pension	kb. pensiun. p. fund dana pensiun. -kkt. memensiunkan.
pensioner	kb. 1 (civilian) orang pensiunan, purnakaryawan. 2 mil.: purnawirawan.
pensive	ks. termenung-menung, tafakur.
pent-up	ks. 1 terkurung. 2 tertahan. p.-up emotions emosi-emosi/perasaan-perasaan yang terpendam.
pentagon	kb. segilima, sisilima.
pentameter	kb. sanjak bersuku lima (dalam tiap baris).
pentateuch	kb. lima buku pertama dari kitab perjanjian lama (injil).
pentathlon	kb. pancalomba.
pentecost	kb. pantekosta.
penthouse	kb. kamar atau ruang tempat tinggal di atap.
penultimate	kb., ks. yang kedua dari belakang.
penurious	ks. kikir, pelit.
peony	kb. (j. -nies) semacam tumbuh-tumbuhan semak yang berbunga bagus dan sering ditanam.
people	kb. 1 orang-orang. how many p. ? berapa orang ? 2 rakyat. 3 bangsa, 4 anak negeri. 5 sanak keluarga, suku. -kkt. mendiami, menempatkan penduduk. -peopling kb. penempatan penduduk/penghuni.
pep	kb. semangat, enersi. full of p. penuh semangat. -kkt. (pepped) memberi semangat. to p. s.o. up menambah/menghidupkan semangat seseorang.
pepper	kb. 1 lada. 2 merica. -kkt. 1 membumbui dengan merica. 2 menghujani (a speaker with questions). p. mill gilingan merica. p. shaker penabur merica.
peppercorn	kb. biji merica.
peppermint	kb. permen.
peppery	ks. 1 pedas (of food). 2 penaik darah, lekas marah (of a person).
peppy	ks. inf.: segar, penuh semangat.
pepsin	kb. pepsin.
peptic	ks. p. ulcer bisul perut, radang dinding lambung.
per	kd. setiap, tiap(-tiap), saban. 50 cents p. dozen 50 sen setiap lusin. p. person setiap orang.
perambulator	kb. kereta bayi.
perceivable	ks. dapat dipahami/dirasakan/dilihat dengan jelas.
perceive	kkt. merasa. she perceived that she was being observed ia merasa bahwa orang memperhatikan dirinya.
percentage	kb. 1 persentase, per seratus. 2 sl.: keuntungan. 3 bagian. only a small p. hanya sebagian kecil. the p. of carbon dioxide sejumlah kadar arang.
perceptible	ks. 1 nampak, jelas. p. improvement perbaikan yang nampak. 2 dapat dimengerti. p. difference perbedaan yang dapat dimengerti.
perception	kb. 1 penglihatan. 2 tanggapan daya memahami/menanggapi sesuatu.
perceptive	ks. 1 cerdik, lekas mengerti. 2 berhubungan dengan pengertian. a. very p. individual orang yang cerdas sekali.
perch	kb. 1 tenggeran (of a bird). 2 tempat ketinggian, tempat yang agak tinggi. 3 semacam ikan merah. -kki. bertengger (on diatas).
perchance	kk. secara kebetulan. if, p... jika sekiranya....
percolate	kki. menapis (dalam cerek) (of coffee).
percolator	kb. cerek penepis/perecik/penyaring kopi.
percussion	kb. pukul, ketuk. p. cap sumbu mesiu. p. instrument tabuh-tabuhan.
peregrination	kb. perjalanan.
peremptory	ks. pasti, menentukan, tak dapat dirubah.
perennial	kb. tumbuh-tumbuhan yang tetap hijau. -ks. 1 abadi, kekal. 2 bertahun-tahun.
perf.	[perfect] sempurna.
perfect	kb. gram.: waktu yang telah sempurna/selesai. -ks. 1 sempurna. 2 sepenuhnya. 3 benar-benar. 4 lengkap, utuh (of set of dishes). 5 gram.: yang sudah dilakukan. -kkt. menyempurnakan. -perfectly kk. 1 dengan sempurna. 2 benar-benar. 3 sama sekali.
perfection	kb. 1 kesempurnaan (of a civilization). to strive for p. berusaha kearah kesempurnaan. 2 penyempurnaan (of plans).
perfidy	kb. (j. -dies) khianat, kedurhakaan.
perforate	kkt. melubangi (a sheet). -perforated ks. penuh dengan lubang-lubang. p. stamps perangko-perangko yang berlubang-lubang.
perforation	kb. 1 perforasi, pembubuhan lubang-lubang (of s.t.). 2 lubang kecil (in s.t.).
perforce	kk. terpaksa.
perform	kkt. 1 melakukan, menyelenggarakan (operation, a feat, marriage ceremony). 2 memainkan (a role). -kki. main (on the stage).
performance	kb. 1 pertunjukan. 2 perbuatan. 3 dayaguna, prestasi, hasil. 4 pelaksanaan, penyelenggaraan. 5 pergelaran (of wayang, play).
performer	kb. 1 thea.: pemain sandiwara, pelaku. 2 sport : pemain.
perfume	kb. minyak harum/wangi, wangi-wangian. -kkt. memberi wangi-wangian pada.
perfunctory	ks. 1 acuh tak acuh, tak bersungguh-sungguh. 2 asal saja.
perhaps	kk. barangkali, boleh jadi, mungkin.
pericardium	kb. kantong/selaput jantung.
peril	kb. risiko, bahaya. to do s.t. at o's own p. melakukan sesuatu atas risiko sendiri.
perilous	ks. membahayakan, penuh bahaya.
perimeter	kb. 1 garis keliling, lingkaran. 2 batas pinggir (of a yard). 3 mil.: garis pertahanan.
perineum	kb. med.: kerampang.
period	kb. 1 titik. 2 habis perkara. 3 masa, waktu. 4 zaman. p. play sandiwara yang menggambarkan suatu jaman tertentu.
periodic	ks. berkala, pada waktu-waktu tertentu. p attacks of asthma serangan-serangan berkala penyakit asma.
periodical	kb. majalah. -periodically kk. pada waktu-waktu tertentu, kadangkala.
peripatetic	ks. yang berjalan berkeliling.
peripheral	ks. 1 sekeliling (of vision, area). 2 tak mengenai pokoknya (of a discussion).
periphery	kb. (j. -ries) keliling, batas luar.
periscope	kb. periskop.
perish	kki. binasa, mati, tewas. many perished in the fire banyak orang yang binasa dalam kebakaran itu.
perishable	kb. perishables j. barang-barang yang tak tahan lama. -ks. dapat/mudah menjadi busuk (of food).
peristalsis	kb. gerak peristaltik.
peritoneum	kb. selaput perut.
peritonitis	kb. radang selaput perut.
perjure	kkt. to p. o.s. melakukan sumpah palsu.
perjurer	kb. orang yang bersumpah palsu.
perjury	kb. (j. -ries) sumpah palsu.
perk	kki. inf.: menetes, merembes, merecik (of coffee).
perky	ks. keren, gagah, megah.
permanence	kb. ketetapan, keabadian.
permanent	kb. keriting permanen. -ks. tetap, kekal, permanen. -permanently kk. secara tetap, untuk selama-lamanya.
permeable	ks. dapat ditembus (air).
permeate	kkt. menyerap, meresap, merembes, menembus.
permissible	ks. diizinkan, diperbolehkan. is it p. to...? apakah diizinkan untuk...?
permission	kb. izin, permisi. with your p. mohon permisi, dengan seizin saudara.
permissive	ks. serba membolehkan, suka mengizinkan. p. parents orang tua yang serba membolehkan.
permit	kb. surat izin. exit p. surat izin keluar. -kkt. (permitted) mengizinkan, membolehkan.
permutation	kb. biol.: permutasi (of genes). 2 perubahan urutan (angka-angka).
pernicious	ks. jahat, merusak (of a habit).
peroxide	kb. peroksid(a).
perpendicular	kb. garis tegak lurus. -ks. tegaklurus.
perpetrate	kkt. melakukan (a crime, fraud).
perpetrator	kb. pelaku, pelaksana (kejahatan).
perpetual	ks. 1 terus-menerus, tak henti-henti. p. motion gerak terus-menerus. 2 kekal, abadi.
perpetuate	kkt. mengabadikan, mengekalkan, menghidupkan terus-menerus (a name, memory).
perpetuity	kb. kb. (j. -ties keabadian, kekekalan. in p. untuk selama-lamanya.
perplex	kkt. membingungkan. the problem perplexes him soal itu membingungkannya. -perplexing ks. membingungkan, mengejutkan.
perplexity	kb. (j. -ties) kebingungan.
perquisite	kb. 1 penghasilan tambahan. 2 keuntungan.
pers.	1 [person] orang, oknum. 2 [personal] pribadi.
persecute	kkt. 1 menyiksa, menganiaya. 2 menggoda.
persecution	kb. penyiksaan, penganiayaan, penghambatan.
persecutor	kb. penyiksa, penganiaya.
persentile	kb. bagian per seratus.
perseverance	kb. ketekunan, kekerasan hati.
persevere	kki. bertekun (in dalam), gigih. -persevering ks. tekun, keras hati, berkanjang.
persian	kb. 1 orang iran. 2 bahasa iran. p. cat kucing persia. p. rug babut buatan iran.
persimmon	kb. kesemak.
persist	kki. 1 tetap melakukan. 2 berlangsung (lama), berkanjang. 3 tahan.
persistence	kb. ketekunan. the p. of the illness sakit yang terus-menerus.
persistent	ks. 1 keras hati, gigih, berkanjang. 2 menetap (of a cough, cold, headache). -persistently kk. secara terus-menerus.
persnickety	ks. inf.: cermat sekali, rewel.
person	kb. 1 orang. 2 oknum. 3 gram.: persona. person-to-person ks. dari orang ke orang (of a phone call).
persona non grata	orang yang tidak disukai.
personable	ks. menarik, tampan, rupawan.
personage	kb. orang (yang) terkemuka, tokoh.
personal	ks. 1 pribadi. p. belongings barang-barang milik pribadi/perseorangan. 2 perseorangan. -personally kk. sendiri.
personality	kb. (j. -ties) 1 kepribadian. attractive p. kepribadian yang menarik. 2 tokoh.. well-known p. films tokoh layar putih yang terkenal.
personalize	kkt. membuat menurut selera atau ukuran tertentu. personalized stationery alat tuis-menulis yang dibuat menurut selera/ukuran tertentu.
personification	kb. penjelmaan, pengejawantahan.
personify	kkt. (personified) mewujudkan, menjelmakan, mempribadikan, melambangkan. he is generosity personified pribadinya mewujudkan kemurahan hati. ia melambangkan kebaikan.
personnel	kb. personalia, personil. p. management tata personalia.
perspective	kb. 1 perspektiv (in drawing). to lose p. kehilangan perspektiv. 2 pemandangan.
perspicacious	ks. tajam pikiran.
perspicacity	kb. kecerdasan, ketajaman pemandangan.
perspiration	kb. keringat, peluh.
perspire	kki. berpeluh, berkeringat.
persuade	kkt. 1 membujuk. 2 mengajak. 3 mendesak. 4 meyakinkan.
persuader	kb. pembujuk.
persuasion	kb. 1 bujukan, bujuk rayu. 2 kepercayaan.
persuasive	ks. yang meyakinkan.
pert	ks. kurang sopan, bebas (terhadap orang tua dll).
pertain	kki. menyinggung. to p. to the party menyinggung hal partai.
pertinacious	ks. keras hati/kepala, teguh hati, tegar.
pertinacity	kb. ketabahan (hati), kekerasan hati.
pertinence	kb. ketepatan, kejituan, kegunaan.
pertinent	ks. berhubungan/bersangkutan dengan. the question is not p. to the problem pertanyaan itu tak berhubungan dengan persoalan itu.
perturbation	kb. gangguan, kegelisahan, kekacauan.
perturbed	ks. bingung, gelisah.
perusal	kb. pembacaan (of a book, newspapers).
peruse	kkt. membaca dengan teliti.
pervade	kkt. 1 meliputi. 2 menyerap, merembes.
pervasive	ks. dapat menembus/merembes/meresap.
pervectionist	kb. orang yang ingin segalanya sempurna.
perverse	ks. 1 suka melawan/menentang, 2 jahat.
pervert	kb. seorang yang sesat, seorang yang bersifat tak wajar. -kkt. 1 merusak, menodai. 2 menyesatkan. -perverted ks. 1 jahat, salah. 2 murtad. 3 sesat, menyeleweng. a p. interest in perhatian yang sesat terhadap.
perverter	kb. penggoda.
pervesion	kb. perbuatan yang tak wajar.
pervious	ks. dapat tembus. p. soil tanah yang bisa tembus (air).
pesky	ks. inf.: sial celaka, yang menganggu. p. insect serangga yang sial.
pessary	kb. (j. -ries) med.: alat pencegah kehamilan (yang dimasukkan kedalam farji). semacam spiral.
pessimism	kb. pesimisme.
pessimist	kb. (orang ) yang pesimis.
pessimistic	kb. pesimistis.
pest	kb. 1 (h)ama. fruit p. hama buah-buahan. 2 (orang) pengganggu.
pester	kkt. mengganggu, merundung, membengkengi. to p. s.o. to do s.t. terus-menerus mengganggu seseorang agar berbuat sesuatu.
pesticide	kb. obat pembunuh hama, pestisida.
pestilence	kb. wabah, sampar.
pestle	kb. alu, alat penumbuk, pengentak.
pet	kb. 1 bintang kesayangan (cat, dog). 2 kesayangan (of a teacher). -kkt. (petted) menimang (a dog, child). -kki. bercumbu-cumbuan. -petting kb. bercumbu-cumbuan, bercinta-cintaan.
petal	kb. daun bunga.
petard	kb. to be hoisted with/on o's own p. binasa karena perbuatannya sendiri.
peter	kki. inf.: to p. out 1 perlahan-lahan habis kekuatan (of a runner). 2 mereda (of a storm).
petite	ks. kecil mungil.
petition	kb. 1 petisi, (surat) permohonan. p. for a divorce permintaan cerai. 2 doa. -kkt. mengajukan (surat) permohonan.
petitioner	kb. permohon.
petrel	kb. sejenis burung laut. storm p. sesorang yang suka menimbulkan kegegeran.
petrify	kkt. (pertrified) membatu. -pertified ks. 1 yang membatu. p. forest hutan yang membatu. 2 amat ketakutan/kengerian. i was p. when... aku hampir mati ketakutan ketika...
petroleum	kb. minyak tanah. p. industry perminyakan.
petticoat	kb. rok-dalam wanita. p. government pemerintahan wanita.
pettifoggery	kb. (j. -ries) pokrol-pokrolan.
pettiness	kb. kepicikan, keremehan.
petty	ks. 1 picik. 2 remeh (of remarks, principles). 3 rendah, bawahan. 34 kecil-kecil. petty-minded ks. berfikiran sempit.
petulant	ks. lekas marah, pemarah.
petunia	kb. semacam bunga.
pew	kb. bangku gereja.
pewter	kb. 1 campuran timah putih dan timah hitam. 2 barang-barang yang dibuat daripadanya.
ph.b.	[bachelor of pilosophy] bakaloreat ilmu filsafat.
ph.d.	[doctor of philosophy] doktor ilmu filsafat.
phalange	= phalanx.
phalanx	(j. -anxes atau -anges) kb. tulang jari (tangan, kaki), ruas kaki.
phallus	kb. 1 lingga lambang kemaluan lelaki. anat.: zakar.
phantasy	kb. (j. -sies) lih fantasy.
phantom	kb. momok, hantu, setan. p. ship kapal hantu.
pharmaceutical	ks. yang berkaitan dengan farmasi. p. preparation obat farmasi.
pharmacist	kb,. ahli obat, apoteker.
pharmacology	kb. ilmu farmasi.
pharmacopoeia	kb. farmakope.
pharmacy	kb. (j. -cies) rumah obat, apotek, apotik.
pharyngitis	kb. sakit/radang tekak.
pharynx	kb. tekak, hulu kerongkongan.
phase	kb. 1 tahap. new p. tahap baru. 2 bentuk (of the moon). 3 elec.: keadaan perubahan aliran. -kkt. membuat bertahap-tahap. to p. out menghapuskan setahap demi setahap.
pheasant	kb. burung/ayam pegar.
phenobarbital	kb. obat tidur/bius/penenang.
phenomena	lih phenomenon.
phenomenal	ks. 1 luar biasa. p. memory ingatan yang luar biasa, daya ingat yang menakjubkan. 2 dapat dilihat. 3 hebat.
phenomenon	kb. (j. -mena) perwujudan, kejadian, gejala. natural p. kejadian alam.
phew	kseru. aduh, bah, buset, cih.
phil.	[philosophy] filsafat.
phil. is.	[philippine islands] kepulauan pilipina.
phila.	[philadelphia] kotabesar a.s.
philanderer	kb. orang yang pandai memikat hati wanita, tukang merayu.
philanthropic(al)	ks. 1 suka menderma. 2 cinta sesama manusia. p. work kedermawanan
philanthropist	kb. dermawan.
philanthropy	kb. (j. -pies) 1 hal cinta sesama manusia. 2 kedermawanan.
philatelist	kb. pengumpul perangko.
philately	kb. pengumpulan perangko.
philharmonic	kb. orkes simfoni. -ks. yang berkaitan dengan orkes simfoni.
philippine	kb. orang pilipina. -ks. pilipina. p. islands kepulauan pilipina.
philippines	kb. j. negeri pilipina.
philologist	kb. ahli bahasa-bahasa.
philology	kb. ilmu bahasa-bahasa.
philosopher	kb. filsuf, ahli filsafat.
philosophic(al)	ks. 1 berfilsafat, kefilsafatan. 2 filosofis, seperti filsuf. p. attitude sikap seorang filsuf.
philosophize	kki. berfilsafat (about tentang).
philosophy	kb. (j. -phies) filsafat.
philter	kb. obat pekasih, guna-guna untuk mendatangkan cinta.
phlebitis	kb. radang urat darah.
phlegm	kb. 1 dahak, lendir. 2 sikap dingin/acuh-tak-acuh.
phlegmatic	ks. bersikap/berdarah dingin.
phobia	kb. penyakit ketakutan, fobi, gamang.
phoey	kseru. sl.: alaaah. p. to you ! alaaaah kamu ini !
phone	kb.: telepon. -kkt., inf.: menelpon.
phoneme	kb. fonem.
phonemic	ks. fonemis.
phonemics	kb. ilmu fonemik.
phonetic	ks. fonetis.
phonetics	kb. (ilmu) fonetik.
phoney	ks. lih phony.
phonograph	kb. gramopon, pikap. p. needle jarum gramopon.
phonology	kb. fonologi.
phony	kb. kb. (j. -nies) sl.: seorang palsu/lancung. -ks. sl.: palsu, lancung. he's as p. as a three dollar bill ia gadungan/palsu.
phosphate	kb. fosfat.
phosphor	kb. fosfor.
phosphorescent	ks. pendar.
phosphoric	ks. p. acid asam fosfat.
phosphorus	kb. fosfor.
phot.	[photograph] foto, potret, gambar.
photo	kb. foto, potret. -kkt. memotret.
photocopy	kb. (j. -pies) fotokopi. -kkt. (photocopied) membuat fotocopi.
photogenic	ks. baik dalam potret, baik untuk dipotret.
photograph	kb. potret, foto, gambar. -kkt. memotret, mengambil potret. -kki. she photographs well potretnya selalu baik.
photographer	kb. juru/tukang potret.
photographic	ks. fotografis. p. memory ingatan yang sangat tajam.
photography	kb. fotografi, pemotretan. color p. fotografi berwarna.
photogravure	kb. 1 klise foto. 2 pembuatan klise foto.
photomap	kb. peta yang dibuat dengan potret. -kkt. (photomapped) memetakan dengan potret.
photometer	kb. alat pengukur cahaya untuk pemotretan.
photostat	kb. fotostat, fotocopi. -kkt. membuat fotostat.
photosynthesis	kb. fotosintesis.
phrase	kb. 1 ungkapan, ucapan. 2 gram.: kominasi/susunan kata-kata. 3 mus.: bagian. -kkt. menyusun, mengutarakan (a sentence, utterance). -phrasing kb, penyusunan kata-kata.
phrasebook	kb. buku ungkapan-ungkapan.
phraseology	kb. (j. -gies) penyusunan kata-kata, cara menyatakan pikiran.
phrenetic	= frenetic.
phthisis	kb. tebese, penyakit paru-paru.
phyla	lih phylum.
phylum	kb. (j. phyla) pembagian/pentarafan yang pertama daripada jenis binatang dan tumbuh-tumbuhan.
physic	kb. obat urus-urus.
physical	kb. pemeriksaan badan. -ks. 1 jasmani(ah). 2 fisik/ragawi. -physically kk. dengan tenaga jasmani/badaniah.
physician	kb. dokter, tabib.
physicist	kb. ahli ilmu fisika.
physics	kb. ilmu alam/fisika.
physiognomy	kb. (j. -mies) ilmu firasat.
physiological	ks. fisiologis. p. chemistry kimia hayat.
physiology	kb. (j. -gies) fisiologi, ilmu fa'al alat tubuh. plant p. ilmu fa'al tumbuh-tumbuhan.
physiotherapist	kb. ahli pengobatan badan (dengan pijat, gerak badan dsb).
physiotherapy	kb. fisioterapi, pengobatan badan.
physique	kb. badan, bentuk badan, perawakan.
pianist	kb. pemain piano, pianis.
piano	kb. piano. p. bench/stool bangku piano. p. key mata/tuts piano. p. tuner tukang setem piano.
pica	kb. (huruf) pika.
picayune	ks. remeh, kecil. p. remarks ucapan-ucapan yang remeh.
piccolo	kb. pikolo, semacam suling.
pick	kb. 1 beliung. 2 yang terbaik. -kkt. 1 memetik (cherries). 2 memilih (the best student). 3 mencungkil, menusuk (o's teeth). 4 membului (a chicken). 5 membuka (a lock). 6 memihak (sides). 7 mencopet (a pocket). 8 mengupil/mengorek (o's nose).
pickaback	kk. dukung, gendong. to carry p. mendukung, menggendong.
pickax(e)	kb. beliung, pangkur.
picker	kb. pemetik, pemungut.
picket	kb. kb. 1 tiang pancang (fence). 2 petugas serikat sekerja yang mengawasi pemogokan. 3 barisan penjagaan. -picketing kb. mencegah orang yang ingin menjalankan tugas sewaktu diadakan pemogokan.
pickle	kb. acar, asinan, asam-asaman. inf.: i'm in a p. saya dalam kesulitan. -kkt. mengawetkan. -pickled ks. 1 yang diasamkan. p. beets sejenis umbi-umbi yang diasamkan. 2 sl.: mabuk.
pickpocket	kb. tukang copet.
pickup	kb. 1 yang benar-benar menyegarkan (of a cocktail). 2 pikap (of a phonograph). 3 auto.: gerobak/truk pikap. 4 pengambilan, pengangkatan (of mail). -ks. seadanya.
picky	ks. inf.: berpilih-pilih.
picnic	kb. piknik, tamasya, darmawisata, bepergian untuk bersenang-senang. -kki. (picnicked) berpiknik, bertamasya.
picnicked	lih picnic.
picnicker	kb. peserta piknik, darmawisatawan.
pictorial	kb. majalah bergambar. -ks. bergambar.
picture	kb. 1 gambar (of a person). 2 gambaran (of the facts). 3 keadaan. 4 pilem. 5 contoh. -kkt. 1 menggambarkan. 2 membayangkan.
picturesque	ks. indah (seperti dalam lukisan).
piddling	ks. remeh, kecil, tak berarti.
pidgin	kb. p. english bahasa inggeris pasaran.
pie	kb. (kue) pastei. apple p. pastei apel. sl.: as easy as p. mudah sekali.
piebald	ks. belang (of a horse).
piece	kb. 1 potong(an). 2 buah. 3 lagu. 4 artikel. 5 lempeng(an). 6 bagian. 7 satuan. 8 kutipan, tukilan, nukilan. 9 sedikit. -pieces j. potongan-potongan.
piecemeal	kk. sedikit demi sedikit, satu demi satu.
piecework	kb. pekerjaan yang dibayar menurut hasil yang dikerjakan.
pier	kb. dermaga.
pierce	kkt. 1 menembus (of a needle, screams). 2 menyerbu. 3 menusuk. -piercing ks. tajam-menusuk (of eyes, screams).
piety	kb. (j. -ties) kesalehan, kealiman.
pig	kb. 1 baby. 2 vulg.: polisi.
pigeon	kb. burung dara/merpati, punai. clay p. merpati dari tanah liat. pigeon-toed ks. dengan empu kaki menghadap kedalam.
pigeonhole	kb. kotak dalam meja tulis. -kkt. menyimpan, mendep.
piggish	ks. rakus seperti babi.
piggy	kb. (j. -gies) anak babi yang kecil. p. bank tabungan (yang kadang-kadang berbentuk anak babi).
piggyback	kk. dukung-dukungan, (naik) kuda-kudaan.
pigment	kb. zat warna, pigmen.
pigmentation	kb. pewarnaan pigmen.
pigpen	kb. kandang babi.
pigskin	kb. 1 kulit babi. 2 bola (football).
pigsty	kb. kandang babi.
pigtail	kb. kucir, rambut tancang.
pike	kb. 1 tombak, seligi. 2 semacam ikan. 3 lih turnpike.
piker	kb. sl.: orang yang kikir.
pile	kb. 1 gundukan, tumpukan (of stones, snow, sand, books). 2 tiang. 3 onggokan (of wood). 4 phys.: kesatuan. 5 lapisan. -piles j. bawasir.-piling kb. jojol, embarau, tiang pancang.
pilfer	kkt. menimpa, menyerobot, pencuri. pilfered goods barang-barang timpaan. -pilfering kb. pencurian kecil-kecilan, pencopetan.
pilferage	kb. 1 pencurian, penyerobotan. 2 barang-barang curian.
pilferer	kb. pencuri secara kecil-kecilan, pencopet.
pilgrim	kb. 1 haji (mekkah). 2 peziarah (ke kuburan).
pilgrimage	kb. 1 naik haji. 2 ziarah.
pill	kb. pil, pel. 2 (birth control) pil pencegah kehamilan. 3 sl.: orang yang tak menyenangkan.
pillage	kb. penjarahan. -kkt. menjarah, merampas. -pillaging kb. perampasan, perampokan, pembajakan.
pillager	kb. penjarah.
pillar	kb. 1 tiang. 2 bubungan, kepulan (of smoke). 3 sokoguru, sendi. 4 rukun.
pillbox	kb. 1 kotak pil. 2 mil.: gardu pertahanan.
pillory	kb. (j. -ries) tiang tempat menghukum orang didepan umum. -kkt. membikin malu orang, menghina orang dimuka umum.
pillow	kb. bantal. -kkt. membantali, meletakkan, mengalasi (s.o.'s head in o's lap).
pillowease	kb. sarung bantal.
pillowslip	kb. sarung bantal.
pilot	kb. 1 pilot, penerbang. 2 pandu, mua(l)lim. -kkt. 1 mengemudikan (plane, ship). 2 menuntun. -piloting kb. 1 pekerjaanmengemudi. 2 ilmu pelayaran laut atau navigasi udara.
pimento	kb. bumbu cengkeh. p. cheese keju berbumbu cengkeh.
pimiento	kb. = pimento.
pimp	kb. 1 alku, mucikari, jaruman, germo. 2 calo. -pimping kb. penggermoan.
pimple	kb. jerawat. to break out with pimples timbul bintil-bintil.
pimply	ks. berjerawat (on a face).
pin	kb. 1 peniti. 2 lencana. -kkt. (pinned) 1 menyematkan (a dress). 2meletakkan, menggantungkan. 3 menjepit.
pinafore	kb. 1 alas dada anak-anak. 2 pakaian luar untuk bekerja/bermain.
pinball	kb. p. machine main jackpot.
pincers	kb., j. sepit, penyepit (of lobster, crab). a pair of p. sepasang sepit. mil.: p. movement gerakan menjepit/pengguntingan.
pinch	kb. 1 cubitan. 2 jemput. -kkt. 1 mencubit. 2 menjepit (o's feet). 3 sl.: menangkap (s.o. for speeding). 4 sl.: mencopet (the goods of others). -pinched ks. 1 kurus (of face). 2 kurang. -pinching kb. jepitan.
pinchpenny	kb. (j. -nies) inf.: orang kikir. -ks. kikir, sangat hemat.
pincushion	kb. bantal peniti.
pine	kb. cemara, eru. p. cone kerucut pohon cemara.
pineapple	kb. nanas, nenas.
pinfeather	kb. bulu halus-halus.
ping	kb. ting (sound of bullet). ping-pong kb. tenis meja, pingpong.
pinhead	kb. 1 kepala peniti. 2 sl.: orang bodoh.
pining	kb. keadaan merana.
pinion	kb. ujung sayap. -kkt. mengikat tangan sehingga tak terpakai. to p. s.o's arms to sides mengikatkan tangan/lengan seseorang pada pinggirannya/sisinya.
pink	kb. 1 merah muda. 2 inf.: simpatisan komunis. -ks. merah muda. to turn p. menjadi merah muda. p. slip surat pemberhentian/pemecatan.
pinkeye	kb. penyakit mata yang menular.
pinkie	kb. jari, kelingking.
pinkish	ks. agak merah muda, kemerah-merahan.
pinko	kb. sl.: simpatisan komunis, orang kiri.
pinnacle	kb. puncak.
pinpoint	kkt. menunjukkan sesuatu dengan tepat.
pinprick	kb. cocokan peniti.
pinstripe	kb. 1 garis-garis halus. 2 pakaian bergaris-garis.
pint	kb. takaran inggris (0.568 liter). pint-size(d) ks. kecil, kerdil.
pinup	kb. inf.: gambar gadis cantik (untuk digantung di dinding).
pinworm	kb. cacing kerawit.
pioneer	kb. pelopor, perintis (jalan), pionir. -kkt. memelopori. -kki. merintis jalan (in dalam).
pious	ks. saleh, alim.
pip	kb. 1 biji. 2 sl.: yang istimewa. my girl is really a p. gadisku betul-betul seorang yang istimewa.
pipe	kb. 1 pipa. 2 pipa cangkelong, uncui. 3 buluh-buluh, pembuluh. 4 mus.: semacam suling. -kkt. 1 menyalurkan dengan pipa (water into a building). 2 menyalurkan (music into a room). 3 menyerukan. -piping kb. 1 pipa-pipa, pipa selokan. 2 bis, jalur.
pipeful	kb. sepipa penuh.
pipeline	kb. 1 pipa saluran. 2 inf.: saluran (used by reporters)
piper	kb. pemain musik tiup. to play the p. menanggung akibat.
pipestem	kb. tangkai pipa.
pipette	kb. pipet.
pipsqueak	kb. sl.: orang sepele.
piquant	ks. 1 menarik. 2 (of food) pedas.
pique	kb. kekesalan, kejengkelan. to say s.t in a fit of p. mengatakan sesuatu dalam keadaan kesal. -kkt. mengesalkan, menjengkelkan. she was piqued by.... dia kesal karena.
pique'	kb. kain pike.
piracy	kb. (j. -ties) pembajakan, perompakan.
pirate	kb. bajak laut, peompak, lanun. p. radio station radio gelap. -kkt. 1 membajak (a ship). 2 menerbitkan buku-buku tanpa izin penerbitnya/penulisnya. -pirating pembajakan (of a book).
pirouette	kb. putaran, kisaran. -kki. berputar-putar diatas kaki.
pistachio	kb. semacam buah kenari hijau.
pistil	kb. putik.
pistol	kb. pestol, pistol. to pistol-whip memukul dengan pistol
piston	kb. kodok-kodok, pengisap, seher. p. ring ring seher.
pit	kb. 1 lubang. 2 terowongan, lubang (of a mine). 2 ruang bawah di gedung konser. 3 biji. -kkt. (pitted) 1 mengadu (o's strength, two cocks). 2 fruit : menghilangkan biji (pada buah-buahan). -pitted ks. berbintik-bintik (of the face).
pitapat	kb. derai (of rain on the window). -kk. to go p. berdebar-debar (of the heart).
pitch	kb. 1 bubungan, puncak (of roof). 2 ter. 3 mus.: pola titinada. 4 lemparan (bola). 5 gerak maju baling-baling. pitch-black ks. hitam pekat/kelam. pitch-dark ks. gelap gulita, gelap pekat. -pitching kb. 1 anggukan (of a boat, ship). 2 pelemparan.
pitchblende	kb. bijih-bijih uranium.
pitcher	kb. 1 kendi, buyung, bocong. cream p. tempat/kendi susu. 2 sport : pelempar (bola).
pitcherful	kb. sekendi.
pitchfork	kb. garpu rumput.
piteous	ks. memilukan, menyedihkan.
pitfall	pitfall
pith	kb. 1 inti, sari, intipati, intisari. 2 sum-sum. p. helmet topi pandan/gabus/prop.
pithead	kb. pintu terowongan tambang.
pithy	ks. 1 ringkas dan tajam (of a remark). 2 banyak inti/biji (of a tangerine, orange).
pitiable	ks. yang menimbulkan belas kasihan, menyedihkan.
pitied	lih pity.
pities	lih pity.
pitiful	ks. tidak memuaskan, menyedihkan.
pitiless	ks. kejam, bengis.
pittance	kb. sedikit sekali.
pitterpatter	kb. ketipak-ketipuk.
pittypat	= pitapat.
pituitary	ks. p. gland kelenjar dibawah otak.
pity	kb. (j. -ties) kasihan, sayang. -kkt. mengasihani. -pityingly kk. dengan berbelas kasihan.
pivot	kb. poros, pasak, paksi, sumbu. -kki. berputar.
pivotal	ks. sangat penting.
pixie, pixy	kb. (j. -xies) peri, dewi.
pk.	1[peck] ukuran barang-barang kering (hampir 8 liter). 2 [package] paket, bungkusan, bingkisan. 3 [park] taman.
pkg.	[package] paket, bungkusan, bingkisan.
pkw.	[parkway] jalan raya.
pl.	1 [plural] jamak. 2 [place] jalan kecil.
placard	kb. plakat.
placate	kkt. mendamaian, menenteramkan.
place	kb. 1 tempat. 2 tempat tinggal. 3 jabatan. 4 bagian. 5 tingkat. 6 urusan, wewenang. 7 kedudukan .
placement	kb. 1 penempatan. p. office kantor penempatan tenaga. 2 tingkat(an). p. test ujian tingkat.
placenta	kb. (j. -tae/-tai/, -tas) ari-ari, tembuni, uri.
places	j. angka-angka. -kkt. 1 menempatkan (a guard at, students in). 2 meletakkan. 3 memasukkan (on order, a child in school). 4 mengenakan (a duty, tax). 5 menetapkan. 6 kenal. 7 menduduki. 8 menyerahkan.
placid	ks. tenang.
plagiarism	kb. penjiplakan, plagiat.
plagiarist	kb. penjiplak, plagiator.
plagiarize	kkt. menjiplak.
plague	kb. 1 wabah. 2 (penyakit) pes. 3 gangguan. -kkt. menggoda, mengganggu. plague-stricken ks. terserang wabah (of a village).
plaid	kb. kain (wol) yang berpetak-petak.
plain	kb. 1 daratan. 2 dataran, tanah datar. -ks. 1 sederhana. 2 biasa. 3 terang, jelas. 4 kurang menarik (girl). plain-spoken ks. suka berterus-terang. -plainly kk. 1 dengan sederhana. 2 dengan terus terang.
plainclothesman	kb. (j. -men) detektip atau polisi (yang berpakaian orang biasa).
plainness	kb. kesederhanaan.
plaint	kb. keluhan.
plaintiff	kb. penggugat, penuntut.
plaintive	ks. sayu, sedih.
plait	kkt. menjalin.
plan	kb. 1 rencana. 2 perencanaan. -kkt. (planned) 1 merencanakan (a party). 2 bermaksud. -kki. membuat rencana. 2 mengharapkan. -planned ks. berencana. -planning kb. perencanaan
plane	kb. 1 pesawat terbang. 2 carp.: penerah, pengetam. 3 taraf. 4 latar, bidang. -kkt. menarah (wood). -kki. av.: naik pesawat terbang.
planeload	kb. sepesawat terbang penuh.
planet	kb. planit, bintang siarah.
planetarium	kb. tempat pertunjukan jalan bintang-bintang.
planetary	ks. dari atau berhubungan dengan planit.
plank	kb. 1 papan. 2 pol.: bagian penting. -kkt. to p. down 1 menaruh atau meletakkan dengan kekuatan (a book). 2 inf.: membayar sekaligus.
planner	kb. ahli rencana, perencanaan.
plant	kb. 1 tanam-tanaman, tumbuh-tumbuhan. 2 pabrik. 3 gedung-gedung, bangunan-bangunan. (of an institution). 4 para pekerja. 5 sl.: mata-mata/orangnya/antek polisi. -planting kb. penanaman.
plantain	kb. pisang raja (untuk dimasak).
plantation	kb. perkebunan.
planter	kb. 1 penanam. 2 pemilik/pengusaha perkebunan.
plaque	kb. tanda peringatan, (logam) piagam.
plasma	kb. plasma.
plaster	kb. plester, gips. -kkt. 1 memlester, menurap, melepa (a wall). 2 meliputi. -plastered ks. sl.; mabuk. -plastering kb. 1 penurapan. 2 lapisan plester, plesteran.
plasterboard	kb. eternit.
plasterer	kb. tukang plester.
plastic	kb. plastik. p. cup mangkuk plastik.
plasticity	kb. keliatan, kekenyalan.
plate	kb. 1 piring. 2 gambar (in a book). 3 pelat (of a camera). 4 tooth : tambalan gigi. -kkt. melapisi, menyepuh (with silver dengan perak). -plated ks. berlapis.
plateful	kb. sepiring penuh. a p. of rice sepiring penuh nasi.
platen	kb. silinder atau rol mesin tulis.
plateu	kb. 1 dataran tinggi. 2 masa stabil, taraf tanpa kemajuan (dalam pelajaran).
platform	kb. 1 panggung, podium. 2 peron (station). p. ticket karcis peron.3 pol.: program partai.
platinum	kb. platina, mas kodok/putih. p. blond orang yang berambut pirang seperti platina.
platitude	kb. kata-kata hampa/basi.
platonic	ks. p. love cinta yang bersifat persaudaraan.
platoon	kb. peloton.
platter	kb. 1 piring yang besar. 2 mus.: sl.: piringan hitam.
plaudits	kb., j. sorak pujian, tepuk tangan.
plausibility	kb. hal yang masuk akal.
plausible	ks. masuk akal.
play	kb. sandiwara, lakon. 2 auto.: longgar pasamgan (in a wheel). 3 giliran. 4 permaianan (of lights). -kki. 1 bermain-main. 2 main. 3 bertanding. play-off kb. pertandingan, penentuan.
playable	ks. dapat dimainkan.
playback	kb. memainkan/permainan kembali.
playboy	kb. inf.: orang laki-laki kaya yang suka pelesir.
player	kb. pemain. 2 penjudi. p. piano piano otomatis.
playful	ks. suka bermain/melucu.
playgoer	kb. penonton sandiwara.
playground	kb. tempat bermain. lapangan permainan.
playhouse	kb. 1 thea.: gedung komidi. 2 taman bermain anak-anak.
playmate	kb. kawan bermain/sepermainan.
playpen	kb. bok(s), tempat anak-anak kecil bermain-main.
playroom	kb. kamar (untuk) bermain.
plaything	kb. alat permainan.
playwright	kb. dramawan, pengubah sandiwara.
plaza	kb. alun-alun.
plea	kb. 1 permohonan, permintaan. 2 law : pembelaan, dalih.
plead	kkt. (pleaded atau pled) 1 membela, mengadakan pembelaan. 2 membuat dalih/alasan (poverty, bankruptcy). 3 mengaku, menjawab (bersalah). 4 meminta/memohon dengan sangat. -pleading kb. pembelaan, permohonan. -pleadingly kk. dengan permohonan.
pleader	kb. 1 pemohon. 2 pembela.
pleasant	ks. menyenangkan, sedap. p. breeze angin sepoi-sepoi yang lembut. -pleasantly kk. senang.
pleasantry	kb. (j. -ries) olok-olok, sendagurau.
please	kkt. menyenangkan (hati). -kki. 1 silakan. 2 tolong. 3 -lah. -pleased ks. senang, puas. -pleasing ks. menyenangkan.
pleasurable	ks. yang menyenangkan (experience, occasion).
pleasure	kb. kesenangan. pleasure-loving ks. suka/senang pelesir, suka bersenang-senang/berfoya-foya.
pleat	kb. lipatan. -kkt. melipat. pleated skirt rok yang berlipat/berlipit.
plebe	kb. cama, plonco.
plebeian	ks. kampungan, kurang halus, udik.
plebiscite	kb. plebisit.
pled	lih plead.
pledge	kb. janji, cagar, ikrar. -kkt. menjanjikan (a donation). 2 berjanji.
plen.	[plenipotentiary] berkuasa penuh.
plenary	ks. paripurna, pleno. p. session sidang paripurna. p. power kekuasaan/mandat penuh.
plenipotentiary	ks. yang berkuasa penuh. ambassador p. dutabesar yang berkuasa penuh.
plentiful	ks. berlimpah-limpah.
plenty	kb. banyak. p. of money banyak uang. -ks. cukup. -kk. inf.: cukup.
pleonastic	ks. yang berlebih-lebihan, bertele-tele, pleonastis, mubazir.
plethora	kb. kebanyakan, berlebih-lebihan. a p. books buku-buku yang kebanyakan.
pleurisy	kb. radang selaput dada, birsam.
pliable	ks. 1 lembut, lunak (of character). 2 suka melentur (of leather).
pliant	ks. liat.
plied	lih ply.
pliers	kb., j. tang, gegep, cunam, catut, penyepit.
plight	kb. keadaan (buruk, jelek, sedih). in a sad p. dalam keadaan yang menyedihkan. -kkt. berjanji.
plod	kki. (plodded) 1 berjalan dengan susah payah. 2 terus bekerja keras. -plodding ks. lamban, lambat dan berat.
plodder	kb. orang yang lambat tapi tekun bekerja.
plop	kb. gedebur, cebur, celempung, celepuk (of a rock hitting water). -kk. the stone went p. batu itu bergedebur. -kki. (plopped) to p. down menjatuhkan diri (on a bed).
plot	kb. potong/bidang tanah (kapling). 2 isi cerita, alur (of a story). 3 komplotan. -kkt. (plotted) 1 merencanakan dengan diam-diam. 2 menggambari (s.t. on a graph). 3 merencanakan (o's course). -kki. bersekongkol, berkomplot.
plotter	kb. anggota komplotan, pengomplot.
plow	kb. bajak, luku, tenggala. -kkt. 1 meluku, menenggala, membajak (tanah). 2 mengeruk (snow). -kki. membajak, meluku, menenggala.
plowshare	kb. mata bajak.
ploy	kb. 1 cara. 2 kesenangan bersama.
pluck	kb. keberanian. -kkt. 1 memetik (flowers, guitar). 2 membului (chicken). 3 mencabuti (eyebrow). 4 menarik, merenggut.
plucky	ks. berani. he's a p. son-of-a-gun ia seorang "setan"/pemberani.
plug	kb. 1 steker. 2 kayu penyumbat, sumbat (for a hole). 3 busi. 4 kuda tua. 5 inf.: kata-kata baik.
plugger	kb. 1 orang yang mempropagandakan sebuah produk. 2 orang yang bekerja keras.
plum	kb. 1 prem. p. pudding pudding prem. 2 keuntungan. getting him is a real p. mendapatkan dia betul-betul suatu keuntungan.
plumage	kb. bulu burung.
plumb	kb. timbangan pengukur garis tegak lurus. -ks., kk. inf.: betul-betul. -kkt. menduga. -plumbing kb. 1 pipa leding. 2 pekerjaan mematri dan memasang pipa-pipa air leding.
plumber	kb. tukang patri/pipa/ledeng. plumber's friend/helper alat penyedot saluran air.
plume	plume
plummet	kb. bandulan pengukur tegak lurus. -kki. jatuh terjerembab, terjungkir-jungkir.
plump	plump
plunder	kb. barang-barang rampasan. -kkt. merampas, menjarah.
plunderer	plunderer
plunge	kb. loncatan. -kkt. mencelupkan (o's hand into water). -kki. 1 terjun (into a pool). 2 nekat-nekatan berspekulasi (on the stock market).
plunger	kb. 1 (drain) alat penyedot untuk saluran pembuangan air. 2 spekulan (on stock market). 3 pengisap (motor).
plunk	kb. inf.: inf.: bunyi petikan. -kkt. memetik (a banjo).
pluperfect	kb., ks. gram.: waktu lampau yang sempurna.
plur.	[plural] bentuk jamak.
plural	kb. bentuk jamak. -ks. jamak.
plurality	kb. (j. -ties) 1 orang banyak. 2 perbedaan antara jumlah suara yang terbesar dengan jumlah suara yang terbesar dengan jumlah berikutnya. 3 jumlah terbanyak.
plus	kb. 1 tambahan. 2 tanda tambah (+). -ks. plus, lebih. a+ nilai a plus. kd. tambah
plush	ks. mewah, mahal. p. living hidup mewah.
plutocrat	kb. 1 orang kaya. 2 plutokrat.
ply	kb. lapisan. -kkt. (plied) 1 menjalankan, melakukan (o's trade). 2 menghujani (s.o. with question). 3 memberi (s.o. with food, drink). 4 melayari, menjelajahi, mengarungi. -kki. hilir-mudik.
plywood	kb. kayu tripleks/lapis.
pneumatic	ks. berisi udara/angin. p. drill (mesin) bor angin. p. tire ban angin.
pneumonia	kb. radang paru-paru.
poach	kkt. merebus. to p. an egg merebus isi telor di air yang mendidih. -kki. melanggar masuk. to p. on land berburu tanpa izin di tanah.
poacher	kb. pemburu gelap.
pock	kb. becak, kurik, bintik, noda, burik, bopeng. -kkt. memenuhi (o's face, the moon's surface mukanya, permukaan bulan). pock-marked ks. barik, bopeng.
pocket	kb. saku, kantong. -kki. 1 mengantongi (the profits, tickets). 2 menahan.
pocketbook	kb. 1 dompet. 2 uang. 3 buku saku.
pocketful	kb. (se)kantong penuh.
pocketknife	kb. (j. -knives) pisau saku/lipat.
pod	kb. (buah) polong, kelopak. pen p. kulit kacang polong
podiatrist	kb. ahli panyakit kaki.
podiatry	kb. ilmu pengobatan dan pemeliharaan kaki.
podium	kb. (j. -dia) mimbar.
poem	kb. syair, sajak.
poet	kb. penyair, penyajak. p. laureate pujangga resmi.
poetess	kb. penyair wanita.
poetic(al)	ks. puitis. p. license kebebasan penyair.
poetics	kb. puitik.
poetry	kb. puisi, persajakan. to write p. mengubah sajak.
poignancy	kb. 1 kepedihan. 2 ketajaman, kepekatan (of flavor).
poignant	ks. 1 pedih, perih. 2 tajam. 3 pedas (of food).
poinsettia	kb. poinsetia, semacam tumbuh-tumbuhan yang daunnya berwarna merah.
point	kb. 1 ujung (of pencil, sward). 2 titik. 3 biji, angka. 4 batas. 5 maksud, pokok. 6 mata angin (of the compass). 7 bakat. 8 tempat. 9 hal. 10 pendapat, pendirian. 11 perlunya, gunanya. 12 sifat. 13 auto.: platina. 14 koma.
pointed	ks. 1 tirus (of roof). 2 menusuk hati, tajam (of a remark).
pointer	kb. 1 tongkat penunjuk. 2 (advice) petunjuk. 3 anjing pemburu.
pointless	ks. 1 tanpa ujung (of pencil). 2 tiada artinya, tidak berarti (of remark).
poise	kb. 1 sikap tenang. 2 sikap/keadaan seimbang. -kkt. memperseimbangkan. -kki. berhenti (dalam sikap seimbang).
poison	kb. racun, bisa. to take p. minum racun. -kkt. meracuni. -poisoning kb. peracunan.
poisonous	ks. beracun, berbisa. p. rumor desas-desus yang jahat/berbisa.
pok(e)y	ks. 1 bertindak/bergerak lamban. 2 bodoh, tolol, dungu. 3 kecil, sempit (of a room).
poke	kb. 1 kantung. 2 sodokan. -kkt. 1 menyodok, menusuk (in the back, ribs). 2 meninju (in the nose). 3 mempermainkan (fun). 4 menonjolkan. 5 mengulurkan. 6 mencongkel. -kki. mengaduk-aduk.
poker	kb. alat pengorek api. 2 poker (semacam main kartu). inf.: p. face muka yang tak menunjukkan perasaan.
pol.	1 [polish] dari polandia; bahasa polandia. 2 [poland] polandia.
polar	ks. 1 yang berhubungan dengan kutub. p. bear beruang kutub. 2 berlawanan. p. attitude sikap yang berlawanan.
polarity	kb. (j. -ties) 1 sifat berlawanan. 2 muatan kutub.
polarization	kb. polarisasi.
polarize	kkt. mempolarisasikan, mempertentangkan.
pole	kb. 1 galah. long p. galah panjang. 2 tiang. telephone p. tiang telepon. 3 kutub. 4 elektroda. -kkt. menggalah (perahu).
polecat	kb. sigung, kuskus.
polemic(al)	kb. polemik. -ks. yang bersifat polemik.
polemicize	kkt. mempolemikkan.
polemics	kb., j. polemik. to engage in p. berpolemik.
polestar	kb. 1 bintang kutub/utara. 2 pedoman.
polevault	kki. meloncat dengan galah.
police	kb. 1 polisi. 2 angkatan kepolisian. -kkt. 1 menjaga ketertiban. 2 menjaga kebersihan (dalam perkampungan militer).
policeman	kb. (j. -men) polisi. traffic p. polisi lalu-lintas.
policewoman	kb. (j. -women) polisi wanita, polwan.
policy	kb. (j. -cies) 1 polis. 2 kebijaksanaan (of a government). 3 politik.
policyholder	kb. pemegang polis asuransi.
policymaker	kb. pemimpin, orang yang menentukan kebijaksanaan.
polio	kb. penyakit lumpuh (anak-anak). p. vaccine vaksin pencegah penyakit lumpuh anak-anak.
poliomyelitis	kb. penyakit lumpuh (anak-anak).
polish	kb. 1 (silver) obat penggosok upaman, pelitur. 2 semir. 3 budibahasa yang halus. 4 kilap,kilat (sparkle). -polished ks. 1 yang halus budi-bahasanya/tingkah-lakunya. 2 yang dipelitur.
polisher	kb. 1 penggosok. 2 ahli penggosok (lantai).
polite	ks. sopan santun (to (wards) terhadap). p. society kalangan yang halus budi bahasanya. -politely kk. dengan sopan.
politeness	kb. kesopan-santunan, kesopanan, keadaban.
politic	ks. bijaksana. body p. lembaga politik.
political	ks. politik. p. asylum suaka politik. p. economy ilmu ekonomi politik.
politician	kb. politikus.
politick	kki. bermain politik, berdagang sapi.
politico	kb. politikus, gembong politik.
politics	kb. politik. to play p. bermain-main politik.
polity	kb. (j. -ties) 1 pemerintahan. 2 masyarakat yang berpemerintah negara. 3 negara.
polka	kb. tari-tarian. p. dot bintik. polka-dot blouse blus yang berbintik-bintik.
poll	kb. 1 pemberian suara. 2 penyelidikan pendapat umum. -polls j. tempat pemungutan suara. -kkt. 1 menanyai (s.o. for his opinion). 2 memberikan. -polling kb. penyelidikan pendapat umum.
pollen	kb. serbuk/tepung sari. p. count penghitungan jumlah butir serbuk sari dalam jumlah satu yar kubik udara pada suatu saat di suatu tempat.
pollinate	kkt. menyerbukkan, menyerbuki.
pollination	kb. penyerbukan.
pollster	kb. pengumpul suara, orang yang mengumpulkan pendapat umum.
pollutant	kb. alat/bahan pengotor.
pollute	kkt. mengotori, mengotorkan.
polluter	kb. pengotor.
pollution	kb. pengotoran, polusi. air p. pengotoran udara.
pollyanna	kb. optimis, periang.
polo	kb. polo. water p. polo air.
polyandry	kb. poliandri
polyclinic	kb. poliklinik.
polygamist	ks. seorang laki-laki yang beristeri lebih dari seorang.
polygamy	kb. poligami, beristeri/bersuami lebih dari seorang.
polyglot	kb. poliglot.
polygon	kb. poligon, segibanyak.
polygyny	kb. peristrian lebih dari seorang, permaduan.
polynesian	kb. orang polinesia. -ks. dari polinesia.
polysyllabic	ks. bersuku-kata banyak.
polytechnic	kb. sekolah tehnik. -ks. politeknik
pomade	kb. pomade, minyak rambut.
pomegranate	kb. buah delima.
pomology	kb. ilmu tentang buah-buahan.
pomp	kb. kemegahan, kebesaran.
pompous	ks. muluk, bermegah diri, sombong, angkuh.
pond	kb. kolam.
ponder	kkt. mempertimbangkan (dengan hati-hati), memenungkan.
ponderous	ks. 1 berat dan lambat. 2 membosankan, boyak.
pontiff	kb. 1 paus. the soveregn p. paus. 2 uskup. 3 pendeta tingkat tinggi.
pontifical	ks. berkaitan dengan paus. p. mass misa suci yang dipimpin oleh paus.
pontificate	kki. memberi wejangan, mengajar.
pontoon	kb. ponton. p. bridge jembatan ponton.
pony	kb. (j. -nies) 1 kuda yang masih muda. 2 kuda kerdil. 3 (translation) terjemahan.
ponytail	kb. 1 ekor kuda. 2 buntut kuda (rambut gadis).
pooch	kb. sl.: anjing.
pooh	kseru. cih, bah. -kkt. pooh-pooh tak mengindahkan.
pool	kb. 1 kolam. 2 genangan (of water). 3 bilyar kantong/pul. 4 kelompok. 5 arisan tebak-tebakan. -kkt. menyatukan (resources).
poolroom	kb. kamar bola.
poop	kb. 1 nav.: buritan (kapal). 2 sl.: berita, desas-desus, kabar angin.
pooped	ks. sl.: letih(-lesu).
poor	kb. the p. j. kaum miskin, orang yang melarat. -ks. 1 miskin. 2 malang. 3 tidak baik (of eyesight). 4 remang-remang (of light). 5 jelek. 6 tandus (of soil). 7 rendah. 8 (serba) canggung. 9 lemah. 10 buruk. -poorly ks. kurang baik. kk. dengan jelek.
poorhouse	kb. rumah miskin.
pop	kb. air soda. 2 inf.: ayah, pak. 3 letupan. -kkt. (popped) 1 meletuskan (a balloon). 2 menyerudukkan (o's head into)
popcorn	kb. jagung berondong/kembang/meletus.
pope	kb. paus.
popeye	kb. mata membelalak/terbelalak.
