bishop	kb. 1 uskup. 2 chess : mentari, benteng, gajah.
bishopric	kb. keuskupan.
bismuth	kb. bismut.
bison	kb. banteng, sejenis banteng di as.
bit	kb. 1 kekang, gurdi. 2 sedikit. 3 agak. 4 lih bite. b. by b. sedikit demi sedikit. not a b. sedikitpun tidak. bits and pieces potong-potong, kepingan.
bitch	kb. 1 (dog) anjing betina. 2 perempuan jalang. -kki. sl.: menggerutu. he's always bitching about s.t. dia selalu menggerutu tenteng sesuatu.
bite	kb. 1 gigitan, sengatan. mosquito b. gigitan nyamuk. 2 potong. 3 sesuap. 4 tusukan. 5 bagian. -kkt. (bit,bitten) 1 menggigit. 2 menekan dengan keras pada. -bitting ks. menusuk (of wind, remark).
bitten	lih bite.
bitter	ks. 1 pahit. 2 tidak enak. 3 sengit. 4 dingin. -bitters j. sesuatu yang memberikan rasa pada minuman keras, minuman pahit. -bitterly kk. 1 dengan sengit. 2 sekali.
bitterness	kb. 1 kebencian. my b. towards him kebencian saya terhadap dia. 2 kepahitan (of a medicine). 3 kegetiran (in o's voice).
bittersweet	kb. sejenis tumbuh-tumbuhan yang rasanya manis bercampur pahit. my experience was b. pengalaman saya ada suka dan dukanya.
bituminous	ks. b. coal batu bara muda.
bivalve	kb. berlokan/berkelopak dua.
bivouac	kb. bivak, perkemahan. -kki. (biouacked) berkemah. we'll b. here kami akan berkemah disini.
biweekly	kb. (j. -lies) suratkabar yang terbit dwiminggu. -ks. dua kali seminggu. b. newspaper suratkabar yang terbit dua kali seminggu.
bizarre	ks. aneh, ajaib, ganjil.
blab	kki. (blabbed) inf.: banyak (ng)omong.
blabber	kb. perepet, suka berbicara dengan tak memikirkan akibatnya. she's a real b. dia benar-benar seorang yang suka mengecek.
blabbermouth	kb. sl.: pengecek
black	kb. 1 orang hitam, neger, negro. 2 hitam. -ks. 1 hitam. 2 menyedihkan. -kki. to b. out 1 jatuh pingsan. 2 meniadakan, menghapuskan. black-and-blue ks. babak belur. black market menjual barang di pasar gelap. -blacking kb. semir sepatu hitam.
blackball	kb. penolakan keanggotaan. one b. by a member will keep a candidate out of the club satu penolakan oleh seorang anggota akan tidak memungkinkan calon itu menjadi anggota. -kkt. menolak keanggotaan.
blackberry	kb. (j. -ries) sejenis berry.
blackbird	kb. burung hitam.
blackboard	kb. papan tulis.
blacken	kkt. memburukkan, merendahkan, menurunkan. such statements tend to b. o's reputation pernyataan-pernyataan seperti itu bisa memburukkan gengsi (nama) seseorang.
blackguard	kb. bandit, bajingan, buaya darat, orang jahat.
blackhead	kb. bincil (hitam).
blackjack	kb. 1 pentungan polisi. 2 cards : selikuran (permainan kartu).
blacklist	kb. daftar hitam. -kkt. mendaftarhitamkan.
blackmail	kb. pemerasan. -kkt. memeras, memfitnah.
blackmailer	kb. pemeras.
blackness	kb. kegelapan.
blackout	kb. 1 penggelapan. 2 penghentian, gangguan. 3 hilang/tak sadar.
blacksmith	kb. pandai besi.
blacksnake	kb. ular hitam.
blacktop	kb. campuran aspal dengan batu-batu kerikil untuk jalan-jalan. -kkt. (blacktopped) mengaspal.
bladder	kb. 1 anat.: kandung kemih/kencing, perkencingan. 2 sport: bola dalam (pada bola keranjang dsb.).
blade	kb. 1 mata pisau (of an instrument). 2 bilah, helai. 3 pisau (for a razor). 4 daun (of an oar, fan, propellor). 5 (gay) jago. 6 pedang.
blah	kb. sl.: omong kosong. the lecture was b. kuliah itu omong kosong saja.
blame	kb. kesalahan. -kkt. menyalahkan. -blamed ks. inf.: jahanam, terkutuk.
blanch	kkt. memutihkan (almonds). -kki. menjadi pucat, memucat. she blanched when the heard the bad news ia menjadi pucat ketika mendengar kabar buruk itu.
bland	ks. 1 lunak. b. diet makanan lunak. 2 lemah lembut. b. smile senyum yang lemah lembut.
blandishment	kb. bujukan.
blank	kb. 1 formulir. 2 kosong, hampa, blanko. 3 peluru/tembakan kosong.
blanket	kb. 1 selimut. 2 lapisan. -kkt. 1 menutupi. 2 meliputi. b. guarantee jaminan umum/seluruhnya/penuh. b. policy asuransi yang meliputi seluruh harta milik.
blankety-blank	ks. sl.: jahanam. i wish i could get this b. car started saya harap saya dapat menghidupkan mesin jahanam ini.
blare	kb. bunyi. b. of a trumpet bunyi terompet. -kkt. meraungkan. the phonograph blared forth its music gramopon itu meraungkan musiknya terus menerus.
blase	ks. bosan, teledor. she was b. about her round-the-world trip ia bosan akan perjalanannya keliling dunia.
blaspheme	kkt. mengutuk/menyeranah/mengucapkan perkataan yang menghina tuhan, menyerapah. to b. the lord menyeranah tuhan.
blasphemous	ks. yang menghina/menyeranah tuhan. those are b. words kata-kata itu kata-kata yang menghina tuhan.
blasphemy	kb. (j.-mies) penghujahan, pemfitnahan.
blast	kb. 1 letusan, ledakan. 2 hembusan. 3 bunyi, tiupan. -kkt. 1 menghancurkan. 2 membunyikan. -kki. meledakkan dinamit. -blasted ks. inf.: jahanam. -kb. blasting kb. peledakan.
blastoff	kb. inf.: peluncuran roket.
blastproof	ks. tahan ledakan. this shelter is b. lubang perlindungan ini tahan ledakan.
blatant	ks. 1 menyolok (mata) (of clothing). 2 ribut dengan terang-terangan. he showed b. contempt ia menunjukkan dengan terang-terangan kehinaan.
blaze	kb. 1 lautan api. 2 nyala api. 3 suasana. -blazes j. sl.: persetan. sl.: like blazes mati-matian, dengan dahsyat/hebat. -kkt. membuat jalan. -kki. menyala dengan berkobar-kobar. -blazing ks. 1 berkobar. 2 terbakar. 3 terik.
blazer	kb. jaket. the choir members wore their school blazers anggota-anggota paduan suara itu memakai jaket seragam sekolah.
blazr	kb. jaket. the choir members wore their school blazers anggota-anggota paduan suara itu memakai jaket seragam sekolah.
bldg.	(building) gedung.
bleach	kb. obat pengelantang/kelantang. -kkt. 1 memutihkan. 2 mengelantang. -bleaching kb. pemutihan.
bleacher	kb. tempat duduk terbuka di stadion.
bleak	kb. 1 suram. 2 suram, gelap. -bleakly kk. suram, membosankan.
bleakness	kb. rasa suram.
bleary	ks. muram, bilis. her eyes loocked b. matanya kelihatan muram. bleary-eyed bermata muram.
bleat	bleat
bled	lih bleed.
bleed	kkt. (bled) mengambil/mengeluarkan darah. -kki. 1 berdarah. 2 mengeluarkan darah. 3 luka, sedih. 4 berkorban. - bleeding kb. perdarahan (dari hidung, dsb.).
blemish	kb. cacat, cela. -kkt. mencemarkan, merusak, menodai.
blend	kb. 1 campuran. 2 paduan. -kkt. mencampurkan. -kki. cocok. -blended ks. campuran.
blender	kb. alat tempat pencampur, tempat adonan, pencampur.
bless	kkt. (blessed atau blest) 1 memberkahi, merestui. 2 mendoakan. -blessed ks. 1 menyenangkan. 2 inf.: gila. -blessing kb. 1 berkah. 2 untung.
blest	lih bless.
blew	lih blow.
blight	kb. 1 penyakit tumbuh-tumbuhan. 2 kutuk. -kkt. 1 merusakkan. 2 membinasakan.
blind	kb. 1 keraai, kere. 2 persembunyian. 3 pengadangan. -ks. buta, tunanetra. to go b. 1 menjadi buta. 2 samar-samar. -kkt. 1 menyilaukan. 2 mengaburkan.
blindfold	kb. 1 maskara. 2 kain penutup mata. -kkt. menutup mata dengan kain penutup mata.
blindness	kb. kebutaan, ketunanetraan.
bliss	kb. kebahagiaan.
blissfulness	kb. (penuh) kebahagiaan.
blister	kb. lepuh. -kkt. 1 menyerang dengan kata-kata yang tajam. 2 melepuhkan. -blistering ks. panas sekali. -blisteringly kk. panas terik/sekali.
blithe	ks. gembira, bahagia. b. spirit semangat gembira.
blitz	kb. serangan kilat.
blizzard	kb. badai salju.
bloat	kki. menjadi gembung. a goldfish will b. (up) if fed too much ikan mas akan menjadi gembung jika terlalu banyak diberi makan. -bloated ks. gembung, bengkak. he has a b. look mikanya kelihatan bengkak.
blob	kb. gumpal. a b. of paint segumpal cat.
bloc	kb. blok. the western b. blok barat.
block	kb. 1 blok. 2 balok (ganjal). 3 berkas. 4 kayu, cetakan. 5 kompleks. 6 rintangan. -kkt. 1 merintangi (a road). 2 menghalang (-halang) i. 3 memblokir. 4 membangun kembali. b. letter huruf balok/cetak.
blockade	kb. blokade, pemblokiran. -kkt. melakukan blokade, memblokir.
blockage	kb. halangan, rintangan.
blockbuster	kb. inf.: sejenis bom yang besar.
blockhead	kb. orang tolol.
blond	kb., ks. pirang. he's a b. dia berambut pirang. he has b. hair rambutnya pirang.
blonde	kb. si rambut pirang. did i see you with a b.? apakah saya lihat engkau dengan seorang (si) rambut pirang.
blood	kb. 1 darah. 2 berasal. b. bank pengumpulan/bank darah. b. brother saudara kandung. b. count jumlah susunan darah. b. tranfusion tranfusi darah, pindah tuang darah. b. type jenis darah.
bloodcurdling	ks. mengerikan. we heard a b. scream kita mendengar teriakan yang mengerikan.
bloodhound	kb. 1 anjing polisi. 2 sl.: reserse, mata-mata, polisi.
bloodies	lih bloody.
bloodless	ks. tidak menumpahkan darah. a b. battle pertempuran tidak menumpahkan darah.
bloodmobile	kb. mobil untuk pengumpulan darah.
bloodshed	kb. pertumpahann darah.
bloodshot	ks. merah karena sakit atau lelah (eye).
bloodstain	kb. bekas lumuran darah.
bloodstained	ks. berlumur darah. b. shirt kemeja berlumuran darah.
bloodsucker	kb. 1 lintah (darat), pacat. 2 pemeras uang, penghisap darah (of a person).
bloodthirsty	ks. haus darah, ganas.
bloody	ks. 1 berdarah. 2 yang banyak menumpahkan darah. 3 berdarah. -kkt. (bloodied) membuat berdarah.
bloom	kb. 1 kumpulan bunga. 2 masa remaja. -kki. berkembang. -blooming ks. 1 berbunga. 2 berkembang. 3 sl.: jahanam, sial, si celaka..
bloomer	kb. inf.: orang yang berkembang.
bloomers	kb., j. celana pof, celana pendek yang diikat dekat lutut.
bloosom	kb. kumpulan bunga. -kki. 1 mekar. 2 menjadi. to b. out menjelma menjadi.
blot	kb. noda bintik. -kkt. (blotted) 1 mengeringkan dengan kertas hisap. 2 mengotori, menodai.
blotch	kb. jerawat, bisul. several blotches on his face beberapa jerawat di mukanya.
blotter	kb. pengering tinta. police b. buku untuk menuliskan kejadian-kejadian yang berhubungan dengan pekerjaan polisi.
blouse	kb. blus.
blow	kb. 1 pukulan. 2 tamparan. 3 serangan. 4 angin ribut, bayu. -kkt. (blew, blown) 1 meniup. 2 membunyikan. 3 si.: mengeluarkan. -kki. 1 meniup. 2 berbunyi. 3 putus, meleleh. 4 bernapas.
blower	kb. 1 alat peniup. b. in a furnace peniup api dalam tungku. 2 tukang tiup.
blowgun	kb. sumpitan.
blown	lih blow.
blowout	kb. 1 ban kempes/pecah (of tire). 2 sl.: ramai, semarak.
blowpipe	kb. pipa peniup.2 sumpitan.
blowtorch	kb. obor las.
blowup	kb.1 ledakan, letusan.2 inf, : marah.3 pembesaran.
blubber	kb. lapisan lemak.-kki. menangis. the boy blubbered when he heard the sad news. anak laki-laki itu menangis ketika mendengar berita sedih itu.
bludgeon	kb. gada, pemukul. -kkt. memukul dgn gada, mengada.
blue	kb. biru. -ks.1 biru.2 murung, sedih. 3 biru, tdk senonoh, cabul. -blues j. inf.: 1 perasaan sedih/susah. 2 sejenis musik negro amerika. -blue(e) ing kb. biru, membirukan.
blueberry	kb. (j. -ries) sejenis arbei.
bluebird	kb. semacam burung yang pandai menyanyi ; jantannya berpunggung biru..
bluebottle	kb. lalat hijau.
bluegrass	kb. sejenis rumput yang berwarna kebiru-biruan.
bluenose	kb. inf.: seorang yang sangat keras dan teliti dalam hal sopan santun.
blueprint	kb. cetakan biru. -kkt. merencanakan. the entire operation was blueprinted seluruh operasi telah direncanakan.
bluestocking	kb. seorang perempuan yang mempunyai perhatian besar terhadap ilmu pengetahuan.
bluff	kb. 1 gerakan, gertak sambal, sok, lagak, pura-pura. 2 geol.: jurang tebing (di pantai atau sungai). -kkt. maju dengan gerakan. -kki. menggertak.
bluffer	kb. penggertak, pelagak.
bluish	ks. kebiru-biruan. the point has a b. tint cat itu kebiru-biruan warnanya.
blunder	kb. kesalahan besar. -kki. membuat kesalahan besar. you blundering idiot kamu tolol.
blunt	ks. 1 tumpul. 2 kasar. 3 berterus-terang. -kkt. 1 menjadikan tumpul. 2 menumpulkan. -bluntly kk. berterus-terang, blak-blakan.
bluntness	kb. 1 ketumpulan. the b. of the pencil point ketumpulan ujung pensil. 2 kekasaran. the b. of his manner kekasaran tingkahlakunya.
blur	kb. kabur, remang-remang. -kkt. (blurred) mengaburkan.
blurb	kb. inf.: pujian, uraian singkat isi buku sebagai perkenalan atau iklan
blurry	ks. kabur. the tv picture is b. gambar di layar tv itu kabur.
blurt	kkt. berkata tanpa berfikir, mengatakan sesuatu yang harus dirahasiakan.
blush	kb. merah muka. -kki. menjadi merah. -blushing ks. merah kemalu-maluan.
bluster	kb. 1 angin yang keras. 2 pembicaraan yang keras. -kkt. menggertak. -kki. berbicara dengan keras, menggertak.
blustery	ks. 1 kencang (of wind). 2 yang (suka) menggertak (of a person)
blvd.	(boulevard) jalan raya di kota.
bn.	(battalion) batalyon.
boar	kb. babi. wild b. babi hutan.
board	kb. 1 papan. 2 papan tulis. 3 makanan. 4 dewan pengurus. -boards j. pentas, panggung. -kkt. 1 naik. 2 menerima. -kki. indekos. -boarding kb. papan.
boarder	kb. orang indekos. to take in boarders mengambil/menerima orang-orang indekos.
boardwalk	kb. papan untuk berjalan misalnya di pasir.
boast	kb. pembualan, besar mulut. -kkt. membanggakan. -kki. menyombongkan diri. he boasts too much ia terlalu menyombongkan diri.
boastful	ks. sombong. he has a b. attitude ia mempunyai sikap sombong. -boastfully kk. dengan sombong.
boat	kb. 1 kapal. 2perahu, sekoci. 3 sampan. -boating kb. bersampan, berlayar, berdayung.
boatbuilding	kb. pembangunan/pembuatan kapal.
boathouse	kb. gudang kapal
boatload	kb. muatan kapal, sekapal penuh. a b. of fish ikan satu muatan kapal.
boatman	kb. (j. -men) 1 orang yang menjaga atau memelihara kapal. 2 pendayung 3 orang yang bekerja di kapal.
boatswain	kb. serang, kepala kelasi, mador kapal.
boatyard	kb. 1 tempat memperbaiki dan menyimpan kapal. 2 pangkalan kapal.
bob	kb. potongan rambut yang pendek. -kkt. (bobbed) memotong pendek rambut. -bobbed ks. dipotong pendek (hair).
bobbin	kb. kumparan.
bobby pin	kb. jepit (an) rambut.
bobby socks	kb., j. inf.: kaus kaki pendek sampai mata kaki.
bobby soxer	kb. inf.: gadis remaja.
bobsled	kb. gerobak tanpa roda yang diseret.
bode	kkt., kki menjadi tanda. -boding kb. tanda-tanda. we had a b. of some calamity kami mendapat tanda-tanda malapetaka.
bodice	kb. korset.
bodily	ks. jasmani(ah). -kk. hidup-hidup.
body	kb. (j. -dies) 1 badan, tubuh. 2 kumpulan, badan. 3 benda. 4 karoseri. 5 mayat. 6 pokok. 7 gerombolan. 8 majelis. 9 isi.
bodyguard	kb. pengawal.
bog	kb. tanah berlumpur. -kki. (bogged) to b. down macet, terhenti.
bogey	kb. golf : angka lebih satu dari par.
bogeyman	kb. (j. -men) hantu. the b. of starvition hantu kelaparan.
boggle	kkt. mengejutkan. -kki. meragukan.
bogus	ks. 1 gadungan, sok. 2 palsu.
bohemian	kb. orang yang berkehidupan bebas, seperti seniman.
boil	kb. 1 bisul, borok. 2 mendidih. -kkt. merebus (eggs). kki. 1 direbus. 2 panas sekali. 3 mendidih. -boiled ks. yang direbus. -boiling ks. mendidih.
boiler	kb. 1 dandang (for rice). 2 ketel. 3 ketel uap (on a ship, etc.).
boisterous	ks. riuh, ramai. a b. party pesta yang ramai.
bold	ks. 1 berani. 2 tegas. 3 hebat. to make b. berani, memberanikan diri.
boldface	kb. huruf/cetakan tebal.
boldness	kb. kegagahan, keberanian.
bolero	kb. 1 semacam tari spanyol. 2 blus pendek wanita.
boll weevil	kb. kumbang yang biasanya bertelur di buah kapas dan merusak buah itu.
bologna	kb. sosis besar yang dipanggang, dibuat dari daging sapi, sapi muda atau daging babi.
bolster	kb. bantal panjang, semacam guling. -kkt. menyokong, mendukung.
bolt	kb. 1 baut. 2 grendel kunci. 3 gulungan kayu(h), blok bahan untuk baju yang panjangnya 40 yard. -kkt. 1 memalang. 2 menolak mendukung. -kki. meloncat, lari.
bomb	kb. bom. -kkt. membom (a city). -kki. sl.: gagal. -bombed ks. dibom. a badly b. city kota yang dibom (dengan) hebat.
bombard	kkt. 1 membom, membombardir, menyerang dengan tembakan-tembakan berat. 2 menyerang, mendebat.
bombardier	kb. awak pesawat terbang yang membidikkan bom dan melepaskan bom secara mekanis, juru bom di pesawat terbang.
bombardment	kb. bombardemen, pengeboman.
bombast	kb. 1 bahasa yang terdengar baik tetapi tak berarti. 2 omong besar.
bombastic	ks. berisi kata-kata yang muluk-muluk. b. speech pidato berisi kata-kata yang muluk-muluk.
bomber	kb. pembom, bomber.
bombproof	ks. tahan serangan bom. this building is b. bangunan ini tahan serangan bom/granat.
bombshell	kb. bom. the news of the assassination came like a b. berita pembunuhan itu amat mengejutkan.
bona fide	ks. jujur, bisa dipercaya. is it a b. offer? apakah itu penawaran yang jujur?
bonanza	kb. 1 bijih yang amat banyak didalam tambang. 2 sumber keuntungan.
bonbon	kb. 1 kembang gula. 2 segala manisan yang dibuat dari gula.
bond	kb. 1 tali, pertalian, ikatan. 2 surat obligasi. 3 surat tanggungan. 4 pengikat, ikatan. -kkt. 1 mengeluarkan obligasi atas 2 mempertanggungkan. 3 mengganti dengan obligasi. 4 menahan barang digudang sampai beanya/pajaknya terbayar. 5 mengikat.
bondage	kb. perbudakan, perhambaan.
bondsman	kb. (j. -men). orang jaminan.
bone	kb. 1 tulang. 2 duri, -kkt. menulangi (a fish, chiken). -kki. sl.: mempelajari bone-dry ks. kering sekali. b. meal tepung tulang.
boneless	ks. tanpa tulang. b. chicken ayam cabut tulang.
boner	kb. sl.: kesalahan yang bodoh. to make a b. membuat kesalahan yang bodoh.
bonfire	kb. api unggun, api besar yang dinyalakan di langit terbuka.
bonnet	kb. topi, biasanya diikat dibawah dagu dengan tali atau pita, dipakai oleh wanita, anak-anak perempuan dan bayi.
bonus	kb. uang jasa, grafitasi.
bony	ks. 1 kelihatan tulangnya, tulangnya menonjol, kurus. 2 banyak tulangnya.
boo	kb. 1 olokan, ejekan. boo. he said "boo" and she jumped ia mengatakan "boo" dan ia melompat. -kkt. memperolokkan.
boo-boo	kb. sl.: kesalahan yang bodoh. to make a b. membuat kesalahan bodoh.
booby	kb. (j. -bies) seorang tolol. 2 mil.: perangkap yang tersembunyi, ranjau.
boobytrap	kb. ranjau. -kkt (boobytrapped) memasang bom atau ranjau.
boogie-woogie	kb. semacam tarian dengan irama "blues" yang dipercepat.
boohoo	kki. menangis dengan keras. you have nothing to b. about engkau tak usah menangis keras.
book	kb. 1 buku. 2 kitab. -books j. buku-buku, semua catatan perusahaan. -kkt. 1 memesan. 2 mencatat. -booking kb. 1 pemesanan. 2 dicatat, dipesan.
bookbinder	kb. penjilid buku.
bookbindery	kb. penjilidan buku.
bookcase	kb. lemari buku.
bookie	kb. bandar (taruhan).
bookish	ks. 1 terlampau kebuku-bukuan. 2 gemar buku.
bookkeeper	kb. pemegang buku.
bookkeeping	kb. tata/pemegangan buku.
booklet	kb. buku kecil, brosur.
bookmaker	kb. tukang/juru taruh.
bookmaking	kb. 1 menulis atau menerbitkan buku. 2 penyelenggaraan taruhan.
bookmark	kb. penunjuk halaman buku.
bookmobile	kb. perpustakaan keliling.
bookseller	kb. 1 penjual buku. 2 toko buku.
bookselling	kb. penjualan buku.
bookshop	kb. toko buku.
bookstore	kb. toko buku.
bookwork	kb. 1 pekerjaan yang berhubungan dengan pembukuan. 2 pekerjaan yang berhubungan dengan mempelajari buku.
bookworm	kb. orang yang gemar membaca buku.
boom	kb. 1 ledakan, dentuman. 2 bom, perintang pelabuhan. 3 sangat laku. 4 tangan-tangan, tiang. -kkt. menganjurkan, mengusulkan. -kki. 1 berhasil. 2 mengatasi. -booming ks. besar, nyaring.
boomerang	kb. bumerang. -kki. merugikan dirinya sendiri, kembali mengenai dirinya sendiri.
boon	kb. anugerah, hikmah, keuntungan. her presence was a b. to her mother kehadirannya adalah suatu anugerah bagi ibunya. b. companion sahabat baik.
boondoggle	kb. sl.: pekerjaan yang tidak ada faedahnya. this work is nothing but a b. pekerjaan ini semata-mata tidak ada hasilnya hanya membuang-buang waktu saja.
boor	kb. orang yang tidak tahu adat/yang tidak sopan.
boorish	ks. kasar, tidak tahu adat, tidak sopan.
boorishness	kb. kekasaran, ketidaksopanan.
boost	kb. 1 dorongan. 2 tambahan. -kkt. menaikkan.
booster	kb. 1 pendorong, penyokong. 2 penggerak.
boot	kb. sepatu tinggi, lars, sepatu bot. 2 sl.: pemecatan. -kkt. menendang. 2 memecat.
bootblack	kb. tukang gosok sepatu.
bootee	kb. sepatu bayi.
booth	kb.1 tempat pojok.2 tel, : sel/tempat telpon. 3 pojok.4 stan. 5 kamar.
bootleg	kb. pembuatan, pengangkutan atau penjualan yg melanggar undang-undang.-kkt. (bootlegged) menyelundupkan atau membuat tanpa izin.
bootlegger	kb. penyelundup atau pembuat minuman keras.
bootlick	kkt. si. : menjilat. the youth bootlicked his teacher in order to get a good grade pemuda itu menjilat gurunya utk mendapatkan angka yg baik.
bootlicker	kb, si. : penjilat.
bootstrap	kb. gantungan sepatu lars/bot. by o's bootstraps dgn usaha sendiri.
booty	kb. (barang) rampasan.
booze	kb. inf. : minuman keras.
bop	kb. sl. : pukulan. -kkt. (bopped) memukul, meninju.
borax	kb. borak, bubuk sodium borak, obat pembersih barang-barang.
border	kb. 1 batas, perbatasan.2 pinggir.-kkt. membatasi.-kkt. to b. on 1 berbatas kpd.2 mendekati, berdekatan dgn, berhampiran.
borderline	kb. garis batas, perbatasan
bore	kb. 1 orang yg membosankan. 2 kaliber.-kkt. 1 membor (a hole) 2 menjemukan, membosankan.-bored ks. jemu, bosan.-boring kb.pemboran.-ks. membosankan.
boredom	kb. kebosanan, rasa bosan/jemu.
born	lih. bear.
borne	lih. bear.
borough	kb. sektor, wilayah, kota kecil.
borrow	kkt. meminjam. may i b. your pencil ? bolehkah saya pinjam pensilmu? to b. trouble gelisah tanpa alasan. he always borrowing trouble dia selalu gelisah tanpa alasan.
borrower	kb. peminjam.
bos'in	boatswain.
bosom	kb. dada. they took the orphaned girl into the b. of their family mereka mengambil anak yatim itu menjadi anggota keluarga.
boss	kb. inf. : sep, kepala , atasan, majikan. -kkt. lnf, : main perintah.to boss s. o. around meraja thd
bossy	ks. lnf. : suka meraja.
botanical	ks. yg. berk. dgn tumbuh-tumbuhan.
botanist	kb. ahli tumbuh-tumbuhan.
botany	kb. ilmu tumbuh-tumbuhan,botani.
botch	kkt. merusak pekerjaan.
both	ks. kedua.-kg. 1 berdua.2 keduanya.
bother	kb. kesusahan, s.s.t. yg menyusahkan.-kkt. mengacaukan,menghiraukan, menggangu.-kki. bersusah-susah.
bothersome	ks. yg menyusahkan.
bottle	kb.1 botol. sl. : to hit the b. minum-minuman keras.2 (baby's) botol susu. -kkt. memasukkan kedlm botol.-bottled ks. yg di botolkan. -bottling kb. pembotolan.
bottleful	kb. sebotol (penuh). a b. of milk susu sebotol.
bottleneck	kb. 1 leher botol. 2 kemacetan.
bottom	kb. 1 dasar. 2 inf.: pantat. 3 tempat duduk. 4 kapal. -ks. paling bawah. -kkt. menaruh tempat duduk pada.
bottomless	ks. tak beralas, tak berdasar. b. pit lubang yang tak beralas.
bottommost	ks. terendah. the b. layer of shate lapisan yang terendah daripada batu-batu (yang halus).
botulism	kb. peracunan dalam makanan (teristimewa dalam kaleng).
boudoir	kb. kamar hias seorang wanita.
bouffant	kb. sasak (woman's hair style).
bough	kb. cabang (pohon).
bought	lih buy.
boulder	kb. batu besar (yang dimakan oleh arus air).
boulevard	kb. jalan besar.
boullion	kb. bulion, air daging. b. cube bulion yang dikeringkan berbentuk dadu.
bounce	kb. 1 inf.: keuletan. 2 lambungan (of a ball). -kkt. 1 melambungkan. 2 sl.: memecat. -kki. 1 mempelanting, mental. 2 dikembalikan. -bouncing ks. sehat, kuat.
bouncer	kb. sl.: tukang pukul. he's a b. at a night club dia tukang pukul dalam klab malam.
bouncy	ks. inf.: gembira dan bersemangat. he's a b. individual ia adalah seorang yang gembira dan bersemangat.
bound	kb. 1 loncatan. 2 lambungan. 3 lih bind. -bounds j. 1 batas 2 terlarang. 3 keluar batas. -ks. menuju. -kkt. 1 membatasi. 2 mengelilingi. - kki. meloncat.
boundary	kb. (j. -ries) batas.
boundless	ks. tidak ada batasnya. he is endowed with b. energy ia dikaruniai dengan semangat yang tidak ada batasnya.
bounteous	ks. pemurah. he's a b. giver dia seorang penderma yang sangat pemurah.
bountiful	ks. banyak dan melimpah-limpah. we had a b. christmas pada hari natal itu kami mendapat hadiah yang berlimpah-limpah.
bounty	kb. (j. -ties) 1 hadiah. 2 karunia, rahmat.
bouquet	kb. karangan bunga, buket.
bourbon	kb. sejenis wiski.
bourgeois	ks. burjuis. b. society masyarakat burjuis.
bourgeoisie	kb. kaum burjuis, bursuasi.
bout	kb. 1 pertandingan. these wrestlers will appear in the main b. jago-jago gulat ini akan muncul pada pertandingan utama. 2 penderitaan, penyakit. he had a b. with pneumonia dia lama menderita radang paru (paru).
bovine	ks. termasuk keluarga sapi.
bow	kb. 1 haluan. 2 tundukan. -kkt. menundukkan. -kki. 1 menundukkan kepala. 2 membungkuk.
bow-wow	kb. salak anjing. -kki. menyalak. the dog bow-wowed several time anjing itu menyalak beberapa kali.
bowdlerize	kkt. membuang bagian (cabul) dari suatu karangan atau buku.
bowel	kb. isi perut. -bowels j. 1 anat.: usus besar. 2 isi perut.
bower	kb. punjung.
bowknot	kb. ikatan simpul.
bowl	kb. 1 mangkuk. 2 sport : stadion. 3 kepala mangkok (of a pipe).-kki. bermain bola.guling.-bowling kb. permainan bola guling, bola pancang. b. alley tempat main bola guling, gelanggang bowling. b. pin gada.
bowlegged	ks. kaki bengkok/pengkar, pengkar kedalam.
bowler	kb. bowler, pemain bola guling.
bowlful	kb. semangkuk besar. a b. of ice cream semangkuk es krim.
box	kb.1 kotak, peti. mail b. kotak surat.2 (mail) kotak pos. 3 mus., then. : ruangan tempat duduk tersendiri di gedung opera.-kkt. mempak, memasukkan kedlm kotak.-kki. main tinju.-boxing kb. adu tinju.
boxcar	kb. gerbong barang (tertutup).
boxer	kb. 1 petinju, jago tinju.2 sm anjing.
boxwood	kb. sej. tumbuh-tumbuhan.
boy	kb. 1 anak laki-laki.2 wah.3 pria.-the boys j. pria. para/kaum lelaki. b. scout pandu. pramuka.
boycott	kb. boikot, pemboikotan. -kkt. memboikot, membekot.
boyfriend	kb. pacar.
boyhood	kb. masa kanak-kanak.
boyish	ks. kekanak-kanakan. kelaki-lakian.
br.	1 (british) orang inggris; inggris. 2 (britain) negeri inggris.
bra	kb. (kutang) beha, b.h.
brace	kb. 1 penjepit, penahan, penguat.2 pasang. a b. of pheasants sepasang burung kuau.-braces j. 1 alat penguat.2 tanda kurung besar.3 bingkai penunjang gigi.-kkt.menahan , memperkuat.inf, : to b. up 1 ayoh.2 menjadi segar.-bracing ks. yg menyegarkan/menguat
bracelet	kb. gelang.
brachial	ks. yang berhubungan dengan tangan. b. artery pembuluh darah yang berhubungan dengan tangan.
brachiopod	kb. sejenis ubur-ubur.
brachycephalic	ks. mempunyai kepala yang dan lebar.
bracket	kb. tanda kurung besar, akolade : []. 2 golongan. 3 siku-siku (untuk rak, dsb.). -kkt. 1 mengurung. 2 menggolong, mengumpulkan.
brackish	ks. payau.
brag	kki. (bragged) menyombong(kan), membual.
braggart	kb. penyombong, pembual.
bragger	kb. -braggart.
braid	kb. 1 kelabang (an), kepang (an), selampit. 2 jalinan pita (on a coat). -kkt. 1 mengelambang, mengepang, menyelampit. 2 menganyam (a rug).
braille	kb. tulisan/sistim brailye.
brain	kb. otak. -brains j. 1 otak. 2 pintar sekali. to beat o's brains memeras otak. to rack o's brains memutar otak. -kkt. sl.: memukul.
brainchild	kb. inf.: gagasan. this plan was his b. rencana ini adalah gagasannya.
brainpan	kb. tengkorak, batok/tulang kepala.
brainpower	kb. otak.
brainstorm	kb. inf.: ilham. your idea was a real b. gagasanmu itu adalah benar-benar ilham.
brainwash	kkt. mengindoktrinasi. -brainwashing kb. indoktrinasi.
brainy	ks. pintar, cerdas. a b. student seorang mahasiswa yang pintar.
braise	kkt. memasak daging (dengan tertutup rapat dan sedikit air).
brake	kb. rem. -kkt., kki. mengerem, merem. -braking kb. pengereman. b. power daya rem.
brakeman	kb. (j. -men). tukang rem.
bran	kb. kulit padi.
branch	kb. 1 dahan, ranting. 2 cabang, filial. 3 anak sungai. -kki. bercabang.
brand	kb. macam, jenis. -kkt. mencap. brand-new ks. baru sekali.
brandish	kkt. mengacungkan (a sword).
brandy	kb. (j. -dies) brendi, minuman keras.
brash	ks. kurang ajar. b. young man anak muda yang kurang ajar.
brashness	kb. kelancangan, kekurangajaran.
brass	kb. 1 kuningan. 2 inf.: kurang ajar. 3 sl.: pembesar. -brasses j. alat musik tiup. -ks. kuningan.
brassie	kb. pemukul golf kayu nomor 2.
brassiere	kb. (kutang) beha.
brassy	ks. seperti alat musik tiup. the orchestra has a b. quality permainan orkes itu menekankan musik tiup.
brat	kb. anak nakal/bandel. their child is a real b. anak mereka itu betul-betul anak yang nakal.
bravado	kb. besar mulut.
brave	kb. yang berani. -ks. berani. -kkt. memberanikan diri terhadap, menantang.
bravery	kb. (j. -ries) keberanian.
bravo	kseru. bagus! baik sekali!
brawl	kb. percekcokan. -kki. ribut. the drunken sailors brawled pelaut-pelaut yang mabok itu ribut.
brawn	kb. kekuatan, tenaga. b. and brain are needed in sports kekuatan dan pikiran diperlukan dalam olahraga.
bray	kb. bunyi keledai, ringkikan. -kki. meringkik. the donkey brayed keledai itu meringkik.
brazen	ks. kurang ajar, tidak tahu malu. -kkt. to b. s.t. out bersikap seolah-olah tidak malu.
brazier	kb. kompor arang, anglo.
breach	kb. 1 pelanggaran. 2 penebusan 3 pemutusan. -kkt. menerobos.
bread	kb. 1 roti. 2 makanan. -kkt. memasak dengan campuran roti. breaded veal chops daging sapi muda cincang dimasak dengan campuran roti.
breadbasket	kb. 1 keranjang roti. 2 sl.: perut.
breadboard	kb. 1 papan tempat memotong roti. 2 papan untuk membuat roti.
breadbox	kb. peti untuk roti.
breadcrumb	kb. remah roti.
breadfruit	kb. buah keluwih/sukun.
breadth	kb. 1 luas. 2 lebar, kelebaran (of a table).
breadwinner	kb. pencari nafkah, penyambung hidup.
break	kb. 1 patah. 2 putusnya. 3 keretakan. 4 perubahan. 5 istirahat, paus. 6 sl.: kesempatan. 7 nasib. 8 pemutusan. -kkt. (broke, broken) 1 memecahkan. 2 mematahkan 3 memutuskan 4 menghentikan. 5 merusakkan. 6 menahan. 7 menguraikan. 8 melanggar.
breakable	ks. mudah pecah. this phonograph record is b. piringan hitam ini mudah pecah.
breakage	kb. kerusakan. our overseas shipment suffered considerable b. kiriman kita keluar negeri mengalami kerusakan yang agak besar.
breakdown	kb. 1 kemacetan. 2 kerusakan. 3 perincian. 4 gangguan. 5 laporan.
breaker	kb. gelombang besar. the breakers crash on the beach at waikiki gelombang-gelombang besar memecah di pantai waikiki. he's a b. of hearts ia seorang yang suka mematahkan hati orang lain.
breakfast	kb. sarapan, makan pagi. -kki. sarapan. i always b. on eggs saya selalu sarapan telur.
breakneck	ks. sangat berbahaya. the car went at b. speed, mobil itu meluncur dengan kecepatan yang sangat berbahaya.
breakout	kb. kelolosan, kejebolan (from prison).
breakthrough	kb. 1 pemecahan. 2 mil.: penerobosan.
breakup	kb. perceraian. the b. of the family was a sad occasion perceraian dalam keluarga itu suatu peristiwa yang menyedihkan.
breakwater	kb. tembok laut, bendungan/pemecah gelombang.
breast	kb. 1 dada. 2 (female) buah dada, tetek, payudara. -kkt. berlayar menghadapi, menyongsong. breast-fed ks. disusui. breast-high ks. setinggi dada. b. stroke gaya dada.
breastbone	kb. tulang dada.
breastpin	kb. pin, peniti, bros.
breastworks	kb. benteng, pertahanan, apilan, tembok pertahanan.
breath	kb. 1 nafas. 2 tiupan (udara). 3 sedikit. out of b. kehabisan nafas, terengah-engah.
breathe	kkt. 1 menghirup. 2 meniupkan. 3 mengatakan, menyebut-nyebut. -kki. bernafas. -breathing kb. pernafasan.
breather	kb. istirahat. it's verry hot today; let's take a b. hari ini sangat panas ; marilah kita beristirahat.
breathless	ks. 1 terengah-engah, sesak nafas. 2 tak ada angin sama sekali.
breathtaking	ks. mendebarkan hati, menyesakkan nafas, mempesonakan. the view was b. pemandangan itu mendebarkan hati.
bred	lih breed.
breech	kb. 1 gagang bedil. 2 bagian belakang. b. delivery kelahiran sungsang, kelahiran bayi terbalik.
breechcloth	kb. cawat, kain basahan.
breeches	kb., j. celana. b. buoy sejenis pelampung berbentuk celana diikat kepada kerekan digunakan untuk menolong orang yang mendapat kecelakaan.
breed	kb. keturunan, jenis, asal. -kkt. (bred) 1 memelihara. 2 membiakkan 3 membidik. -menternakkan. -breeding kb. 1 pemeliharaan. 2 pendidikan, asuhan.
breeder	kb. 1 peternak. 2 banyak keturunannya.
breeze	kb. angin sepoi-sepoi. -kkt. inf.: to b. by melewati dengan cepat.
breezeway	kb. gang (beratap) a b. connects the house with the garage suatu gang menghubungkan rumah itu dengan garasi.
breezy	ks. 1 berangin lembut. a b. day hari yang banyak angin lembut. 2 gembira. he has a b. manner about him dia mempunyai sifat gembira.
brevity	kb. (j. -ties) keringkasan, kecekatan, ketangkasan. for brevity's sake untuk singkatnya.
brew	kb. masakan, buatan. -kkt. membuat, masak. -kki. timbul, terjadi.
brewer	kb. pembuat/pemasak bir.
brewery	kb. (j. -ries) tempat pembuatan bir.
brialliant	ks. 1 cemerlang. 2 cerah. 3 ulung. 4 pandai.
bribe	kb. (uang) sogok, suap, uang semir. -kkt. menyogok,
bribery	kb.(j. -ries) suapan, penyuapan, sogok, penyogokan.
bric-a-brac	kb. hiasan-hiasan dari pecah belah.
brick	kb.1 (batu) bata, batu, batu merah/tembok. 2 lnf, : orang yg baik. -kkt.menembok.
brickbat	kb. pecahan batu bata.2 lnf. : kecaman yg pedas.
bricklayer	kb. tukang batu/tembok.
brickwork	kb. pekerjaan membuat tembok, menembok, pendinginan.
brickyard	kb. tempat penjualan atau pembuatan batu bata.
bridal	ks. yg berh, dgn pengantin. b. bed pelamin. b. bouquest karangan bunga untuk pengantin. b.procession perarakan pengantin.
bride	kb. pengantin wanita/perempuan.
bridegroom	bridegroom
bridesmaid	kb. gadis pengiring pengantin.
bridge	kb. 1 jembatan. 2 cards : brid(ge) (main kartu). 3 (of teeth) pegangan untuk gigi palsu. 4 nau.: anjungan (kapal). 5 batang (of the nose). 6 kam, kuda-kuda (of a violin). -kkt. 1 memasang jembatan. 2 mempertemukan. 3 menutup.
bridgehead	kb. 1 pangkalan terdepan/lompatan. 2 pangkalan jembatan.
bridgework	kb. pegangan untuk gigi palsu.
bridle	kb. kekang. -kkt. mengekang. she bridled the horse dia mengekang kuda itu.
brief	kb. laporan singkat. -briefs j. celana dalam yang pendek sekali. -ks. 1 singkat. -kkt. memberi penerangan ringkas. -briefing kb. penerangan yang ringkas, uraian.
brier	kb. tanaman yang berduri.
brig	kb. 1 nau.: kici, sejenis kapal yang bertiang dua. 2 nau.: tempat tahanan dalam kapal perang. 3 (jail) penjara.
brigade	kb. 1 brigade. 2 pasukan. fire b. pasukan pemadam api.
brigadier	kb. b. general brigadir jenderal.
brigand	kb. perampok.
bright	ks. 1 cemerlang. 2 cerdas. 3 gembira. 4 terang. 5 bijaksana. 6 ringan.
bright's	kb. b. disease penyakit ginjal.
brighten	kkt. menjadikan terang. -kki. menjadi terang
brightness	kb. 1 kecemerlangan, keterangan. 2 kecerdasan, kepandaian (of mind).
brilliance	kb. 1 kecemerlangan. the b. of the sun kecemerlangan matahari. 2 kecerdasan. his b. showed up on the examination kecerdasannya kentara dalam ujian.
brilliantine	kb. minyak rambut.
brim	kb. pinggir. -kki. (brimmed) meluap.
brimful	kb. penuh sekali.
brimless	ks. tidak bertepi. b. hat topi yg tak bertepi
brimstone	kb. (batu) belerang.
brine	kb. air asin
bring	kkt. (brought) 1 membawa. 2 mengambilkan 3 membawakan.4 mengajukan.to b. about 1 menghasilkan 2 menimbulkan. 3 menyebabkan. 4 mengadakan. to b. around 1 menginsyafkan, menyakinkan 2 menyadarkan. membawa. to b. ashore mendaratkan.
brink	kb. pinggir, tepi. b.of an abyss pinggir jurang.
brinkmanship	kb. penerusan politik luar negeri sekalipun menuju perang, nekad/nyerempet bahaya.
briny	ks. asin, masin. b. water air asin.
briquet(te)	kb. bata, batu, balok, gundu. b. of salt batu garam.
brisk	ks. 1cepat. he takes a b. walk every morning dia melakukan jalan cepat tiap pagi. 2 tajam. his remarks were very b. ucapan-ucapannya sangat tajam. 3 dingin. it's a b. morning pagi ini agak dingin.
bristle	kb. bulu. -kkt. 1 meremang, bulunya tegak/berdiri. 2 siap untuk berperang.
brit.	(british) inggeris. 2 (britain) negeri inggeris.
britain	kb. negeri inggeris, britania.
britches	inf.: = breeches.
briticism	kb. kata/ungkapan dipakai teristimewa di inggeris, britisisme.
british	kb. orang inggeris. they are b. mereka orang inggeris. -ks. inggeris, britis. the b. people bangsa inggeris.
britisher	kb. warganegara inggeris.
briton	kb. pribumi/penduduk britania raya.
brittle	ks. rapuh. chalk is b. kapur rapuh.
brittleness	kb. kerapuhan.
bro. bro.	(brother, brother) saudara.
broach	kb. bros, peniti. -kkt. memulai pembicaraan.
broad	kb. sl.: gadis, wanita. -ks. 1 lebar. 2 luas. 3 besar. 4 kasar. -broadly kk. (dengan) lebar.
broadcast	kb. siaran radio. -kkt. 1 menyiarkan (the news). 2 menaburkan. (seed). -broadcasting kb. 1 siaran radio. 2 penyiaran.
broadcaster	kb. penyiar radio.
broadcloth	kb. sejenis kain tenunan halus terbuat daripada sutera, kapas atau rayon untuk dibuat kemeja, piyama atau pakaian-pakaian lainnya.
broaden	kkt. meluaskan. -kki. bertambah lebar. -broadening kb. pelebaran, peluasan. -ks. yang meluaskan.
broadloom	kb. (tenunan) lebar. b. carpet permadani lebar.
broadness	kb. keluasan, luasnya, lebarnya.
broadside	kb. 1 tembakan serentak. 2 selebaran. -kk. seluruh sisi..
brocade	kb. kain brokat.
broccoli	kb. sejenis kobis atau blumkol hijau warnanya.
brochure	kb. brosur.
brogue	kb. 1 aksen, lagu. 2 semacam sepatu.
broil	kkt. memanggang. -broiling ks. panas sekali/terik.
broiler	kb. 1 ayam panggang/daging.
broke	ks. tidak mempunyai uang, kantong kempes . i'm b. saya tidak mempunyai uang. to go b. bangkrut. falit. lih break.
broker	kb. pedagang perantara/komisi.
brokerage	kb. perdagangan perantara/komisi.
bromide	kb. 1 inf.: umum diketahui. that saying is an old b. peribahasa/pepatah itu sudah umum diketahui. 2 bromida.
bronchial	ks. yang berhubungan dengan cabang tenggorok(an). b. tube pembuluh tenggorok(an).
bronchitis	kb. penyakit bronkhitis, radang cabang tenggorok(an).
bronx	kb. wilayah kota new york. sl.: b. cheer tiupan dengan bibir tertutup yang mengeluarkan bunyi, peluitan dengan bibir tertutup.
bronze	kb., ks. perunggu. -kkt. menjadikan merah tua.
brooch	kb. bros, peniti.
brood	kb. 1 seperindukan. 2 anak-anak. -kkt. mengerami. -brooding ks. memikir-mikirkan (hal-hal yang sedih).
brook	kb. serokan, selokan, alur(an). -kkt. membolehkan, membiarkan.
broom	kb. sapu. a new b. sweeps clean orang baru itu kerjanya selalu baik.
broomstick	kb. gagang/pegangan sapu.
bros., bros.	(brothers, brothers) william bros. departement store toko serbaada kepunyaan williams bersaudara.
broth	kb. bulyon, air daging.
brothel	kb. rumah pelacuran/sundal/jalang, rumah wanita p. pegermoan.
brother	kb. 1 saudara laki-laki. 2 kakak beradik. 3 rel.: broeder. brother and sisters saudara-saudara. brother-in-law (j. brothers-in-law) ipar laki-laki.
brotherhood	kb. persaudaraan.
brotherly	ks. (bersifat) persaudaraan. b. affection kemesraan persaudaraan.
brought	lih bring.
brow	kb. 1 alis. 2 kening. to knit o's b. mengerutkan kening. 3 pundak.
browbeat	kkt. (browbeat, browbeaten) menakut-nakuti, menggertak. -browbeaten ks. dipertakuti.
brown	kb. warna coklat. -ks. 1 coklat. 2 pirang. -kkt. menggoreng sampai garing, menggaringkan.
brownie	kb. kue coklat biasanya berisi kacang atau biji-biji lain. b. kb. kurcaci dari pandu putri, anggota termuda dari pandu putri.
brownish	brownish
browse	kki. 1 melihat-lihat (in a shop). 2 membaca-baca. 3 makan disana-sini, makan tunas-tunas, makan rumput.
bruise	kb. (luka) memar. -kkt. 1 luka memar, (biru) lebam. 2 rusak. 3 menyakiti hati. -kki. mendapat memar. -bruising ks. yang menimbulkan luka memar.
bruiser	kb. inf.: tukang/jago berkelahi. that fellow is a real b. pemuda itu betul-betul tukang berkelahi.
brunch	kb. ( = breakfast + lunch) inf.: makan antara sarapan dan makan siang.
brunette	kb. sirambut coklat. she's an attractive b. ia seorang berambut coklat yang menarik.
brunt	kb. 1 bagian yang terberat. 2 pukulan yang terberat.
brush	kb. 1 sikat. 2 kuas. 3 pertempuran. 4 semak-semak. 5 kol ( in a generator). -kkt. 1 menyikat. 2 menyeka(kan). -kki. bersentuhan. -brushing kb. penyikatan.
brushoff	kb. inf.: penolakan, tolakan.
brushup	kb. mempelajari kembali. before i give my speech i had better have a little b. on my subject sebelum saya berpidato lebih baik saya mempelajari kembali pokok pembicaraan saya.
brushwood	kb. semak, belukar.
brusque	ks. kasar. he has a b. manner ia kasar dalam tingkahlakunya.
brusqueness	kb. kekasaran.
brutal	ks. 1 kejam. he's b. ia orang kejam. 2 kasar. b. remark ucapan yang kasar.
brutality	kb. (j. -ties) kekejaman.
brute	kb. orang yang kejam dan kasar, orang tanpa perikemanusiaan. -ks. kasar.
brutish	ks. kasar. his manner was b. tingkah lakunya kasar/kebinatangan.
bu.	(bushel) gantang.
bubble	kb. 1 gelembung. 2 gagasan. -kki. menggelembung, bergelembung-gelembung. to b. over meluap-luap. b. gum permen karet yang bisa menggelembung.
bubbly	ks. penuh gelembung. b. champagne sampanye yang penuh gelembung.
bubonic	kb. b. plague penyakit pes.
buccaneer	kb. bajak laut.
buck	kb. 1 rusa jantan. 2 sl.: dolar. -kkt. melawan.
bucket	kb. ember, timba. sl.: to kick the b. mati, meninggal (dunia). b seat tempat duduk yang kecil dan bersandaran bulat.
buckeye	kb. sejenis pohon.
buckle	kb. gesper, timang. -kkt. mengaitkan. -kki. 1 melengkung. 2 rebah. -buckling kb. tekuk.
buckram	kb. linan untuk menjilid buku.
buckshot	kb. peluru.
bucktooth	kb. gigi yang mencuat/menganjur kedepan.
buckwheat	kb. soba.
bucolic	ks. pedusunan. the house was located in a b. setting rumah itu terletak dalam satu lingkungan pedusunan.
bud	kb. 1 sl.: nak, jang. 2 pucuk, kuncup, semi. -kki. (budded) berpucuk. -budding ks. naik bintang.
buddha	kb. buda.
buddhism	kb. agama buda.
buddhist	kb. penganut buda. -ks. buda. b. beliefs kepercayaan-kepercayaan buda.
buddy	kb. (j. -dies) inf.: teman baik. the two boys are buddies kedua pemuda itu teman baik.
budge	kkt. 1 mengalihkan. 2 mengalah. -kki. berpindah tempat.
budget	kb. anggaran belanja, neraca keuangan. -kkt. mengatur. -budgeting kb. penganggaran belanja.
budgetary	ks. yang berhubungan dengan anggaran belanja.
buff	kb. 1 inf.: telanjang. 2 penggemar. 3 kekuning-kuningan. -kkt. mengkilapkan.
buffalo	kb. banteng, kerbau. -kkt. sl.: memperdayakan, menggertak.
buffer	kb. 1 (tenaga) penahan, penyangga. 2 kain penggosok. b. state negara (kecil) yang letaknya antara dua negara besar yang bermusuhan. b. zone daerah penyangga.
buffet	kb. bupet. i keep the silver in the b. saya menyimpan barang-barang (sendok-sendok) perak didalam bupet.
buffoon	kb. pelawak, badut.
bug	kb. 1 hama, binatang-binatang kecil. 2 inf.: penyakit. 3 sl.: mikropon kecil. 4 inf.: kesalahan, kerusakan. -kkt. (bugged) sl.: 1 memasang alat pendengar rahasia dalam satu ruang. 2 mengganggu. bug-eyed ks. melotot, membelalak.
bugaboo	kb. momok. math is my b. ilmu pasti adalah momok bagi saya.
bugbear	kb. momok.
buggy	kb. (j. -gies) kereta beroda empat (seperti andong).
bugle	kb. terompet, selompret.
bugler	kb. peniup selompret.
build	kb. tubuh. -(built). 1 membangun, mendirikan. 2 membuat. 3 mendasarkan. -kki. 1 bertambah. 2 membangun. build-up kb. 1 penerangan yang baik tentang seseorang. 2 penambahan kekuatan built-in ks. terpasang tetap, imbo. built-up ks. mempunyai banyak gedung.
bulb	kb. 1 elec.: bola lampu, lampu pijar, bohlam. 2 ubi-ubian. 3 pentolan. b. of a thermometer pentolan thermometer.
bulbar	ks. yang berhubungan dengan bengkak. b. poliomyelitis penyakit polio pada sumsum tulang belakang.
bulbous	ks. 1 berumbi, yang berhubungan dengan ubi-ubian. tulips are b. plants bunga tulip tanaman yang berumbi. 2 yang berhubungan dengan pentolan, bulat. he has a b. nose hidungnya bulat.
bulgarian	kb., ks. yang berasal dari bulgaria. he's b. ia seorang bulgaria.
bulge	kb. 1 yang menonjol. 2 tambahan. 3 tonjolan. -kki. menonjol.
bulk	kb. bagian terbesar. in b. dalam borongan. -kki. menjadi penting.
bulkhead	kb. dinding pemisah dalam kapal, dinding petak kapal, sekat.
bulky	ks. besar sekali, mengambil tempat banyak. this box is b. peti ini besar sekali.
bull	kb. 1 sapi jantan. b. race karapan sapi. 2 fin.: spekulan atas naiknya harga efek-efek. 3 sl.: omong kosong. sl.: to shoot the b. membual, mengobrol. -kkt. inf.: masuk dengan kekerasan, lewat dengan mendesak. bull's 1 sasaran 2 jawaban yang tepat.
bulldog	kb. bulldog. (sejenis anjing).
bulldoze	kkt. 1 meratakan. 2 memaksa dengan kekerasan.
bulldozer	kb. buldoser.
bullet	kb. pelor, peluru.
bulletin	kb. 1 siaran singkat kabar terakhir,, pengumuman terakhir. 2 pengumuman, siaran.
bulletproof	ks. tahan peluru.
bullfight	kb. perkelahian manusia melawan banteng di tempat terbatas yang dipertontonkan.
bullfighter	kb. pekelahi sapi.
bullfighting	kb. perkelahian manusia melawan banteng di tempat yang dibatasi untuk tontonan.
bullfrog	kb. katak betung.
bullheaded	ks. (ber)keras kepala, mengotot. he's aufully b. about the matter ia sangat mengotot mengenai soal itu.
bullion	kb. emas atau perak dalam jumlah besar, emas lantak(an).
bullish	ks. fin.: menunjukkan gejala meningkat. the stock market was b. bursa menunjukkan gejala meningkat.
bullock	kb. banteng, sapi jantan.
bully	kb. (j. -lies) penggertak, orang yang mengganggu orang lemah. -ks. inf.: baik, bagus, kelas satu, nomor wahid. -kkt. (bullied) menggertak, mengganggu.
bulwark	kb. 1 pertahanan, benteng. 2 sokongan. 3 kubu. -bulwarks j. kubu (pagar kapal).
bum	kb. sl.: orang gelandangan/bambungan. -ks. sl.: 1 tidak baik. 2 ceroboh. 3 cacat (of a leg, arm, etc.). -kkt. (bummed) 1 membonceng. 2 menebeng, meminta -kki. 1 luntang-lantung, hidup berkeluyuran. 2 hidup bergelandangan.
bumblebee	kb. tawon besar.
bumbling	ks. kikuk, canggung. he's nothing but a b. idiot dia seorang yang tolol dan canggung.
bump	kb. benjol, jendul. -kkt. 1 menabrak, menubruk. 2 inf.: menggeser dan mengambil tempat orang lain.
bumper	kb. auto : bemper. -ks. inf.: yang luar biasa besarnya.
bumpy	ks. 1 tidak rata, bergelombang. b. road jalan yang tidak rata. 2 melonjak-lonjak. b. plane fight penerbangan yang penuh lonjakan.
bun	kb. 1 sejenis kue berisi kismis. 2 sanggul. she wears her hair in a b. dia bersanggul.
bunch	kb. 1 ikat. 2 gerombolan. 3 rangkai 4 sikat, sisir. 5 tandan. 6 berkas. 7 inf.: kumpulan, kelompok. -kkt. menyatukan. to b. up duduk berdekat-dekatan.
bundle	kb. 1 buntel(an). 2 ikat. 3 berkas. -kkt. membendel (newspapers, letters).
bung	kb. tutup (of cask, barrel). place the b. in the hole taruhlah tutup pada lubang.
bungalow	kb. bungalo, banglo.
bungle	kkt. mengerjakan dengan ceroboh/serampangan. -kki. mengerjakan secara serampangan. -bungling ks. yang ceroboh, yang serampangan, tanpa keahlian.
bunion	kb. bengkak pada ibu jari kaki yang bisa menjadi radang.
bunk	kb. 1 bangku tidur. 2 sl.: omong kosong. -kki. 1 inf.: diam bersama-sama. 2 tidur di seadanya tempat.
bunker	kb. 1 mil.: lubang perlindungan, tembok pertahanan. 2 golf : bunker, lubang berisi pasir. 3 ship : gudang arang, tempat menyimpan batubara pada kapal.
bunkhouse	kb. rumah bedeng untuk buruh.
bunny	kb. (j. -nies) kelinci.
bunting	kb. kain untuk dibuat bendera.
buoy	kb. pelampung. -kkt. 1 menahan'mencegah supaya jangan tenggelam. 2 timbul kembali.
buoyancy	kb. kemampuan mengapung, tenaga/daya apung.
buoyant	ks. 1 ringan, bisa mengapung. 2 meluap, naik, bisa timbul.
bur	kb. duri tumbuh-tumbuhan. the dog was covered with burs anjing itu badannya penuh dengan duri-duri kecil.
bur., bur.	(bureau, bureau) biro.
burden	kb. 1 beban. 2 pokok. -kkt. menyusahkan.
burdensome	ks. berat, memberatkan. the additional work is b. for him pekerjaan tambahan itu berat bagimya.
bureau	kb. 1 rak pakaian, lemari pakaian berlaci. 2 meja tulis. 3 kantor. b. of vital statistics biro pencatatan statistik (angka kelahiran, perkawinan, dan kematian).
bureaucracy	kb. (j. -cies) birokrasi.
bureaucrat	kb. birokrat.
bureaucratic	ks. birokratis.
burgeon	kki. berkembang. this satellite town has burgeoned in the past few years kota satelit ini berkembang dalam beberapa tahun terakhir ini.
burglar	kb. pencuri, maling yang membongkar rumah. b. alarm alat tanda bahaya (ditaruh pada pintu atau jendela).
burglarize	kkt. membongkar untuk mencuri.
burglarproof	ks. tahan pembongkaran.
burglary	kb. (j. -ries) pembongkaran dan pencurian.
burgle	kkt. sl.: membongkar. the store was burgled toko itu kebongkaran.
burial	kb. penguburan, pemakaman. b. ground (pe)kuburan, makam, kerlop. b. plot tempat/tanah kubur. b. sevice kebaktian pemakaman.
buried	lih bury.
buries	lih bury.
burlap	kb. kain guni.
burlesque	kb. 1 ejekan dalam bentuk sandiwara atau karangan. 2 bahan tertawaan. -kkt. meniru dan mengejek.
burly	ks. besar dan tegap. a b. man seorang yang besar dan tegap.
burma	kb. birma.
burman	kb. orang birma. -ks. yang berasal dari birma.
burmese	kb. 1 orang birma. 2 bahasa birma. -ks. yang berasal dari birma. b. language bahasa birma.
burn	kb. 1 luka hangus/terbakar, luka (kena) bakar. 2 pembakaran (of a spaceship engine). -kkt. (burned atau burnt) 1 membakar. 2 memasang. 3 membuat ukir-ukiran dengan cara membakar. -kki. 1 menyala. 2 panas. 3 hangus. 4 inf.: memboroskan. 5 membuat marah.
burner	kb. 1 alat pembakar, pelik/pelita pembakar. 2 pelita pembakar (pada kompor). bunsen b. pembakar/lampu bunsen.
burnish	kkt. mempolitur to b. copper memoles/mengkilapkan tembaga.
burnout	kb. pemadaman. the b. is an important aspect of rocketry pemadaman adalah satu segi yang penting dalam peroketan.
burnt	lih burn.
burp	kb. inf.: serdawa. -kkt. menepuk punggung supaya serdawa. -kki. beserdawa. the baby burped bayi itu beserdawa.
burr	kb. 1 = bur. 2 aksen, lagu. 3 bunyi "r" yang berat.
burrow	kb. liang. -kkt. menggali. -kkt. 1 bersembunyi. 2 mencari-cari dengan meraba. 3 menggali liang.
bursar	kb. bendaharawan (pada suatu perguruan tinggi).
bursitis	kb. radang kandung lendir.
burst	kb. ledakan. -kkt. (burst) membuka keras. -kki. 1 meledak (pecah). 2 penuh.
bury	kkt. (buried) 1 mengubur. 2 memendam. 3 melupakan. -buried treasure harta karun, harta yang tersembunyi. -burying ground kuburan, makam, kerlop.
bus	kb. (j. busses atau buses). bis, otobis. sl.: to miss the b. kehilangan kesempatan. -kkt. (bus(s)ed) mengangkut dengan bis.
bush	kb. semak-semak. -kkt. sl.: menghabiskan tenaga. -bushed ks. sl.: lelah.
bushel	kb. gantang. a b. of potatoes segantang kentang.
bushelful	kb. segantang.
bushing	kb. 1 ring. 2 paking.
busied	lih busy.
busily	lih busy.
business	kb. 1 perusahaan. 2 urusan. 3 usaha b. school sekolah dagang. b. woman usahawati.
businesslike	ks. praktis, cekatan. bersifat urusan dagang.
businessman	kb. (j. -men). pedagang, pengusaha, usahawan. he's a b. ia seorang pedagang.
busman	kb. (j. -men). sopir bis. busman's holiday hari libur yang dipergunakan untuk mengerjakan sesuatu yang biasa dikerjakan tiap-tiap hari kerja.
busses	lih bus.
bust	kb. 1 dada, payudara. 2 potret atau patung dada. 3 sl.: kegagalan. -kkt. sl.: 1 gagal. 2 menurunkan pangkat. -kki. sl.: meledak. -busted ks. sl.: 1 falit, bangkrut. 2 pecah, patah, putus.
bustle	kb. 1 kesibukan. 2 cloth.: rangka untuk rok wanita. -kki. buru-buru.
bustup	kb. sl.: perselisihan, percekcokan. they had a b. and were finally divorced mereka berselisih dan akhirnya bercerai.
busy	ks. 1 sibuk. 2 ramai. 3 bicara. -kkt. (busied) menyibukkan, sibuk. -busily kk. sibuk.
busybody.	kb. (j. -dies). orang yang suka ikut campur dengan urusan orang lain.
busywork	kb. kegiatan asyik-sendiri.
but	ksam. 1 tetapi. 2 kecuali. 3 meskipun begitu. -kkt. b. me no buts jangan mencari-cari/mengemukan alasan-alasan.
butane	kb. sejenis gas hidrocarbon yang tidak berwarna.
butcher	kb. 1 tukang daging, jagal. 2 pembunuh. -kkt. 1 menyembelih, memotong. 2 membunuh. 3 inf.: merusak.
butchery	kb. (j. -ries) 1 penyembelihan, pemotongan. b. of hogs pemotongan babi. 2 pembunuhan kejam.
butler	kb. kepala pelayan, pelayan yang mengurus makanan dan minuman.
butt	kb. 1 puntung. 2 korban, obyek. 3 ujung. 4 sl.: pantat. -kkt. menanduk. -kki. 1 menanduk. 2 bertubrukan kepala. sl.: to b. in(to) 1 memotong. 2 mengganggu.
butter	kb. mentega. -kkt. mentegai, menaruh mentega pada. to b. up menjilat, menggulai, memuji-muji. b. bean sejenis kacang. butterfingered ks. biasa menjatuhkan barang-barang (dari pegangan). buttered ks. bermentega.
butterball	kb. inf.: orang yang gemuk.
buttercup	kb. sejenis bunga yang tumbuh di hutan, kuning warnanya dan bentuknya seperti mangkok
butterfat	kb. gemuk yang terdapat pada susu.
butterfingers	kb., inf.: orang yang sering menjatuhkan barang dari pegangannya.
butterfly	kb. (j. -flies). kupu-kupu. b. stroke gaya kupu-kupu.
buttermilk	kb. dadih (cairan susu yang tinggal setelah membuat mentega).
butterscotch	kb. gula-gula yang terbuat dari gula merah dan mentega.
buttock	kb. pantat, bokong. -buttocks j. pantat, bokong.
button	kb. 1 kancing. 2 tombol, kenop. -kkt. 1 mengancingkan. 2 inf.: menutup mulut. inf.: to b. up menyelesaikan dengan cara yang memuaskan (a deal).
buttonhole	kb. lubang kancing. -kkt. menahan untuk bercakap-cakap (s.o.)
buttress	kb. dinding penopang. -kkt. menahan, menunjang (a wall, an argument).
buxom	ks. montok, gemuk. the girl was b. in upearance gadis itu kelihatan montok.
buy	kb. pembelian. -kkt. (bought) 1 membeli. 2 menyuap, menyogok. 3 sl.: menerima. -kki. menjadi pembeli. to b. over menyogok, menyuap. to b. up memborong.
buyer	kb. pembeli, langganan. i'm a steady b. at that store saya pembeli tetap pada toko itu.
buzz	kb. dengung(an). -kkt. 1 terbang diatas. 2 memanggil dengan alat dengungan. -kki. 1 mendengung. 2 berdengungan. 3 membicarakan desas-desus.
buzzard	kb. semacam elang.
buzzer	kb. aparat dengung(an), bel, lonceng listrik.
by	kk. by and by segera. -kd. 1 dekat. 2 oleh. 3 dengan. 4 per. 5 menurut, dengan menghitung. 6 karena. 7 dari.
bye	kb. sport: biji cuma-cuma yang diperoleh dalam satu pertandingan karena lawan tidak ada. bye-bye kseru. inf.: selamat jalan, selamat tinggal.
bygone	kb. hal yang sudah-sudah. let bygones be bygones jangan bicarakan hal yang sudah-sudah. ks. silam. in b. days pada zaman yang silam.
bylaw	kb. anggaran rumah tangga, peraturan-peraturan untuk perkumpulan sendiri.
bystander	kb. orang yang berdiri didekat, penonton.
byway	kb. jalan kecil. the thief took to the byways in an attempt to escape pencuri itu mengambil jalan-jalan kecil dalam usaha untuk melarikan diri.
byword	kb. 1 pepatah yang menjadi buah bibir orang. 2 pemeo, ejekan.
byzantine	ks. yang berhubungan dengan rumawi timur.
c	kb. 1 huruf ketiga daripada abjad. 2 kunci musik. 3 nilai yang ketiga dari atas (dipakai di sekolah-sekolah dan universitas-universitas di as) 4 sl.: $100. he paid 3 c's for that dia membayar $300 untuk itu.
c c	(consular corps) korps konsuler.
c-in-c	(commander-inchief) panglima tertinggi.
c.	1 (cape) tanjung. 2 (catholic) katholik. 3 (centigrade) berskala 100 derajat. 4 (center) pusat. 5 (chruch) gereja. 6 (city) kota. 7 (conservative) konserpatip. 8 (carbon) karbon.
c. e.	(civil engineer) insinyur sipil.
c. of s.	(chief of staff) kepala staf.
c. z.	(canal zone) daerah terusan.
c.a.	(central america) amerika tengah.
c.a.p.	(civil air patrol) patroli udara sipil.
c.c., c.c.	(chasier's check) cek bank. 2 (chief clerk) kepala pembantu di toko, kepala juru tulis, kepala komis. 3 (consular clerk) pegawai konsuler.5 (cubic centimer) sentimeter kubik. 6 (centimeters) sentimeter.
c.g.	1 (coast guard) penjaga pantai. 2 (consul (ate) general) konsul (at) jenderal. 3 (commanding general) jenderal panglima.
c.i.a	(central intelligence agency) badan intelijens pusat as.
c.o.d.	(collect/cash on delivery) kiriman remburs. membayar waktu diantarkan.
c.p.a.,  cpa	(certified public accountant) akuntan umum berijazah.
c.s.a.	(confederate states of america) negara konfederasi as.
c.s.t.	(central standart time) waktu tolok sentral.
c/a	(current account) rekening koran.
c/o	(in care of) d/p. d/a. c/o. mr. j. doe d/p sdr j. doe.
ca	(circa) kira-kira. ca 1950 kira-kira tahun 1950.
caa	(civil aeronautics administration) direksi penerbangan sipil as.
cab	(civil aeronautics board) dewan penerbangan sipil as.
cabal	kb. komplotan rahasia.
cabana	kb. semacam tenda tempat bernaung pada permadani di pinggir laut.
cabaret	kb. kabaret.
cabbage	kb. kubis, kol. c. patch petak tanah ditanam dengan kubis.
cabby	kb. (j. -bies) supir taksi.
cabin	kb. 1 pondok. 2 kamar (di kapal). c. on b deck kamar di dek. 3 av.: ruang (dalam kapal terbang)
cabinet	kb. 1 lemari kaca. 2 kabinet. c. minister anggota kabinet.
cabinetmaker	kb. tukang lemari.
cabinetmaking.	kb. pembuatan perabot rumah.
cable	kb. 1 kawat, kabel.. 2 tilgram, kawat. -kkt., kki. mengirim tilgram.
cablese	kb. singkatan kata-kata untuk mempersingkat isi tilgram
cabman	kb. (j. -men). supir taksi.
caboodle	kb. sl.: rombongan, kelompok. lih kit.
caboose	kb. gerbong tukang rem.
cacao	kb. cokelat. c. bean biji cokelat.
cache	kb. tempat menyembunyikan bahan makanan dan perlengkapan-perlengkapan. -kkt. menyembunyikan (food).
cachet	kb. cap (lak, materai, dsb.).
cackle	kb. kotek. -kki. 1 berkotek-kotek (of chickens). 2 ngobrol-ngobrol (of person)
cacophony	kb. (j. -nies) bunyi hiruk pikuk.
cactus	kb. (j. cactuses atau cacti) kaktus.
cacuminal	ks. kakuminal.
cad	kb. orang kurang ajar.
cadaster	kb. kadaster.
cadastral	ks. yang berhubungan dengan kadaster. c. survey penyelidikan batas-batas tanah milik.
cadaver	kb. bangkai, mayat.
cadaverous	ks. pucat lesi/pasi. c. appearance seperti mayat , pucat pasi.
caddie, caddy	kb. (j. -dies) kadi, karung permainan golf. -kki. menjadi kadi.
cadence	kb. irama.
cadenza	kb. bagian penghabisan dari satu musik.
cadet	kb. kadet, calon perwira. c. corps at west point korps kadet akademi militer as.
cadmium	kb. kadmium.
cadre	kb. kader.
caduceus	kb. lambang kedokteran.
