doyan	(jakarta) be fond of.
doyong	inclined, not straight.
dozer	bulldozer.
dpc	(dewan pimpinan cabang) leadership of political party at local level.
dpd	(dewan pimpinan daerah) leadership of political party at regional level.
dpp	1. (dewan pimpinan pusat) leadership of political party at national level. 2. (dada, pinggang, pinggul) chest, waist, hip measurements. 3. (dana pembinaan pendidikan) k.o. gvt. subsidy to state universities to supplement tuition fees.
dpr	(dewan perwakilan rakyat) indonesian legistilative assembly.
dprd	(dewan perwakilan rakyat daerah) assembly at provincial, regional, or municipal level.
dprgr	(dewan perwakilan rakyat gotong royong) the indonesian parliament (1959-1973).
dpt	(diphteri, pertussis, tetanus) diphtheria, whooping cough, tetanus vaccine.
dpt.	(dapat) can, be able.
dr-	see also entries with der-.
dr.	1. (dari) from. dr.2, dr.1 (dokter) doctor (of medicine). dr.2 (doktor) doctor (of philosophy).
dra.	(doktoranda) title of woman holding post-graduate degree in humanities below doctoral rank.
draft	draft (of plan, etc.).
dragon	manual water pump.
draimolen	carousel.
drainase	drainage.
dram	see drum.
drama	drama.
dramatari	dance drama.
dramatis	dramatic.
dramatisasi	men-dramatisasi-kan dramatize, make into a play.
dramatisir	men-dramatisir dramatize, make into a play.
dramaturg	dramatist.
dramaturgi	dramaturgy.
dramawan	stage actor, performer.
dramben	see drumband.
drastis	drastic.
drat	1 wire thread. 2 thread of a screw.
drei	k.o. drill.
drell	sound of ataccato crackling (gun salvo, etc.). men-drel spray with bullets.
dressoar	(dreswar) sideboard, buffet.
drg.	(dokter gigi) dentist.
drh.	(dokter hewan) veterinarian.
dribbel, dribel	men-dribbel (sport) dribble.
dril	k.o. cloth.
drive	(drayp) (sport) drive in golf.
drodok	(coll.) dry dock.
dromedaris	dromedary.
drop	mints, cough-drops.
droping,dropping	allocation, us from outside ordinary channels (direct order of president, etc.).
drs.	(dokterandus) title of o. holding graduate degree in humanities below doctoral rank.
drum	1 drum. 2 oil drum, canister for chemicals.
drumband	(dramben) marching band.
ds.	(domine) protestant clergyman.
dsb.	(dan sebagainya) etc.
dsl.	(dan selanjutnya) and so forth.
dst.,dstnya	(dan seterusnya) and so on.
dt	see daswati.
dt.	(datuk) title in malaysia and certain parts of indonesia.
dtk.	(detik) second moment.
dto.	(ditandatangani oleh) signed by.
dua	two. (ber)-dua-dua 1 two by two 2 both.
duai	see ipar.
duaja	banner, ensign.
dual	1 duel. 2 (coll.) traffic collision.
dualis	(ling.) dual.
dualisme	dualism.
duane	customs.
dub	see dab.
dubang	(java) saliva reddened by betel chewing.
dubes	(duta besar) ambasador.
dubilah	(isl., coll.) god forbid !
dubun	hyena.
dubur	anus.
duda	widower.
dudu	follow s.o., continue on (without looking back).
duduk	1 sit. 2state, situation. 3 live, dwell, reside. 4 settle, go to the bottom (of dregs).
dudut	1. (java) pull, tug at. 2. (child language) penis.
duet	duet.
duga	guess, estimate.
dugal	(java) naughty.
dugang	restrain s.t. with a rope so that it will not fall.
dugden	(java) invulnerable.
dugder	(java) week-long festival before fasting month.
dugong	dugong.
duh	see aduh.
duhai	see aduhai.
duilah	/duillah/ (coll.) my gosh ! (exclamation of surprise or astonishment).
duit	money.
duk	kerchief.
duka	grief, sorrow.
dukacarita	/dukacerita/ tragedy, story with sad theme.
dukacita	profound sorrow.
dukana	taking pleasure in sex, lascivious.
duko	spray paint (for cars, etc.).
duku	lanseh totree or its fruit.
dukuh	hamlet.
dukun	indigenous medical practitioner, shaman.
dukung	men-dukung 1 carry as o. would carry a child, on the back or straddling the hip (with support of the arm) 2 support, espous (a couse).
dulang	1. food tray. 2. printer's galley. 3. men-dulang feed (a child).
duli	(lit.) 1 dust. 2 expression in royal tittles.
dulu	1 formerly, previously. 2 first (before doing s.t. else). 3 before, prior. 4 for the time being.
dulur	(java) kin, family.
dum-dum	sound of drum or cannon.
dumel	(java) nag, complain.
dumpis	caps (for toy guns, etc.).
dung	sound of drum.
dungak	see dongak.
dungu	1 dull-witted, mentally slow. 2 gullible.
dunia	1 world. 2 (bio.) kingdom. se-dunia the whole world.
duniawi	worldly, secular.
duniawiah	worldly, profane.
dunsanak	(m) relatives.
dup	see dop 2.
dupa	incense.
dupak	see depak 1.
duplik	(leg.) rejoinder, rebuttal.
duplikasi	duplication (of effort, etc.).
duplikat	/duplo/ duplicate, carbon copy.
dur	sound of explosion.
duren	(java) see durian.
durga	hindu goddess of destruction.
durhaka	rebellious, insubordinate.
duri	1 thorn, burr, spine. 2 fish bone.
durian	durian fruit and tree.
durja	see muram.
durjana	(lit.) evil, wicked.
durna	1 (java) name of character in the wayang, adviser first to o. side and later the other. 2 intrigue-ridden adviser.
dursila	(java) unethical.
dus	1. shower (bath). 2. (coll.) so, consequently. 3. see dos.
dusel	(java) snuggle up close.
dusi	men-dusi continue to feel drowsy after nap.
dusin	men-dusin 1 be awake. 2 be conscious of, realize.
dusta	1 lie, falsehood. 2 tell a lie.
dusun	1 (lit.) orchard. 2 village far from urban areas.
dut	(coll.) dead.
duta	ambassador.
dutawati	ambassadress.
duyun	ber-duyun-duyun in throughs.
duyung	see dugong.
dwi	two (formal and only in certain constructions).
dwiarti	ambiguous.
dwibahasa	bilingual.
dwibahasawan	a bilingual.
dwidasawarsa	20th anniversary.
dwifungsi	dual function, esp. of the military, referring to its soldierly and political roles.
dwiguna	dual-purpose.
dwihuruf	(ling.) digraph.
dwikewarganegaraan	dual citizenship.
dwikora	(dwikomando rakyat) the people's two mandates: crush malaysia and defend the revolution (slogan of sukarno era).
dwimakna	ambiguous.
dwipekanan	biweekly.
dwisuku	(ling.) disyllabic.
dwitunggal	duumvirate, two working as o.
dwiwarna	the indonesian flag, the red and white.
dwiwulanan	bimonthly.
dynamo	see dinamo.
dysentri	see disentri.
dz	see also entries with d-. l-.or z-.
e	1.the 5th letter of the alphabet. 2. ha ! emphatic particle. 3. hey ! interjection to attact attention or to express astonishment.
e-e	(child language) doo-doo, feces.
e-e-e	say ! interjection of amazement or of being amusingly offended.
ebam	porcelain pot with lid.
eban	see heban.
ebang	see bang 2.
ebek	awning.
ebeng	seee ibing.
ebi	dried shrimps.
eboh	see heboh.
ebom	see bom 1.
ebonit	ebonite.
ebor	see bor.
ebro	two- or four-wheeled carriage.
ec.	(ekonomi) economics (used in academic degrees).
ece	make a fool of, kid, make fun of.
ecean	kidding, fooling.
ecek	apparently, outwardly. ecek-ecek not be serious, just appear as.
ecek-ecek	k.o. legume.
eceng	k.o. water plant with red leaves and edible flowers.
ecer	retail. price of a single item.
eco	(java) tasty, delicious.
edah	see idah 1.
edan	1 wild, frantic. 2 (coll.) insane, mad, crazy.
edap	see idap.
edar	1turn, revolve. 2 circle (of flying plane) 3 circulate (of money, etc.).
edisi	edition (of book, etc.).
edit	edit (manuscript, etc.).
editor	/editur/ editor (of manuscript, etc.).
edukasi	education.
edukatif	/edukatip/ educative, instructive.
eem-eem	(child language) yummy, tasty.
efectivitas	effectiveness.
efek	1. effect. 2. efek, efekten (fin.) share, stock.
efektif	/efektip/ effective.
effekten	see efek 2.
efisien	efficient.
efisiensi	efficiency.
egah	glorious.
egois	egoist, egoistic.
egoisme	egoism.
egoistis	egoistic.
egol	meng-egol 1 pry up, lift with a lever in a jerky motion. 2 sway o's hips.
egos	meng-egos 1 evade. 2 evade, get around s.t., get out of the way of s.t.
egosentris	egocentric.
egosentrisme	egocentricity.
egrang	stilts.
egung	see gong 1.
eh	ugh, interjection expressing disgust.
ehm	1. whatsit (particle used to avoid saying actual word). 2. (coll.) uh-huh, yes.
ei	see e 2.
eit	exclamation used when trying to avoid physical or verbal attack.
eja	spell.
ejakulasi	ejaculation of semen.
ejan	meng-ejan strain abdominal muscles when defecating.
ejawantah	visible, manifest.
ejek	mock, ridicule, make fun of.
ek	1. meng-ek calibrate. 2. oak.
eka	one, single (in formal compounds and slogans).
ekabahasa	(ling.) monolingual.
ekabahasawan	/ekabasawan/ (lit.) monolingual person.
ekamarga	one-way (traffic, road).
ekamarta	unidimensional.
ekaprasetia-pancakarsa	title of 1978 speech by suharto, in which he gave his interpretation of the pancasila.
ekaristi	(rel.) eucharist.
ekasila	condensation of the pancasila into o. principle (1960s).
ekasuku	(ling.) monosyllabic.
ekawarna	monochromatic.
ekawarsa	o. year.
ekeh-ekeh	panting, out of breath.
ekivalen	see ekuivalen.
ekivalensi	see ekuivalensi.
eko	echo.
ekologi	ecology.
ekologis	ecological.
ekonom	economist.
ekonometri	econometrics.
ekonomi	1 economics. 2 economy. 3 household management.
ekonomis	economical.
ekor	1 tail (of animals). 2 classifier used for animals. 3 tail (end) (of kite, parade, train, etc.). 4 follower, adherent, hanger-on. 5 bad consequence, aftermath. 6 the last digits in a lottery number.
ekosistem	ecosystem.
eks	1. 1) (leg.) (cited from. 2) imported from. 2. eks-ex-, former.
eks.	(eksemplar) copy, issue, number.
eksak	/eksakta/ exact sciences (mathematics and physics).
eksamen	(acad.) examination.
eksaminator	(acad.) o. who administers an examination.
eksekusi	1 execution, carrying out. 2 execution, putting to death.
eksem	/eksema/ eczema.
eksemplar	copy (of book), issue (of periodical).
eksentrik	eccentric.
eksepsi	(leg.) demurrer,exception.
ekses	excess.
ekshibisi	/eksibisi/ exhibition.
eksim	see eksem.
eksistensi	existence.
eksistensialisme	existentialism.
eksit	exit permit from the immigration office.
ekskavasi	excavation.
eksklusif	1 exclusive, select. 2 excluded, without.
eksklusivisme	exclusivism.
ekskursi	excursion.
ekskutif	executive.
eksodus	exodus, mass migration out of a place.
eksogami	exogamy.
eksogen	exogenous.
eksotik	/eksotis/ exotic.
ekspansi	expansion (of territory, gas, etc.).
ekspansif	expansive.
ekspansionis	1 expansionist. 2 expansionistic.
ekspedisi	1. 1) shipping, forwarding. 2) mail room 9of large institution). 2. 1) expedition, jaunt, campaign. 2) (mil.) dispatching of troops.
ekspeditur	shipping agent.
eksperimen	experiment.
eksperimental	experimental.
eksperimentasi	experimentation.
eksperimentil	see experimental.
eksplisit	explicit.
eksploatasi	see eksploitasi.
eksploatir	see eksploitir.
eksploitasi	1 development, working. 2 exploitation, use, operation.
eksploitir	meng-eksploitir 1 work, use. 2 exploit.
eksplorasi	exploration.
eksplosi	explosion.
eksplosif	explosive.
eksplotasi	see eksploitasi.
ekspo	see eksposisi.
eksponen	1 (math.) exponent. 2 exponent (of idea, theory, etc.).
ekspor	export.
eksportir	exporter.
ekspos	meng-ekspos expose, reveal, uncover.
ekspose	expose.
eksposisi	1 exposition, fair. 2 exposition, explanation.
ekspres	1 express, fast (public transport). 2 special delivery.
ekspresi	1 expressiveness. 2 expression.
ekspresif	expressive.
ekspresionis	expressionist (art).
ekspresionisme	expressionism (art).
ekspresionistis	expressionistic (art).
ekstase	extasy.
ekstensif	extensive
ekstern	1 external. 2 not a resident.
ekstra	1. 1) extra, more. 2) extraordinary, in a special way. 3) previws or shorts shown in addition to the main filn. 2. outside of a certain institution.
ekstradisi	extradition.
ekstrak	extract.
ekstrakuliluler	extracurricular.
ekstrane	(acad.) outside participant in an examination.
ekstraparlementer	extraparliamentary.
ekstrapolasi	extrapolation.
ekstrauniversiter	outside of the university.
ekstrem	extreme.
ekstremis	extremist.
ekstremisme	extremism.
ekstremitas	extremity.
ekstrim	see ekstrem.
ekstrovert	extrovert.
ekuin	(ekonomi, keuangan dan industri) economy, finance, and industry.
ekuivalen	equivalent.
ekuivalensi	equivalency.
ekumis	ecumenical.
ekwivalen	see ekuivalen.
ekwivalensi	see ekuivalensi.
ela	unit of linear measure, 91,4 cm. or about o. yard.
elaborasi	elaboration.
elah	1 trick. 2 pretext, excuse.
elang	hawk, eagle or any large bird of prey.
elastik	/elastis/ elastic.
elastisitas	/elastisitet/ elasticity.
electroteknik	electrical engineering.
elegi	elegy.
elektrifikasi	electrification.
elektris	(coll.) electrical.
elektrisir	meng-elektrisir electrify.
elektro	1 concerning electrical matters. 2 electrical engineering.
elektroda	/elektrode/ (phys.) electrode.
elektrodinamika	electrodinamics.
elektrolisa	electrolysis.
elektrolit	electrolyte.
elektrolitis	electrolytic.
elektromagnit	electromagnet.
elektron	electron.
elektronik	1 electronic. 2 electronics.
elektronika	electronics.
elektronis	see elektronik.
elemen	1 element. 2 (chem.) element.
elementer	elementary.
eleng	rock (of boat).
eliminasi	meng-eliminasi-kan eliminate.
eliminir	eliminate.
eling	(java) remember (esp. in spiritualism).
elips	ellipse.
elipsis	(ling.) ellipsis.
elipsoide	elipsoid.
elit	/elite/ elite.
elitis	elitist.
elitisme	elitism.
elo	see ela.
elok	1 beautiful, lovely. 2 good.
elon	see kelon.
elpiji	(liquid propane gas) liquid propane gas.
els	(europese lagere school) k.o. elemtary school of colonial period with instruction in dutch for europeans and the indigenous elite.
eltor	(med.) eltor, k.o. cholera.
elu	see lu.
elu-elu	1. meng-elu-elu come in waves (of sound), reverberate. 2. acclaim give applause.
eluk	see luk.
elus	meng-elus stroke. elus-an a caress. 2 flattery.
em	see m 1.
email	enamel.
emak	see mak.
emam	(child language) eat.
emang	(sunda) term off address and reference for o.'s uncle.
emansipasi	emancipation.
emas	gold.
emat	1. (che.) checkmate. 2. see mat2.
embacang	k.o. mango.
embah	(java) 1 term of address and reference for o.'s grandparent. 2 term of address and reference for old person, teacher, or mystic.
embalau	shellac.
emban	1. 1) breastband, waistband, sash. 2) belly band (for horses). 2. meng-emban 1) carry out, execute, perform. 2) support. 3.nursemaid.
embara	roam, rove wander.
embarau	1 palisade, wood or stone embankment. 2 piling (of pier, etc.).
embargo	embargo.
embarkasi	embarkation.
embat	lash s.o. down with strip of bamboo, rope, etc.
embek	see embik.
embel	(jakarta) swamp covered with plant growth.
embel-embel	1 details. 2 insignificant addition, supplement. 3 side issue of little importance.
ember	pail, bucket.
embi	(jakarta, sunda) term of address for o.'s aunt.
embik	1 a bleat. 2 sheep, goat.
embok	see mbok 2.
embol	meng-embol swell, puff up.
embrat	see emrat.
embrio	(biol.) embryo, fetus.
embriologi	(biol.) embryology.
embun	1 dew. 2 condensed vapor. 3 haze.
embus	1. aspirate. 2. scoot ! go away !
embusan	1 bellows. 2 blowing, blast (of wind). 3 (ling.) aspiration. 4 suggestion.
embut	move up and down (i.e. of the chest of sleeping person).
emigran	emigrant.
emigrasi	emigration.
emik	(child language) drink.
emirat	emirate.
emis	see kemis 1.
emisi	1 issue (of banknote, security, stock, etc.). 2 emission (of semen, light, etc.).
emiter	o. who issues a security or banknote.
emoh	(java) be unwilling.
emolumen	emolument, perquisite.
emong	meng-emong 1 care for, look after. 2 direct an enterprise.
emosi	1 emotion. 2 emotional. 3 be emotional.
emosional	/emosionil/ emotional.
empal	(java) spiced and fried chunks of beef.
empang	1 (fish)pond. 2 embankment. 3 dam.
empap	ber-empap gamble by tossing a coin. meng-empap strike with heavy or flat object (oar, palm of hand, etc.).
empar	meng-empar drift off, be off course (of ship, etc.).
empas	meng-empas be tossed, dashed against, throw o.s. down.
empat	four.
empe-empe	see empek-empek.
empe-empek	k.o. fishcake (s. sumatra specialty).
empedal	gizzards.
empedu	gall, bile.
empek	1 (china) term of address and reference for o,'s parent's older brother or brother-in-law. 2 (coll.) ter of address for old china man.
empelas	see amplas 1,2.
empelop	see amplop.
empenak	meng-empenak 1 spoil, coodle, pamper. 2 (friendly) persuasion, prais, flattery.
empeng	see emping.
emper	/emperan/ 1 veranda, porch. 2 overhang, awning.
empet	(jakarta) annoyed, angry.
empet-empet	paper trumpet, ballon with a whistle.
empeyek	cracker made of dried fish or other viand fried rice flour.
empik	(java) eager, want to.
emping	1 chips made of pounded new rice toasted and served with palm sugar. 2 fried chips made of gnetum gnemon fruit.
empiris	empirical.
empirisisme	/empirisme/ empiricism.
emplasemen	1 (mil.) emplacement. 2 (r.r.) railway yard.
emplek	1 (java) sheer, layer. 2 (coll.) classifier for sheet of mosquito coils.
empoh	rise, overflow (of water). meng-empoh-i inundate, flood.
empok	(jakarta) 1 term address and reference for o.'s older sister. 2 term of address to lower class women.
empon-empon	(java) spices.
empos	1 breathe, blow on. 2 expose fruit to smoke to speed up ripening process.
empu	1 (lit.) master craftsman. 2 armorer. 3 master.
empuk	1 soft (mattress, etc.). 2 tender, well-done (of food). 3 easy to defeat or cheat. 4 well-worn (of cloth). 5 soft and pleasant (of voice, sounds).
empul	meng-empul bob up and down (of boat, etc.).
empulur	pith or soft core of palm tree.
empunya	owner.
emrat	(jakarta) large watering can.
emulsi	emulsion.
emut	ng-emut have in o.'s mouth, such.
en	(coll.) and.
enak	1 nice, tasty, delicious. 2 nice, pleasant. 3 well.
enam	six.
enap	1. ponder, consider deeply, give a great deal of thought to. 2. see endap 1.
enau	sugar palm.
encek	1. (java) stand on s.t. 2. see encik.
enceng	see eceng.
encer	see incar.
encik	1 (china) term of address and reference for father's younger brother. 2 (china) term of address for a man of o's father's generation. 3 (lit.) term of address for a woman teacher.
encim	1 (china) term of address for father's younger brother's wife. 2 (china) term of address or reference for woman of o.'s mother's generation. 3 wife of the store owner.
encit	(china) cloth, fabric.
encok	1 rheumatic, stiff. 2 rheumatism. 3 gout.
encot	see incut 2.
endak	1 see ndak 1. 2. see hendak.
endal	meng-endal 1 stuff, cram (into bag, etc.). 2 elastic, resilient, springy.
endap	1. meng-endap 1) settle, precipitate. 2) be present, be there (but not put to any use). 2. meng-endap-endap, ber-endap-endap move stealthily, move in crouching position. 3. see tanah.
endasan	chopping board.
endemi	endemic disease.
endemis	endemic.
enderia	see inderia.
endon	(java) (me)ng-endon stay for a considerable length of time.
endong	(sunda) see endon.
endosemen	endosement (of checks).
endosir	endorse (checks).
endrin	brand of pesticide. meng-endrin kill with endrine.
enduk	see genduk.
endus	1 get wind of, smell, whiff. 2 get wind of, find out, discover.
endut	endut-endut-an throb, beat, pound.
enek	nauseated, feel sick.
energi,enerji	energy.
enerjetik,enerjik	energetic.
enersi	see energi.
enes	(java) meng-enes languish from sadness.
enga,engah	1. (jakarta) be aware, be conscious. 2. ter-engah-engah 1) panting, puffin. 2) in hurry.
engak	1 drowsy, sleepy. 2 (med.) comatose. 3 dazed.
engap	1 panting, puffing. 2 tight in the chest, breathe with difficulty.
engas	stink, stench, foul odor.
enggak	see nggak.
enggan	reluctant, averse, unwilling.
enggang	hornbill.
engget	(jakarta) meng-engget hook (fruit, etc.).
enggil	ber-enggil toothed, serrated, notched.
enggokan	(jakarta, java) curve (in road, etc.).
engkah	1. wood glue. 2. 1) half ripe, partially ripe. 2) partially cooked.
engkak	(java) k.o. crow.
engkang	meng-engkang walk with legs wide apart.
engkar	see ingkar.
engkau	1 you, familiar pronoun for 2d person singular, often abbreviated as kau. 2 (coll.) your. 3 (rel.) thou, thee.
engkel	single, not manifold.
engkim	(china) term of address and reference for mother's younger brother's wife.
engko	see engkau.
engkoh	(china) term of address and reference for elder brother or male of age similar to o.'s elder brother.
engkol	1 crank (of machine). 2 wrench.
engkong	(china, jakarta) term of address and reference for grandfather.
engku	1 (china) term of address and reference for mother's younger brother. 2 (lit.) term of address and reference for highly respected individual of both sexes.
engkuk	1. k.o. bird similar to barbet. 2. meng-engkuk-engkuk bend or push s.o. down.
engsel	1 hinge. 2 (r.r.) switch.
engso	(china) 1term of address and reference for older brother's wife. 2 respectful term of address for woman old enough to be married but not of a generation older than the speaker.
enjak	see injak.
enjal	1. meng-enjal stuff, cram. 2. see anjal.
enjima	see ensim.
enjot, enjut	meng-enjut 1 push or pull with a jerk. 2 pedal (a bicycle, etc.).
ensiklik	(rel.) encyclical.
ensiklopedi	encyclopedia.
ensim	/ensima/ enzyme.
ensopor	(coll.) et cetera.
entah	who knows, i do not know. entah-berentah fabled, imaginary.
entah-berentah	see entah.
entak	meng-entak 1 stamp on with force. 2 thrust, stab. 3 pound, throb as if being stamped on.
entar	(jakarta) later.
entas	meng-entas take or pull s.t. out. meng-entas-kan raise achild to adulthood so that it becomes s.t.
ente	(jakarta and among arabs) you.
enten	meng-enten graft, implant.
enteng	1 light (in weight), 2 light (feelings, etc.). 3 easy, inconsequential. 4 mild (of cigarrettes, etc.).
enternit	see eternit.
entimun	see mentimun.
entit	(java) ng-entit steal (small and trivial objects).
entog	(java) manuila duck.
entomolog	entomologist.
entomologi	entomology.
entomologis	entomological.
entot	(vulg.) (me)ng-entot fuck, screw.
entri	entry (in dictionary, etc.).
entrog	meng-(entrog-entrog) shake.
enyah	go away, get out.
enyak	meng-enyak tread on, step on, press, stamp. te(pe)r-enyak fall back with thud (in a chair etc.).
enyek	(java) answer in a mocking way.
enzim,enzima	see ensim.
epak	see pak 1.
epek	(coll.) belt.
epidemi	epidemic.
epidemiologi	epidemiology.
epigrafi	epigraphy.
epik	epic.
epilepsi	epilepsy.
episentrum	epicenter.
episode	episode.
epistemologi	epistemology.
epok	k.o. plaited bag to hold ingredients for betel chewing.
epolet	epaulette.
epos	epic.
era	era.
erak	screeching sound.
eram	meng-eram 1 hatch, brood. 2 crouch on all fours (as of water buffalo in pond, tiger set to pounce on prey, etc.). 3 brood.
erang	groaning, moaning from pain.
erang-erot	zig-zag, askew, awry.
erat	1 tight, firm. 2 firm (of promise, etc.). 3 close (of relationship).
ercis	peas.
ereng	see reng.
eret	meng-eret 1 drag, pull. 2 snate, lure, take in s.o.
eretan	sleigh, sledge.
erik	meng-erik scream, shout, trumpet (of elephant).
ering	k.o. bird of prey.
erloji	see arloji.
erobik	1 aerobic. 2 exercise.
erong	lubang-erong (naut.) scupperhole.
eropa,eropah	europe, european.
eropanisasi	europeanization.
erosi	erosion.
erot	1. distorted, wry (of face). 2. ber-erot in a row, following exactly in e.o.'s traces.
erotik	1 eroticism. 2 erotic.
erotis	erotic.
erpah	land leased on a long-term basis.
erpekad	see rpkad.
erte	see rt.
erti	(me)ng-erti 1 understand. 2 (java) know.
eru	the australian pine (casuarina sp.).
erwe	see rw 2.
es	1 ice. es balok/batang block of ice. es-batu ice cube. es-serut shaved ice. 2 confection or drink with ice. es-campur iced mixed with fruits and syrup. es-teler iced fruit-cocktail with topping of condensed milk. es-lilin/loli/mambo/ roli popsicle.
esa,esa	(lit.) single, one.
esah	see sah 1.
esak	sakit-esak be short of breath.
esang	see kesang.
esde	see sd.
esei	essay.
eseis	essayist.
esek	see demam.
eselon	1 echelon. 2 (mil.) echelon, battle-array.
esema	see sma.
esembling	see asembling.
esempe	see smp.
esens	essence, odor, scent.
esensi	essence, quintessence, gist.
esensiil	essential.
eser	see sr.
eset	see ez.
esha	see sh.
eskadron	squadron.
eskalasi	escalation.
eskas	icebox, refrigerator.
eskatologi	eschatology.
eskatologis	eschatological.
eslandia	iceland.
esok	tomorrow, the next day.
esot	see ingsut.
espos	see ekspos.
espres	see ekspres.
esrar	see tanda.
estafet,estapet	(sport) relay race.
estetika	aesthetics.
estetis	aesthetic.
et	see eit.
etalage,etalase	shop window.
etatisme	statism.
etek	1. ng-etek crave. 2. (m) term of address for mother's younger sister.
eter	1 ether, upper air. 2 (med.). ether.
eternit	plasterboard.
ethika,etik,etika	ethics.
etiket	1. label (on bottle, etc.). 2. etiquette.
etimologi	etimology.
etiologi	etiology.
etis	ethical.
etnis	ethnic.
etnisitas	ethnicity.
etnografi	ethnography.
etnolinguistik	ethnolinguistics.
etnologi	ethnology.
etnologis	ethnological.
etos	ethos, ethics.
etsa	etch.
evakuasi	evacuation.
evaluasi	evaluation.
evaluir	meng-evaluir evaluate facts, etc.
evangelis	1 evangelist. 2 evangelical.
evangelisasi	evangelization.
evolusi	evolution.
ewa	(java) averse, unwilling.
ewe	(vulg.) meng-, ng-ewe copulate, have sexual intercourse.
ex	see also entries with eks.
eyang	(java) term of addres and reference for grandparent.
eyd.	(ejaan yang disempurnakan) official indonesian and malaysian spelling system since 1972.
eyel	obstinate in argument.
ez,ez,e-zet,ezet	(economische zaken) ministry of economic affairs (in colonial period).
f	f, the 6th letter of the alphabet.
fa	(firma) firm.
faal	1. 1) deed, work . 2) (med.) function, action (of body, organs, etc.). 2. sign, omen.
faali	physiological.
fabel	fable.
fabrik	see pabrik.
fabrikan	maker, manufacturer.
fabrikasi	manufacture, product.
fadihat	disgrace, shame, ignominy.
fadil	prominent, eminent, famous.
fadilat,fadzilat	excellence, prominence.
faedah	use, benefit, profit.
faham	see paham.
failasuf	see filsuf.
failit	see fayit.
fait-accompli	(fetakompli) fait accompli.
fajar	dawn.
fakih	(islam) expert in canon law.
fakir	1 poor, destitute, indigent. muslim or hindu religious mendicant.
fakta	fact.
faktor	1 factor, element. 2 (math.) factor.
faktual,faktuil	factual.
faktur	invoice.
fakultas	school of a university, faculty.
fakultatif,fakultatip	optional.
fakultet	see fakultas.
falak	1 celestial sphere. 2 (outer) space.
falsafah,falsafat	1 philosophy, philosophical system.
falsafi	philosophical.
fam	family name (esp. in e. indonesia).
famili	1 relative. 2 family.
familial	familylike.
familier	1 accustomed, used to doing. 2 intimate. 3 have an intimate or homelike atmosphere.
fana	1 transitory, fleeting. 2 perishable.
fanatik	adhering strictly to a religion.
fanatisme	fanaticism.
fani	perishable.
fantasi	1 fantasy, illusion, fancy. 2 imagination. 3 fancy.
fantastis	fantastic.
faraid,faraidz	(islam) law of inheritance.
faraj	see farji.
fardhu,fardu	1 obligatory. 2 (islam) religious obligation.
faring	(anat.) pharynx.
farji	vulva.
farmakologi	pharmacology.
farmakope	pharmacopoeia.
farmasi	pharmacy, drugstore.
fasal	see pasal.
fase	phase.
faset	facet.
fasid	imperfect.
fasih	1 fluent. 2 eloquent, quick-witted. 3 glib.
fasihat	eloquence.
fasik	godless, atheistic.
fasilita	/fasilitas/ facilities or conveniences put at o.'s service.
fasis	fascist.
fasisme	facism.
fatal	fatal.
fatalis	fatalist.
fatalisme	fatalism.
fatehah	see alfatihah.
fatsal	see pasal.
fatwa	1 (islam) a binding ruling in religious matters. 2 instructions, guidance of an order person.
favorit	favorite.
fayit	bankrupt.
fe	(fakultas ekonomi) school of economics.
feb	(februari) february.
februari	february.
federal	federal.
federalis	federalist.
federalisme	federalism.
federalistis	federalistic.
federasi	federation.
felbet	cot.
feminin	feminine
feminisme	feminism.
fener	see fineer.
fenomena,fenomin	phenomenon.
fentilasi	see ventilasi.
feodal	feudal.
feodalisme	feudalism.
feodalistis	feudalistic.
feri	ferry.
fermentasi	fermentation.
fertilitas	fertility.
festival	festival.
fetsin	see vetsin.
fh	(fakultas hukum) school of law.
fhipk,fhpk	(fakultas hukum dan (ilmu) pengetahuan kemasyarakatan) school of law and social sciences.
fiasko	fiasco.
figur	1 figure, shape. 2 figure, personage (in a story).
figura	see pigura.
figuran	supernumerary (actor or actress), extras (in a movie).
fihak	see pihak.
fikh	see fiqh.
fikir	pikir.
fiksi	fiction.
fiktif	fictitious.
filamen	filament.
filantrop	philanthropist.
filantropi	philanthropy.
filantropis	philantrophical.
filateli	philately.
filatelis	philatelist.
filem	see film.
filial	branch (of a firm, etc.).
filing	(coll.) 1 feeling, intuition. 2 lottery hunch.
filipin,filipina,filipinas	the philippines.
fill	1 behavior, deeds. 2 (lit.) verb.
film	1 film for camera. 2 film, movie.
filolog	philologist.
filologi	philology.
filologis	philological.
filosofi	philosophy.
filosofis	philosophical.
filsafah,filsafat	philosophy,ideology. 2 philosophical system. 3 (coll.) mysticism.
filsafati	philosophical.
filsuf	philosopher.
filum	(biol.) phylum.
filusuf	see filsuf.
final	(sport) finals.
finalis	finalist.
finansial,finansiil	financial.
finansir	financier.
fineer,finir	veneer.
finlandia	finland.
fipa,fippa	[fakultas ilmu pasti dan (pengetahuan) alam] school of mathematics and physical sciences.
fipia	[fakultas ilmu pasti dan alam] school of mathematics and physics.
fiqh,fiqih	(islam) study of laws pertaining to ritual obligations.
firaon	(fir'aon) see firaun.
firasat	1reading of s.o.'s character (by palmistry, physiognomy, etc.). 2 ability to prophesy the future. 3 presentiment, hunc, foreboding.
firaun	(fir'aun) 1pharaoh. 2 tyrant.
firdaus	paradise.
firdausi	heavenly, paradisiacal.
firma	firm, company, enterprise.
firman	saying, decree (diving or royal).
firus	k.o. gemstone, turquoise.
fis	[fakultas ilmu sosial] school of social sciences.
fisik	physical.
fisika	physics.
fisiografi	physiography.
fisiografis	physiographic.
fisiologi	physiology.
fisioterapi	physioterapy.
fisip	[fakultas ilmu sosial dan ilmu politik] school of social and polotical sciences.
fisipen	(sport) kingpin.
fiskal	1 fiscal. 2 (mil.) judge advocate. 3 departure tax was paid, exit-tax receipt.
fissi	(phys.) fission.
fiting	see fitting.
fitnah	slander, calumny.
fitrah	1. (islam in rice or cah paide at end of fasting month. 2. fitrah,fitrat natural tendency, disposition, character.
fitri	pure, natural.
fitting	light cocket, fixture.
fk	[fakultas kedokteran, fakultas keguruan] school of medicine, schoolof teacher training.
fkg	[fakultas kedokteran gigi] school of dentistry.
fkh	[fakultas kedokteran hewan] school of veterinary medicine.
fkip	[fakultas keguruan dan ilmu pendidikan] normal school.
flai	(sl.) euphoric and disoriented due to drugs or intoxicating beverages.
flamboyan	poinciana tree.
flanel	flanel.
flat	(flet) apartment.
fleksibel	flexible.
fleksibilitas	flexibility.
fles	see ples.
flet	see flat.
flipper	(coll.) dolphin.
floret	(sport) foil.
floridasi	fluoridation.
flu	influenza, a cold.
fluktuasi	fluctuation.
fluor	fluoride.
fluoroskop	fluoroscope.
fly	see flai.
fly-over	traffic overpass.
fobi	see phobi.
fohte,fokhte	(coll.) humid.
foklor	folklore
fokus	1 focus (of lens). 2 focus (of attention).
folio	foolscap-size paper.
fondamen	foundation.
fondasi	foundation.
fonds	(fin.) fund.
fonem	(ling.) phoneme.
fonemik	(ling.) phonemics.
fonemis	(ling.) phonemic.
fonetik	(ling.) phonetics.
fonetis	(ling.) phonetic.
fonologi	(ling.) phonology.
fonologis	(ling.) phonological.
forklif	(foklif, poklip) forklift.
formal	formal.
formalisir	memf- formalize.
formalitas	formality.
formasi	1 formation. 2 (mil.) formation. 3 position, aline item in the official budget for a certain employee.
format	format, form.
formatir,formatur	(pol.) person or committee appointed by an assembly to form the executive leadership, cabinet, etc.
formika	formica.
formil	see formal.
formulasi	formulation.
formule	formula.
formulir	form, declaration, blank.
forsir	memf- force, compel.
forum	forum, open discussion.
fosfat	phosphate.
fosfor	phosphorus.
fosil	fossil.
foto	photograph, picture.
fotograf,fotografer	photographer.
fotografi	photography.
fotokopi	1 photocopy. 2 (coll.) print of a video casette.
fotosintesa,fotosintesis	(biol.) photosynthesis.
foya,foya-foya	(ber)- foya be extravagant with money, throw money around.
fps	(fakultas pasca sarjana) graduate school.
fr.	(frater) (rel.) brother, friar.
fragmen	/fragmenta/ fragment.
fragmentaris	fragmentary.
fraksi	faction (in parliament), section (of political party).
framboesia	frambesia, yaws.
frambos	raspberry.
frambosen	raspberry flavored syrup.
frambus	see frambos.
frambusia	see framboesia.
franco,franko	surcharge paid to an expediter for shipments sent to a certain place.
frasa, frase	(ling.) phrase.
frater	(rel.) friar, brother.
fraude	fraud, swindle.
fregat	frigate.
frekuensi,frekwensi	frequency.
frigiditas	sexual frigidity.
frikatif	(ling.) fricative.
friksi	friction.
friser	(coll.) freezer, freezer compartment.
frobel	(coll.) kindergarten.
front	1 (pol.) fron, cadre. 2 (mil.) front (line).
frontal	frontal, head-on.
fronton	jai alai arena.
fruktosa	fructose.
frustrasi	1 frustration. 2 frustrated.
fs	[fakultas sastra] school of literature.
fuad	(lit.) heart.
fufu	meat of copra dried by heat.
fulan	see polan.
fuli	mace, the whorled interior skin or membrane of nutmeg.
fulus	1 filthy lucre. 2 (coll.) money.
fumigasi	fumigation.
fundamental,fundementil	fundamental.
fungisida	fungicide.
fungsi	1 fungtion, office, job. 2 fungtion, purpose.
fungsional	see fungsionil.
fungsionalisasi	fungtionalization.
fungsionalisme	functionalism.
fungsionaris,fungsioner	functionary, official.
fungsionil	fungtional.
funisia	phoenicia.
fuqoro-wal-masakin	(islam) the poor and the needy.
furak	difference,dissimilarity.
furuj	(lit) star.
furuk	teaching of ethics based on principles of religion.
fusi	1 (phys.) fusion. 2 (pol.) fusion, coalition.
futbal	soccer.
futur	(ling.) future.
futurolog	futurologist.
futurologi	futurology.
futurologis	futurological.
fuyonghai	(china) foo young, an omelette with meat and vegetables served with sweet and sour sauce.
g	g, the 7th letter of the alphabet.
g.	1. (gunung) mt., mount. 2. (gerakan) movement.
g30s	[gerakan 30 september] september 30th movement, the 1965 attempt to seize control of the gvt.
gaang	mole cricket.
gaba-gaba	(ambon) 1 garlands and other decorations made of palm fronds. 2 bamboo gate decorated with garlands of fronds, etc. 3 roof of sago palm fronds. 4 dried sago palm stems, esp. as building material.
gabag	german measles.
gabah	unhulled paddy separated from the stalks.
gabai	see gapai.
gabak	1. cloudy, overcast. meng-gabak gloomy, dark. 2. see gabag.
gabardine	gabardine.
gabas	1. in a hurry, hurriedly. 2. rough, coarse, not tidy.
gabir	clumsy, awkward, maladroit.
gableg,gablek	(java) be capable of doing s.t.
gabruk	sound of banging.
gabug,gabuk	1 empty (of rice, kernels, etc.). 2sterile. 3 childless.
gabung	1 bundle, sheaf. 2 cluster.
gabus	1. 1) k.o. tree, the soft wood of which is used as cork, scraper, etc. 2) cork. 2. k.o. wiely eaten freshwater fish, snakehead.
gacok,gacuk	the marble, card, etc. which o. picks as the means of winning in children's game of marbles, cards, etc., where the object is to accumulate marbles, etc.
gada	club, bludgeon, cudgel.
gada-gada	ship's weathervane.
gadai	1 pawning. 2 security. ber-gadai borrow money by pawning s.t.
gadang	1. large, big. rumah-gadang (minang) large sprawling house,esp. the matrilineal clan house. 2. large sieve. 3. ber-gadang see begadang.
gadang-gadang	meng-gadang hope for s.t.
gadar	see kadar 1.
gadas	bowling pin.
gaden	see surat.
gading	1 elephant tusk. 2 ivory. 3 ivory color.
gading-gading	1 joist, truss. 2 ribs of ship.
gadis	1 girl. 2 maiden, virgin.
gado	meng-gado eat side dishes without rice. gado-gado 1 k.o. salad eaten with peanut sauce. 2 s.t. consisting of various elements.
gaduh	1. 1) noisy. 2) boisterous, rowdy. 3) tumult. 2. meng-gaduh farm s.o.'s land or raise s.o.'s animals for a share in the product.
gaduk	arrogant, conceited.
gadung	k.o. creeping edible tuber which is toxic if not cooked properly.
gadungan	fake, bogus, imitation.
