hellish	ks. jahat, kejam. h. temper watak yang jahat.
hello	kb. salam. please say h. to your wife beri salam kepada istrimu. -kseru. halo.
helluva	ks. sl.: 1 buruk/jelek sekali. 2 baik sekali, luarbiasa, bukan main (soccer team).
helm	kb. kemudi. to be at the nation's h. mengemudikan negara, memimpin bangsa, menjadi pimpinan negara.
helmet	kb. topi baja. crash h. helm.
helmsman	kb. (j. -men) jurumudi.
help	kb. pertolongan, bantuan. -kseru. sungguh mati. -kkt. 1 menolong, membantu. 2 menuntun. -helping kb. porsi, mangkuk. a h. of rice seporsi nasi. h. hand. bantuan pertolongan.
helper	kb. pembantu, penolong.
helpful	ks. suka menolong, berguna, bermanfaat.
helplessness	kb. keadaan tdk berdaya.
helpmate	kb. pembantu, suami atau istri.
helpmeet	= helpmate.
helpness	ks. tdk berdaya, mati kutu.
helter-skelter	kk. dlm keadaan kacau balau, puntang-panting dan tergesa-gesa.
hem	kb. keliman, depun (of dress. -kkt. (hemmed) mengelim (a skirt).to h. and haw berbicara dgn ragu-ragu. to h. in mengepung, mengurung.
hemispere	kb. belahan bumi. the western h. belahan bumi barat.
hemlock	kb. cemara (beracun).
hemorrhage	kb. pendarahan.-kki. mengeluarkan darah.
hemorrhoids	kb., j. bawasir, puru sembelit.
hemp	kb. rami.
hemstitch	kb. jahit kelim.-kkt. mengelim.
hen	kb. ayam betina, induk ayam, babon.
hence	kk. sebab itu, karena itu, karenanya.
henceforth	kk. mulai sekarang, utk selanjutnya.
henchman	kb. (j.-men). pengikut, antek.
henhouse	kb. kandang ayam.
henna	kb. inai, pacar.
henpeck	kkt. menguasai, menaruh pengaruh. henpecked husband suami yg dikuasai oleh istrinya.
hep	ks. sl,: banyak mengetahui. to be h. to banyak mengetahui ttg.
hepatitis	kb. radang hati.
heptagon	kb. segi tujuh.
heptagonal	ks. bersegi tujuh.
her	kg. dia, ia, -nya.i see h. saya lihat dia. h. vacation liburannya. i wrote h. yesterday saya menyuratinya kemarin. to give a book to h. memberikan buku kepadanya. inf. : it's h.! itu dia! dialah itu!
herald	kb. bentara. -kkt. menggembar - gemborkan. his coming has been widely heralded kedatangannya itu sudah digembar-gemborkan kemana-mana.
heraldry	kb. (j. -ries) ilmu lambang.
herb	kb. med.: jamu. -herbs j. (for seasoning) ramuan untuk membumbui masakan, tumbuh-tumbuhan bumbu.
herbivore	kb. pemakan tumbuh-tumbuhan.
herbivorous	ks. (yg) hidup dari rumput atau tanam-tanaman, yang makan tumbuh-tumbuhan.
herculean	ks. seperti raksasa (kuatnya, besarnya). h. task pekerjaan raksasa.
herd	kb. kumpulan, kawanan. -kkt. mengumpulkan, menggembalakan. to h. together mengumpulkan, menggiring menjadi satu kumpulan.
here	kb. the h. and now waktu sekarang, sekarang ini. -kk. 1 (di)sini. 2 ini. 3 begini. 4 kesini, kemari. 5 sini.
hereabouts	kk. didekat/disekitar sini.
hereafter	kb. alam baka. -kk. sesudah ini, selanjutnya, sekarang.
hereby	kk. dengan ini. i h. declare that.. dengan ini saya permaklumkan bahwa...
hereditary	ks. 1 turun- temurun. h. position pangkat yang turun-temurun. 2 pusaka. h. estate tanah pusaka.
heredity	kb. (j. -ties) keturunan, hal turun-temurun, kebakaan.
herein	kk. didalam ini. the letter enclosed h. surat yang terlampir didalam ini.
hereinafter	kk. selanjutnya, sesudah ini.
heresy	kb. (j. -sies) bid(a)'ah, klenik.
heretic	kb. orang bid'ah.
heretical	ks. yang berhubungan dengan bida'ah.
hereto	kk. dengan ini.
heretofore	kk. sebelum ini, sampai sekarang. h. we had been good friends sebelum ini kami teman baik.
herewith	kk. bersama ini. i h. enclose... bersama ini saya lampirkan...
heritage	kb. warisan, pusaka. our cultural h. kebudayaan yang kita/kami warisi.
hermaphrodite	hermaphrodite
hermetically	kk. rapat-rapat, kedap udara. h. sealed dipateri/ditutup rapat-rapat.
hermit	kb. pertapa.
hermitage	kb. pertapaan.
hernia	kb. burut, turun berok.
hero	kb. pehlawan. hero-worship pemujaan (terhadap) pahlawan.
heroic	ks. 1 sengit, gagah berani. h. struggle perjuangan yang gagah berani. 2 bersifat kepahlawanan.
heroin	kb. heroin (sejenis obat bius yang dibuat dari morfin).
heroine	kb. pahlawan wanita.
heroism	kb. kepahlawanan.
heron	kb. burung bangau/jangkung.
herring	kb. ikan haring.
herringbone	kb. pola hiasan seperti kerangka haring. h. pettern corak seperti puncuk rebung
hers	kg. kepunyaan (perempuan). a. friend of h. seorang temannya. that book isn't h. buku itu bukan kepunyaannya.
herself	kg. dia, sendiri. lih self.
hesitancy	kb. (j. -cies) keragu-raguan.
hesitant	ks. ragu-ragu. he was h. to accept the job dia ragu-ragu menerima pekerjaan itu.
hesitate	hesitate
hesitation	kb. keragu-raguan.
het	ks. marah, naik darah, bersemangat. don't get so h. up janganlah begitu naik darah.
heterodox	ks. bida'ah, murtad.
heterogeneous	ks. heterogen, beraneka-ragam, berbeda-beda.
hew	kkt. (hewed, hewed atau hewn) menebang. to h. down a tree menebang pohon. -kki. to h. to memegang pada.
hewn	lih hew.
hex	kb. inf.: kutukan, guna-guna. to place a h. on s.o. menjatuhkan kutukan atau seseorang.
hexagonal	ks. bersegi enam.
hexameter	kb. heksameter, puisi yang baris-barisnya memuat enam derap/daktilus.
hey	kseru. he !
heyday	kb. masa jasa, jaman gemilang. in his h. he was a fine actor dalam masa kejayaannya dia adalah aktor yang baik.
hf	[high frequency] frekwensi tinggi.
hgt.	[height] tingginya, ketinggian.
hi	kseru. halo ! hi, how are you ? halo, apa kabar ?
hi-fi	[high fidelity] kb. inf.: perekaman dan pemancaran suara kembali dengan teliti.
hiatus	kb. rumpun, kekosongan, ruang kosong, ompong.
hibernate	hibernate
hibiscus	kb. waru, bunga raya/sepatu.
hiccough	= hiccup.
hiccup	kb. sedakan, sedu, ketegukan, kecegukan. -kki. tersedak, bersedu.
hick	kb. inf.: orang udik/dusun/kampungan.
hickory	kb. (j. -ries) sejenis pohon di a.s. yang buahnya berkulit keras.
hid	lih hide.
hidden	lih hide.
hide	kb. kulit, jangat. -kkt. (hid, hidden) menyembunyikan. -kki. bersembunyi. to h. out menyembunyikan diri. hide-and-seek kb. main alip-alipan/bulus-bulusan/umpet- umpetan/cari-carian. hidden treasure harta-benda yang terpendam. hiding pergi dalam bersem u
hideaway	kb. tempat persembunyian.
hidebound	ks. picik. h. opinion pendapat/pandangan yang picik.
hideous	ks. seram, mengerikan.
hideout	kb. tempat persembunyian.
hierarchy	kb. (j. -chies] hirarki.
hieroglyphics	kb., j. tulisan mesir kuno.
high	kb. 1 ketinggian, puncak. 2 meteor.: tekanan udara yang tinggi. 3 auto.: persneling tiga. ks. 1 tinggi. 2 mahal, tinggi (of prices). 3 besar. 4 tinggi, nyaring (of a voice). 5 inf.: mabuk. -highly kk. sangat, terlalu.
highball	kb. wiski dicampur dengan air (soda) dan es. -kki. sl.: berjalan dengan cepat. (of a train, auto).
highborn	ks. dari keturunan yang bangsawan.
highbrow	kb. inf.: cendekiawan. he has h. tastes dia mempunyai citarasa seorang ahli.
highchair	kb. kursi tinggi untuk bayi.
highfalutin(g)	ks. sl.: yang muluk-muluk, yang penuh gembar-gembor. h. language kata-kata yang muluk-muluk.
highlands	kb., j. tanah tinggi, pegunungan.
highlight	kb. hal/acara yang penting. -highlights j. pokok-pokok. -kkt. menyoroti, membunga-bungai.
highness	kb. keberatan. h. yang mulia.
hightail	kki.: berlari cepat.
highwater	h. mark garis tinggi air pasang.
highway	kb. jalan raya/besar. h. patrolman polisi patroli jalan-raya.
hijack	kkt. inf.: membajak, merampok. to h. a plane in midlair membajak kapal terbang di angkasa.
hijacker	kb. inf.: perampok, pembajak.
hijinks	kb., j. pesta gila, pesta- pora.
hike	kb. 1 perjalanan kaki. to go on h. pergi berjalan kaki. 2 inf.: kenaikan. salary h. kenaikan gaji.-kkt. inf.: to h. up o's trousers menarik celananya keatas. -kki berjalan kaki. -hiking kb. gerak jalan.
hiker	kb. pejalan kaki.
hilarious	ks. riang, gembira. h. party pesta yang meriah.
hilarity	kb. kegembiraan, keriangan, keriaan, keriuhan.
hill	kb. bukit. h. country daerah yang berbukit-bukit.
hillbilly	kb. (j. -lies) orang (yang diam di) pegunungan, orang udik/dusun. h. song lagu dusun/pegunungan - pegunungan, nyanyian udik.
hilliness	kb. keadaan berbukit-bukit.
hillock	kb. bukit kecil.
hillside	kb. lereng bukit.
hilltop	kb. puncak bukit.
hilly	ks. berbukit-bukit.
hilt	kb. puting, pangkal pedang. to enjoy life to the h. menikmati hidup sepuas-puasnya. up to the h. samasekali, sepenuhnya.
him	kg. dia (laki-laki), -nya. ask h. tanyalah dia.
himself	kg. diri(nya) sendiri. he keeps his thoughts to h. dia menyimpan (buah) pikirannya untuk diri sendiri.
hind	ks. belakang. h. leg kaki belakang.
hinder	kk. 1 menghalangi, merintangi. to h. him in his research menghalangi dia dalam penyelidikannya itu. 2 mengganggu. the noise hindered him from studying keributan itu mengganggu dia belajar.
hindi	kb. 1 orang hindi. 2 bahasa hindi.
hindmost	ks. yang paling belakang. everyone for himself and the devil take the h. setiap orang berusaha menyelamatkan dirinya dan/tidak mengacuhkan orang lain.
hindquarter	kb. bagian kaki belakang dan pinggang (mis. daging).
hindrance	kb. 1 halangan, rintangan. 2 gangguan. lih let kb.
hindsight	kb. peninjauan hal-hal yang sudah terjadi, melihat kebelakang.
hindu	kb., ks. hindu.
hinduism	kb. hinduisme, agama hindu.
hindustani	kb. 1 orang hindustan. 2 bahasa hindustan.
hinge	kb. 1 engsel. 2 phila.: sepotong kertas berlem guna menempelkan perangko dalam album. -kki. bergantung.
hint	kb.1 isyarat, petunjuk.2 bayangan, gambaran.3 tanda.-kki. membayangkan, mengisyaratkan.
hinterland	kb. daerah pedalaman.
hip	kb.1 pinggul.2 pangkal paha.-ks. sl. : modern.-kseru.h.. h. hurrah hip. hip. hura! hidup! horas! -hipped ks. sl, : keranjingan.
hipbone	kb. tulang pinggul/pinggang.
hippie, hippy	kb. (j.-pies) hippi
hippopotamus	kb. (j.-muses/-mesez/) kuda nil, badak sungai.
hire	kb. sewa. for h. bisa disewa, disewakan. -kkt.1 menyewa oto.2 menggaji, mengupahi.-hired ks. yg diupahi. -hiring kb. penyewaan, persewaan.
hireling	kb. orang sewaan.
his.	kg.-nya, kepunyaannya (laki-laki).h. book bukunya. this book is h. buku ini dia (yg) punya.buku ini punya dia.
hiss	kb.1 (bunyi) suitan.2 desis (of steam, gas). -kkt. mengejek, mencemoohkan.-kki. bersuit.-hissing kb. bersuit-suit, suitan, desis.
histology	kb. ilmu jaringan tubuh.
historian	kb. ahli sejarah, sejarawan.
historic	ks. bersejarah. h. landmark tempat kejadian yg bersejarah.
historical	ks. berh. dgn sejarah.-historically kk. menurut sejarah.
historiography	kb. penulisan sejarah.
history	kb. (j.-ries) sejarah.
histrionics	kb. seni drama.
hit	kb.1 pukulan (boxing, baseball).2 sukses.3 suatu tindakan yg mengenai sasaran.-kkt. (hit) 1 memukul.2 mengenai.3 membentur, menabrak.-kki.1 tenn.: masuk.2 terbentur.to h. at memukul.to h. back 1 memukul kembali.2 membalas serangan.ks. untung-untungan.
hitch	kb.1 (jerk) sentak.2 (snag) rintangan,halangan.3 inf. : jangka waktu. sl. : they were hitched last week mereka kawin minggu yg lalu. inf. : to h. a ride membonceng. to h. up memasang hewan penarik pd kereta.
hitchhike	kki. menggonceng, minta nunutan,membonceng.
hitchhiker	ks. seorang yg membonceng, tukang bonceng, pembonceng.
hither	kk. kesini-kemari. h. and thither kesini-kesana, kesana kemari.
hitherto	kk. sampai sekarang (ini).
hitter	kb. pemukul.
hive	kb. sarang (utk lebah). -hives j. penyakit, rasa gatal dgn bintik-bintik merah dan bengkak dll.
hoard	kb. timbunan. h. of money timbunan uang. -kkt. menimbun. to h. up menimbun. -hoarding kb. penimbunan.
hoarder	kb. penimbun.
hoarfost	kb. embun beku (berwarna putih).
hoarse	ks. parau, serak. to shout o.s. h. berteriak-teriak sampai parau.
hoary	ks. tua, beruban.
hoax	kb. olok-olok(an), cerita bohong. -kkt. memperdayakan.
hobble	kkt. mengikat kaki (kuda). -kki. berjalan pincang.
hobby	kb. (j. -bies) kegemaran.
hobbyhorse	kb. kuda-kudaan, kuda main-mainan. to ride o's favorite h. membicarakan persoalan yang disenanginya.
hobgoblin	kb. orang kerdil, hantu.
hobnob	kki. (hobnobbed) bergaul (rapat) dengan.
hobo	kb. orang gelandangan/jembel/gembel.
hock	kb. sl.: keadaan berhutang / menggadaikan. to be in h. banyak berhutang. to put o's ring in h. menggadaikan cincin. -kkt. sl.: menggadaikan.
hockey	kb. (permainan) hockey.
hocus-pocus	kb. permainan sunglap.
hodgepodge	kb. campur-aduk, gado-gado.
hoe	kb. cangkul, pacul. -kkt. mencangkul (i).
hog	kb. babi. h. raising peternakan/pemeliharaan babi. sl.: to go the whole h. mengerjakan sesuatu sepenuhnya. -kkt. (hogged) sl.: 1 menjadi pusat perhatian. 2 memonopoli (the road). hog-wild ks. sl.: lupa daratan, mengamuk.
hogwash	kb. sl.: omong kosong.
hoist	kb. 1 kesekan. 2 lift. -kkt. 1 menaikkan, mengerek. to h. the colors menaikkan bendera. 2 mengangkat. to h. a safe to the third floor mengangkat lemari besi ke tingkat ketiga.
hoity-toity	ks. angkuh, sombong. kseru. astaga ! y a allah.
hokum	kb. sl.: kebohongan, humor murahan.
hold	lih hold.
holder	kb. 1 tempat. cigarette h. tempat rokok. 2 pemilik (of shares). 3 pemegang (of records).
holdover	kb. 1 peninggalan. 2 pegawai (lama) yang masih dipertahankan.
holdup	kb. perampokan, penghadangan, penggarongan, penodongan, pembegalan. h. man penodong, tukang todong, perampok, pembegal
hole	kb. 1 lubang, lobang. 2 rongga. 3 liang. 4 (water) lubuk. 5 kekurangan, kelemahan, kesalahan. 6 golf ; lubang, hole. -kki. to h. up pergi menjauhkan/mengasingkan. diri. hole in the wall kb. gubuk kecil. ks. kecil, miskin.
holiday	kb. hari besar/raya. where are you spending the holidays ? dimana kau menghabiskan/meliwatkan hari-hari liburmu ?
holiness	kb. kesucian, kekudusan. his h. the pope sri paus.
holland	kb. negeri belanda.
holler	kki. inf.: berteriak (halo).
hollow	kb. lembah. -ks. 1 berlubang. 2 bergaung, bergema. 3 palsu. 4 cekung, caung, kempung (of eyes, cheeks). -kk. lemah. -kkt. to h. out melubangi. hollow-eyed ks. bermata cekung. hollow-sounding ks. yang dibuat-buat saja, dempang, berbunyi kosong.
holly	kb. sejenis tumbuh-tumbuhan yang hijau dan runcing daunnya, dan buahnya merah bergugus-gugus.
hollyhock	kb. sejenis tumbuh-tumbuhan hiasan.
holocaust	kb. 1 bencana. 2 pembakaran.
holster	kb. sarung pistol.
holy	ks. 1 suci, kudus. 2 keramat. h. bible kitab injil. h. city baitul mukaddas. h. father sri paus. h. scripture kitab injil.
homage	kb. penghormatan. to pay h. to menyembah/memberi penghormatan kepada.
home	kb. 1 rumah. 2 tempat diam. 3 kampung halaman. 4 panti asuhan. -homing pigeon merpati pos.
homebody	kb. (j. -dies) orang yang senang atau yang lebih suka tinggal di rumah.
homecoming	kb. 1 acad.: reuni alumni. 2 pulang ke rumah/kampung.
homefolk	kb. 1 orang sekampung, tetangga. 2 keluarga.
homeland	kb. tanah air, tanah tumpah darah.
homeless	ks. tunawisma.
homelike	ks. yang menyenangkan, seperti suasana rumah (sendiri).
homeliness	kb. kesederhanaan.
homely	ks. 1 sederhana, bersahaja. 2 tidak cantik (of a person).
homemaker	kb. ibu rumah tangga.
homeowner	kb. pemilik rumah.
homesick	ks. rindu, hendak pulang ke kampung.
homesickness	kb. kerinduan.
homesite	kb. tanah perumahan.
homespun	ks. 1ditenun di rumah. h. cloth kain tenunan sendiri. 2 sederhana. h. philosophy filsafat yang sederhana.
homestead	kb. rumah (dan pekarangannya).
hometown	kb. kota kediaman. we're from the same h. kami sekampung.
homeward(s)	ks. pulang. the h. trip perjalanan pulang. -kk. the ship is h. bound kapal dalam perjalanan pulang.
homework	kb. pekerjaan rumah, pr. to do o's h. 1 mengerjakan pekerjaan rumah. 2 inf.: mempersiapkan diri.
homey	ks. seperti di rumah, enak.
homicidal	kb. yang berhubungan dengan pembunuhan.
homicide	kb. pembunuhan. member of the h. squad seorang penyelidik pembunuhan.
hominy	kb. bubur jagung.
homo	sl.: homosexual. kb.
homogeneity	kb. keserbasamaan.
homogeneous	ks. serbasama, homogen.
homogenize	kkt. membuat sejenis. homogenized milk susu yang dibuat/dicampur sedemikian rupa sehingga tidak ada kepala susunya.
homonym	kb. homonim, kata sebunyi.
homophone	kb. huruf sebunyi.
homosexual	kb. homoseks. -ks. homoseksuil.
homosexuality	kb. homoseksualitas.
homy	= homey.
hone	kkt. mengasah, mengikir. -honing kb. pengasahan, pengikiran.
honest	ks. jujur, lurus hati. h. face muka yang jujur. -honestly kk. secara jujur, dengan terus terang.
honesty	kb. kejujuran, kelurusan hati. in all h. dengan terus terang.
honey	kb. 1 madu. 2 sayang (form of address of husband to wife, wife to husband). i love you, h. saya cinta padamu, sayang.
honeybee	kb. lebah yang bermadu.
honeycomb	kb. sarang madu/lebah.
honeydew	h. melon semacam semangka (kulitnya putih).
honeymoon	kb. bulan madu. -kki. berbulan madu.
honeymooner	kb. orang yang sedang berbulan madu.
honeysuckle	kb. semacam kamperfuli.
honk	kb. bunyi tuter. h.! h.! tet ! tet ! -kkt. membunyikan. to h. the horn membunyikan klakson. -kki. mengklakson. the car honked mobil itu mengklakson.
honor	kb. 1 kehormatan. 2 kemurnian (of a woman). 3 yang terhormat. (from of address to a judge). -honors j. 1 tanda-tanda jasa. 2 bridge : kartu-kartu yang tertinggi. -kkt. menghormati. 2 menerima, menguangkan (a check). 3 mempertahankan, menetapi.
honorable	ks. 1 yang terhormat. 2 yang mulia. -honorably kk. dengan hormat.
honorarium	kb. (j. -ria) uang jasa, honorarium, imbalan, honor.
honorary	ks. kehormatan. h. member anggota kehormatan. h. degree gelar kehormatan.
honorific	kb. sebutan kehormatan.
hood	kb. 1 kerudung (kepala). 2 auto.: kap. 3 sl.: buaya darat, penjahat.
hooded	ks. berkerudung. h. snake ular sendok.
hoodlum	kb. penjahat, buaya darat.
hoodoo	kb. inf.: sial, naas. to put a h. on s.o. menjadikan seseorang sial.
hoodwink	kkt. menipu, memperdayakan.
hoof	kb. (j. hooves) kuku ( binatang). -kkt. to h. it inf.: berjalan.
hook	kb. 1 sangkutan, cantelan (of clothes). 2 (fish) kail. 3 kait(an), pengait. 4 hak (on door, window). -kkt. 1 menyangkutkan. 2 mengail (fish). 3 memancing. hook-nosed ks. berhidung kakaktua. -hooked ks. 1 bengkok (nose). 2 ketagihan, doyan.
hookey	= hooky.
hookup	kb. 1 pemasangan, persambungan. 2 siaran radio atau televisi.
hookworm	kb. cacing tambang.
hooky	kb. sl.: to play h. membolos.
hooligan	kb. = hoodlum.
hoop	kb. 1 gelindingan. 2 simpai (of barrel, drum). h. skirt rok bergelung/kembang.
hooray	= hurrah.
hoot	kb. teriak(an). inf.: to care/give a h. peduli. -kkt. meneriaki. -kki. berteriak-teriak. -hooting kb. ejekan.
hooves	lih hoof.
hop	kb. 1 loncatan, lompatan. 2 penerbangan. 3 buah hop. 4 pesta dansa/tari-menari. -kkt. (hopped) 1 inf.: meloncat (aboard a freight train). 2 turun naik. -kki. melompat, meloncat. -hopping kk. sangat. he was h. mad dia sangat marah.
hope	kb. harapan. -kki. berharap, mengharap.
hopeful	ks. penuh harapan. he was h. of.. besar harapannya bahwa...
hopeless	ks. tidak ada harapan, putus asa, sia-sia. h. task pekerjaan yang sia-sia. -hopelessly kk. dengan tidak ada harapan. he's h. drunk ia mabuk sekali.
hopelessness	kb. keputusasaan, keadaan putus-asa.
hopper	kb. 1 pelompat. 2 gerobak. coal h. gerobak batubara.
hopscotch	kb. main jingkat/pincang-pincangan.
horde	kb. 1 gerombolan (of savages). 2 sekelompok, sekumpulan (of ants).
horizon	kb. kaki langit, ufuk, horison. on the h. di masa datang.
horizontal	kb. garis mendatar. -ks. mendatar. h. line garis mendatar. -horizontally kk. secara horizontal.
hormone	kb. hormon.
horn	kb. 1 terompet. 2 tanduk (of goat, etc). 3 auto.: klakson. -kki. sl.: to h. in menyelundup masuk (kedalam). -horned ks. bertanduk.
hornbill	kb. burung enggang/lilin.
hornet	kb. langau kerbau, tabuhan, penyengat. to stir up a hornet's nest menimbulkan keributan, membangunkan ular tidur.
horoscope	kb. primbon, pestaka, tenung, ramalan.
horrendous	ks. menghebohkan.
horrible	ks. mengerikan. what a h. sight ! alangkah ngerinya pemandangan itu ! -horribly kk. mengerikan. h. burned mendapat luka bakar yang mengerikan.
horrid	ks. 1 mengerikan. a h. cut luka yang mengerikan. 2 inf.: tidak enak (of a person).
horrify	kkt. (horrified) menakutkan, mengejutkan. we were horrified to learn of his death kami merasa terkejut sekali mendengar kematiannya.
horror	kb. kenngerian, ketakutan. to have a h. of takut/ ngeri sekali akan horror-stricken ks. lumpuh ketakutan, tak berdaya karena ketakutan.
hors d'oeuvre	kb. makanan kecil, penganan, kudapan.
hors(e)y	ks. 1 suka pada kuda, gemar berkuda. 2 sl.: besar dan canggung (of build).
horse	kb. 1 kuda. 2 (saw-horse, trestle) kuda-kuda. -kki. sl.: to h. arround mempermainkan.
horseback	kb. punggung kuda. h. ride naik kuda. to go on h. (pergi) naik kuda.
horsefly	kb. (j. -lies) langau/lalat kuda.
horsehair	kb. bulu kuda.
horselaugh	kb. gelak terpingkal-pingkal, tertawa riuh.
horseman	kb. (j. -men) penunggang kuda.
horsemanship	kb. kepandaian menunggang kuda.
horsemeat	kb. daging kuda.
horseplay	kb. kelakar yang kasar dan ribut,permainan kasar.
horsepower	kb. daya kuda [dk].
horseradish	kb. semacam tanaman lobak.
horseshoe	kb. ladam, sepatu kuda.
horsewhip	kb. pecut, sambuk, cambuk. -kkt. (horsewhipped) memukuli, menghajar.
horticultural	ks. yang mengenai ilmu perkebunan.
horticulture	kb. ilmu perkebunan, hortikultura.
horticulturist	kb. ahli perkebunan.
hose	kb. 1 cloth.: kaus kaki. 2 pipa air (dari karet), selang karet. -kkt. to h. down/off menyemprot, menyirami (a car, lawn, burning house).
hosiery	kb. kaus kaki.
hospitable	ks. ramah, bermurah hati, senang menjamu.
hospital	kb. rumah sakit. h. attendant perawat, jururawat rumah sakit. h. ship kapal rumah sakit.
hospitality	kb. (j. -ties) keramah-tamahan, kesukaan/kesediaan menerima tamu.
hospitalization	kb. hal masuk rumah sakit, hal berobat di rumah sakit, opname.
hospitalize	kkt. masuk rumah sakit, menghospitalkan, mengopname.
host	kb. 1 tuan rumah. 2 (wafer)hosti, roti suci. 3 rombongan besar. a whole h. of ants sekumpulan besar semut.
hostage	kb. sandera.
hostel	kb. asrama, pondok(an). losmen. youth h. asrama pemuda.
hostess	kb. 1 nyonya rumah. 2 rest.: kepala pelayan. airlines h. pramugari. nightclub h. pramuria.
hostile	ks. bermusuhan. h. attitude sikap bermusuhan. to have h. feelings towards berperasaan permusuhan terhadap.
hostility	kb. permusuhan. -hostilities j. permusuhan, peperangan kecil-kecilan.
hot	ks. 1 panas. 2 inf.: hebat. 3 pedas. 4 sulit. 5 sl.: enak. 6 sl.: dicari/dikejar/diuber. 7 sl.: beruntung, mujur. -hotly kk. dengan semangat/hangat.
hour	kb. 1 jam. 2 saat. -hours j. 1 jam-jam. 2 waktu.
hourglass	kb. jam pasir.
hourly	ks. sejam, setiap jam, per jam. h. wage upah perjam. -kk. sekali satu jam. to take medicine h. minum obat sekali sejam.
house	kb. 1 rumah. 2 rumah tangga.3 dewan perwakilan rakyat. 4 majelis. 5 keturunan kerajaan. 6 thea.: para penonton.-kkt. 1 menempatkan, mengasramakan, memondokkan. 2 menyimpan. -housing kb. 1 perumahan, penginapan. 2 blok/kerangka mesin.
houseboat	kb. rumah perahu, rumah terapung.
housebound	ks. terkurung di rumah.
houseboy	kb. pelayan rumah.
housebreaker	kb. pencuri/pembongkar rumah.
housebreaking	kb. mencuri dengan membongkar rumah.
housebroken	ks. terlatih untuk tidak buang air dalam rumah.
housecleaning	kb. pembersihan rumah.
housecoat	kb. hoskut.
housedress	kb. baju rumah.
housefly	kb. (j. -flies) lalat, lalar.
houseful	kb. serumah penuh. we had a h. of guests this weekend akhir pekan ini rumah kami penuh dengan tamu.
household	kb. rumah tangga. the entire h. attended the wedding seisi rumah itu menghadiri perkawinan itu.
housekeeper	kb. pengurus rumah-tangga.
housekeeping	kb. berumah tangga. to set up h. mulai berumah tangga.
housemaid	housemaid
housemate	kb. teman serumah.
housemother	kb. ibu asrama.
housetop	kb. puncak (atap) rumah. to shout from the h. mengumumkan kemana-mana.
housewares	kb., j. perkakas/perabotan.
housewarming	kb. selamatan memasuki atau menaiki rumah baru.
housewife	kb. (j. -wives) isteri, nyonya rumah, ibu rumah tangga.
housework	kb. pekerjaan rumah tangga.
hove	lih heave.
hovel	kb. pondok, gubuk.
hover	kki. 1 menunggu dekat. 2 melayang-layang (of a bird, helicopter).
how	1 bagaimana. 2 bagaimana caranya. 3 berapa. 4 betapa. 5 apa. 6 apa sebabnya. 7 alangkah. 8 kenapa.
howdy	kseru. inf.: bagaimana ! apa kabar !
however	kk. bagaimanapun, betapapun, biarpun. -ksam. (akan) tetapi.
howl	kb. 1 deru (of the wind). 2 gonggong (of a dog, wolf). 3 teriak. 4 tangis. -kki. menggonggong, melolong, meraung (of animals).
howler	kb. inf.: kesalahan (besar).
hrs.	[hours] jam.
ht.	[height] tingginya.
hub	1 naf, nap. 2 pusat. h. of the financial district pusat daerah keuangan. h. of the universe pusat alam semesta.
hubbub	kb. keributan, kebisingan, keriuhan.
hubby	kb. (j. -bies) inf.: pap, papi (julukan buat suami).
hubcap	kb. dop (roda).
huckleberry	kb. (j. -ries) semacam buah frambos kecil.
huckster	kb. penjaja, pedagang keliling.
huddle	kb. berkumpul/berkerumun dengan membungkuk. to be in a h. berjubal. -kkt. berjubal, berdempet. to h. together berimpit-impitan.
hue	kb. (corak) warna, warna-warni. h. and cry tampik sorak. to raise a h. and cry berteriak-teriak.
huff	kb. kemarahan, kegusaran. to go off in a h. berangkat dengan marah.
huffy	ks. cepat marah, mudah tersinggung. don't act so h. janganlah berlaku/bersikap cepat marah.
hug	kb. peluk(an), rangkulan, rangkuman. -kkt. (hugged) 1 memeluk, merangkul, merangkum. 2 melanggar (the curb). 3 menyusur (the shore).
huge	ks. 1 sangat besar. 2 sangat banyak. -hugely kk. luar biasa besarnya, tingginya dsb.
huh	kseru. he, ya.
hulk	kb. badan kapal. a ship's h. bangkai kapal.
hulking	ks. bagur.
hull	kb. nau.: badan bahara, lambung kapal. 2 sekam, kulit (of a peanut). -kkt. menguliti.
hullabal(l)oo	kb. keributan, kebisingan, keriuhan. to make/raise a h. menimbulkan keributan.
hum	kb. deruman, dengungan,senandung. h. of a car suara derum mobil. h. of bees dengung tawon. -kkt., kki. (hummed) menyanyi kecil, bersenandung. -humming kb. dengungan, deruman.
human	kb. manusia. ks. bersifat manusia. she's very h. dia sangat pengasih. -humanly kk. secara kemanusiaan. h. possible dari batas kemampuan manusia.
humane	ks. peramah, orang yang penyayang. she's a h. person di adalah seorang yang peramah.
humanism	kb. humanisme, perikemanusiaan.
humanist	kb. penganut paham humanisme, budayawan.
humanitarian	kb. pengasih sesama manusia. -ks. berperikemanusiaan.
humanitarianism	kb. (peri)kemanusiaan.
humanity	kb. (j. -ties) 1 umat manusia, menusia seluruhnya. 2 perikemanusiaan. -the humanities j. ilmu sastera.
humanize	kkt. mempermanusia. memperlakukan sebagai manusia.
humble	ks. 1 sederhana, rendah (of dwelling, of upbringing). 2 rendah hati. to eat h. pie terpaksa mengaku kesalahannya dan minta maaf. -humbly kk. dengan merendahkan hati.
humbug	kb. 1 penipu, pengecoh, pembual. 2 cakap-besar, omong kosong, pengoceh.
humdrum	ks. yang membosankan/menjemukan. a h. life kehidupan yang membosankan.
humerus	kb. tulang bagian atas dari lengan atau kaki depan.
humid	ks. lembah, lengas.
humidifier	kb. alat pelembab udara.
humidify	kkt. (humidified) melembabkan.
humidity	kb. kelembaban, kelengasan.
humidor	kb. kotak/tempauan/kaleng tembakau.
humiliate	kkt. 1 menghina. 2 memalukan. to h. o's parents memalukan orang tuanya. -humiliating ks. 1 menghinakan. 2 memalukan.
humiliation	kb. penghinaan.
humility	kb. (j. _ties) kerendahan hati.
hummingbird	kb. semacam burung kolibri.
humor	kb. kejenakaan,kelucuan. in good h. dalam keadaan menyenangkan. -kkt. menyenangkan hati, menghiburkan.
humorist	kb. orang pelucu, jenakawan.
humorous	ks. lucu, penuh kelucuan, yang menggelikan.
hump	kb. 1 onok (of a camel). 2 bongkol. 3 punggung bukit barisan. over the h. melalui saat-saat kritis. -kkt. membungkukkan (the back).
humpback	kb. 1 punggung bungkuk. 2 orang yang berpunggung bungkuk, sibongkok.
humpbacked	ks. berpunggung bungkuk.
humus	kb. humus, bunga tanah, tanah (gemuk).
hunch	kb. inf.: firasat, prasangka, dugaan. to sit hunched up duduk membungkuk.
hunchback	kb. orang bungkuk.
hunchbacked	ks. bungkuk, berpunggung bungkuk.
hundred	kb., j. (se)ratus. a. h. and two seratus dua.
hundredfold	kb., ks. seratus kali. he repaid me a h. ia membalas kebaikan saya seratus kali lipat.
hundredth	ks. keseratus.
hundredweight	kb., j. ukuran berat 50 pon inggris atau 100 pon amerika serikat.
hung	lih hang.
hungarian	kb. 1 orang hongaria. 2 bahasa hongaria. -ks. yang berhubungan dengan hongaria.
hungary	kb. hongaria.
hunger	kb. kelaparan, rasa lapar. h. pains perut kosong. -kkt. sangat menginginkan/mengharapkan/ merindukan/mendambakan. to h. after ice cream ingin sekali minum eskrim. h. strike mogok makan.
hungry	ks. lapar. to be h. lapar. to get h. menjadi lapar.
hunk	kb. bingkah, bongkah, bungkal. a h. of bread sebingkah roti.
hunker	kki. bercangkung, mencangkung.
hunky-dory	ks. sl.: baik sekali.
hunt	kb. 1 pemburuan, perburuan. 2 pencarian. -kkt. memburu, berburu. -hunting kb. pemburuan. to go h. pergi berburu.
hunter	kb. 1 pemburu. souvenir h. pemburu tandamata. 2 penggemar.
hurdle	kb. sport : gawang. high/low hurdles lari gawang tinggi/rendah. 2 rintangan, halangan. -kkt. 1 melompati (a fence). 2 melintasi, mengatasi (an abstacle).
hurdler	kb. pelari gawang.
hurdy-gurdy	kb. (j. -dies) lir, orgel jalanan (yang dimainkan dengan alat putaran).
hurl	kkt. melemparkan (a stone, javelin). to h. defiance at the crowd menantang orang banyak itu.
hurly-burly	kb. (j. -lies) huru hara, hiruk-pikuk.
hurrah	kb. sorakan, teriakan karena kegembiraan. to give a h. bersorak. -kseru. hure.
hurricane	kb. angin ribut/topan.
hurried	lih hurry.
hurries	lih hurry.
hurry	kb. (j. -ries) 1 kegopohan. 2 buru-buru, tergesa-gesa. -kkt. (hurried) 1 menyegerakan. 2 mempercepat. 3 melakukan dengan terburu. 4 menyuruh melakukan dengan cepat. -kki. bergegas (-gegas). hurried ks. sekilap, sekejap mata, cepat-cepat.
hurt	kb. luka. -kkt. 1 menyakiti (feeling, body). 2 melukai. 3 merugikan. -kki. 1 sakit. 2 melukai hati.
hurtle	kki. 1 meluncur dengan cepat. 2 menderu dengan cepat (of a train).
husband	kb. suami. h. and wife suami istri. -kkt. menghematkan, berhemat dengan (resources, strength).
husbandry	kb. pertanian. animal h. peternakan hewan.
hush	kb. diam, hening. -kkt. mendiamkan. -kki. diam. h. money uang sogok/suap/hangus.
husk	kb. kulit ari, sekam. -kkt. mengupas (corn).
huskiness	kb. keparauan (of voice).
husky	kb. (j. -skies) anjing eskimo. -ks. 1 parau, serak(of voice). 2 besar dan kuat. he's a h. boy dia adalah anak yang berbadan tegap lagi kuat.
hussy	kb. (j. -sies) gadis tak sopan, perempuan yang nakal sekali.
hustle	kb. inf.: kegiatan, semangat bertanding/bekerja yang meluap. -kkt. memaksa dengan cepat.-kki. buru-buru.
hustler	kb. orang yang giat dan mempunyai banyak tenaga.
hut	kb. pondok, gubuk.
hyacinth	kb. sejenis bunga bakung.
hybrid	kb. 1 bastar, cangkokan. 2 peranakan. h. plant tanaman cangkokan, tanaman yang dikawinkan.
hydrangen	kb. sebangsa semak.
hydrant	kb. 1 sambungan pipa air di tepi jalan untuk keperluan kebakaran. 2 pipa air.
hydraulic	ks. hidrolis, hidrolik. h. brakes rem hidrolik. -hydraulics j. hidrolika.
hydrocephalus	kb. kepala busung.
hydrochloric	ks. zat asam garam. h. acid air keras.
hydrodynamics	kb. hidrodinamika.
hydroelectric	ks. hidrolisterik. h. power tenaga hidrolisterik.
hydrogen	kb. zat air, hidrgen. h. bomb bom hidrogen. h. peroxide peroksida zat air.
hydrographic	ks. mengenai pengetahuan tentang perairan. the h. service jawatan hidrografi.
hydrography	kb. (ilmu) hidrografi.
hydrology	kb. (ilmu)tata air, hidrologi.
hydrophobia	kb. penyakit anjing gila.
hydroxide	kb. hidroxid(a).
hyena	kb. dubuk.
hygiene	kb. ilmu kesehatan. h. kesehatan pribadi/perseorangan
hygienics	ks. menurut ilmu kesehatan. under h. condition dengan syarat-syarat yang menjamin kesehatan badan.
hygienist	kb. ahli kesehatan. dental h. perawat gigi.
hymen	kb. selaput dara, jangat keperawanan.
hymn	kb. nyanyian pujian, hymne.
hymnal	kb. buku nyanyian pujian.
hymnbook	kb. buku nyanyian pujian.
hyperactive	ks. sangat giat/aktip.
hyperbola	kb. hiperbola.
hyperbole	kb. penghebat, ucapan yang bersifat berlebih-lebihan.
hypercritical	ks. sangat suka mengeritik.
hypersensitive	ks. terlalu halus perasaan, sangat perasa.
hypertension	kb. hipertensi.
hyphen	kb. tanda sengkang/penghubung.
hyphenate	kkt. menghubungkan dengan garis penghubung. hyphenated word kata yang diuraikan/dituliskan dengan memakai garis penghubung.
hypnosis	kb. hipnose.
hypnotic	ks. hipnotis, hipnotik.
hypnotism	kb. hipnotisme, ilmu sihir.
hypnotist	kb. ahli hipnotisme
hypnotize	kkt. menghipnotisir, menghipnotis.
hypo	kb. 1 inf : suntikan, injeksi. 2 sl.: penyedih, seorang yang menderita penyakit cemas.
hypochondria	kb. penyakit bersedih hati, kesedihan tanpa alasan.
hypochondriac	kb. seorang yang terlalu cemas terhadap kesehatannya.
hypocrisy	kb. (j. -sies) kemunafikan, muka dua, pura-pura.
hypocrite	kb. orang munafik, lidah biawak.
hypocritical	bersifat munafik, bermuka dua.
hypodermic	kb. injeksi. -ks. h. needle jarum suntik.
hypotenuse	kb. hipotenuse.
hypothesis	kb. hipotesa
hypothesize	kki. mengadakan hipotesa tentang.
hypothetical	ks. hipotetis.
hysteria	kb. penyakit histeria, gangguan syaraf.
hysterical	ks. histeris. -hysterically kk. secara histeris. to cry h. menangis secara histeris.
hysterics	kb., j. naik pitam, kemasukan setan. to go into h. tertawa terbahak-bahak.
i	kg. saya, aku, gua. i am sick saya sakit. it's i saya.
i'd	1 [ i had] saya telah. 2 [ i would] saya akan.
i'll	[1 i shall 2 i will] saya akan.
i'm	[i am] saya adalah.
i've	[i have] lih have.
i,i	kb. huruf yang kesembilan dari abjad inggris.
i.	[island(s) ] pulau, kepulauan.
i.d.	1[intelligence division] bagian intelijen. 2 [identity] identitas. i.d. cord surat keterangan diri, kartu pengenal.
i.e.	[id est] yaitu, yakni.
i.o.u., iou	[i owe you] kb. tanda terima hutang/pinjaman.
i.r.	[internal revenue] kantor pajak.
i.r.s.	[internal revenue service] dinas perpajakan.
ia	[iowa] sebuah negarabagian di a.s.
iambic	ks. (beriramakan) yambe atau deretan pertentangan bunyi lemah dan keras.
ibid.	[ibidem] dalam buku itu juga, dalam bab, bagian dll, yang tersebut.
ibidem	kk. lihat dalam buku, tempat, bab, fasal itu juga.
ibm	[intercontinental ballistic missile] peluru kendali antar benua.
icbm	[intercontinental ballistic misile] peluru kendali antara benua.
icc, i.c.c.	[interstate commerce commossion] panitia perdagangan antar negara.
ice	ice
iceberg	kb. gunung atau gumpalan es yang terapung.
icebound	ks. terkepung oleh es, terdampar ditengah-tengah es.
icebox	kb. peti/lemari es.
icebreaker	kb. kapal pemecah es.
icecap	kb. 1 es. 2 kantong es.
icelandic	ks. yang bertautan dengan islandia. i. language bahasa islandia.
iceman	kb. (j. -men) tukang es.
ichthyology	kb. ilmu pengetahuan tentang ikan.
icicle	kb. untaian tetesan air yang membeku.
iciness	kb. hal seperti es.
icky	ks. sl.: sentimentil, menjijikkan.
icon	kb. patung/gambar orang suci.
iconoclast	kb. 1 orang yang menentang. pemujaan patung berhala. 2 orang yang menentang pemujaan lembaga-lembaga yang telah ada.
iconography	kb. ikonografi, ilmu arca.
icy	ks. 1 licin karena es. the streets are i. today jalan-jalan licin karena es hari ini. 2 dingin, tidak ramah (look).
id(a).	[idaho] negarabagian a.s.
idea	kb. 1 gagasan, idea, pikiran. 2 rencana, idea. 3 cita-cita. 4 maksud. 6 pemikiran.7 gambaran. 8 angan-angan.
ideal	kb. idaman, teladan, cita-cita, ideal. -ks. 1 baik, bagus sekali. 2 ideal. -ideally kk. menurut yang dicita-citakan, dalam teori.
idealism	kb. idealisme.
idealist	kb. seorang idealis.
idealize	kkt. mengidealkan.
identical	ks. sama, serupa. i. dresses pakaian yang sama. i. twins anak kembar satu telur.
identification	kb. pengenalan. i. card tanda-sah-diri, kartu pengenal. i. tag 1 kartu pengenal. 2 pening anjing.
identified	lih identify.
identifies	lih identify.
identify	kkt. (identified) mengenal(i) memperkenalkan. -kki. to i. with a party memihak kepada suatu partai.
identity	kb. (j. -ties) identitas, ciri-ciri, tanda-tanda (khas). i. card kartu pengenal, surat keterangan diri.
ideogram	= ideograph.
ideograph	kb. tulisan/huruf gambar.
ideological	ks. ideologis. i. struggle perjuangan ideologi.
ideology	kb. (j. -gies) ideologi, adicita.
idiocy	idiocy
idiolect	kb. gaya bahasa seseorang
idiom	kb. 1ling.: langgam suara. 2 corak khas.
idiomatic	ks. yang berhubungan dengan ungkapan. i. usage penggunaan ungkapan.
idiosyncrasy	kb. (j. -sies) keistimewaan,keanehan
idiot	kb. orang bodoh/tolol/dungu. he would be i. to go there dia bodoh benar, kalau pergi kesana.
idiotic	ks. dungu,bodoh, tolol. he does such i. things dia berbuat hal-hal yang gila.
idle	ks. bermalas-malas. 2 tidak jalan.3 (me)nganggur. to stand i. 1 berpangku-tangan, bertopang dagu (of a person). 2 menganggur. -kki. hidup, jalan.
idleness	kb. 1 kemalasan. 2 hal tak berbuat apa-apa.
idler	kb. pemalas, orang yang suka luntang-lantung.
idol	kb. berhala. matinee i. bintang pilem pujaan.
idolatrous	ks. musyrik.
idolatry	kb. (j. -ries) pemujaan terhadap berhala, kemusyrikan, pemberhalaan.
idolize	kkt. memberhalakan, memuja. she idolizes her husband ia memuja suaminya.
idyl(l)	kb. syair/prosa yang menggambarkan keindahan alam.
idyllic	ks. idilis.
ie, i.e.	[indo-european] indo-eropah.
if	kb. let's have no "ifs" jangan selalu mengatakan kalau-kalau. -ksam. 1 jika, kalau, jikalau. 2 apakah, kalau. if only kalau, sekiranya, semoga. as if seolah-olah, seakan-akan.
igloo	kb. rumah salju bangsa eskimo.
igneous	igneous
ignite	kkt. 1 menyalakan (s fire). 2 membakar (zeal, spirit). -kki. terbakar, kena api, menjadi panas dan menyala. the paper ignited kertas itu menjadi panas dan menyala.
ignition	kb. 1 pengapian, penyalaan, pembakaran. 2 kontak, starter. turn on the i. putarlah kunci kontak. hidupkan mesin.
ignoble	ks. hina, dina, tercela, rendah.
ignominious	ks. tercela, jahat, memalukan.
ignoramus	kb. orang bodoh/bebal/tolol.
ignorance	kb. 1 ketidaktahuan. to plead i. of the law memberi alasan karena tidak tahu akan undang-undang. 2 kebodohan, kedunguan.
ignorant	ks. bodoh, dungu, bebal. to be i. of the possibilities tidak mengetahui kemungkinan-kemungkinan.
ignore	kkt. 1 mengabaikan, tak mengindahkan, tidak mengambil perduli. to i. an order mengabaikan perindah. 2 menganggap (seseorang) tidak ada, mengesampingkan, menganggap sepi. she ignoresme ia mengganggap saya tak ada.
iguana	kb. sejenis biawak.
ikon	= icon.
ileum	kb. bagian usus yang paling bawah.
iliac	kb. lih sacroiliac.
ilium	kb. tulang pangkal paha.
ilk	kb. jenis, macam. i don't like people of his i. saya tidak menyukai orang semacam dia.
ill	kb. penyakit. -ks. 1 sakit, tidak enak badan, kurang sehat. 2 buruk. -kk. to speak i. of s.o. menjelekkan seseorang. ill-advised ks, keliru. ill-(as) sorted ks. tidak sebanding, tidak cocok.
ill.	[illustration(s) ] gambar, ilustrasi.
illegal	ks. yang merupakan pelanggaran. 2 gelap, tak sah. i entry masuk secara illegal (trade, arms). 3 liar (occupation).
illegality	kb. (j. -ties) ketidaksahan.
illegible	ks. tidak terbaca.
illegitimacy	kb. (j. -cies) sifat melanggar hukum / undang-undang, sifat tidak sah / sejati, kepalsuan, kelancungan.
illegitimate	ks. haram. i child anak haram/zina.
illicit	ks. gelap, haram. i. trade in narcotics perdagangan gelap dalam narkotika.
illiteracy	kb. (j. -cies) kebutahurufan.
illiterate	illiterate
illness	kb. sakitnya, keadaan sakit.
illogical	ks. tidak logis, tidak masuk akal.
illuminate	kkt. 1 menerangi, menyinari (a building). 2 menjelaskan (a subject). -illuminated ks.1 yang dihiasi. i. manuscript naskah bergambar. 2 diterangi, dihiasi dengan lampu-lampu. -illuminating ks. yang memperjelas, yang memberi.
illumination	kb. 1 penerangan. 2 (hiasan) cahaya.
illumine	kkt. menerangi. electric lights i. homes lampu-lampu listrik menerangi rumah -rumah.
illus.	[illustration(s) ] ilustrasi, gambar.
illusion	kb. khayal(an), maya, optical i. pandangan/penglihatan yang menyesatkan, pandangan khayalan.
illusive	ks. pura-pura, dibuat-buat, yang menyesatkan.
illusory	ks. = illusive.
illustrate	kkt. 1 menghiasi ( a book). 2 menjelaskan, memberikan penjelasan. -illustrated ks. yang disertai gambar-gambar, bergambar.
illustration	kb. 1 ilustrasi, gambar. 2 penjelasan, uraian.
illustrative	ks. yang membantu menjelaskan.
illustrator	kb,. juru gambar, pelukis.
illustrious	ks. termasyhur, amat terkenal.
ilo	[international labor organization] organisasi buruh international.
image	kb. gambar. 2 patung. 3 kesan, bayang-bayang. to project a favorable i. abroad menimbulkan kesan yang baik diluar negri. 4 tamsilan, pelukisan (in poetry)
imagery	kb. (j. -ries) tamsil, perumpamaan, perbandingan.
imaginable	ks. 1 yang dapat dipikirkan. to try every i. way mencoba dengan segala jalan yang dapat dipikirkan. 2 yang ada. to collect every stamp i. mengumpulkan setiap perangko yang ada.
imaginary	ks. khayal. 2 imajiner. i. number bilangan imajiner.
imagination	kb. daya khayal, imajinasi. his i. gets the best of him khayalannya menguasai dirinya.
imaginative	ks. imaginatif, penuh daya khayal. i. literature bacaan khayalan.
imagine	kkt. membayangkan, menghayalkan. to i. life without a car membayangkan cara hidup tanpa mobil. 2 kira. i i. he will come kukira dia akan datang.
imbalance	kb. ketidakseimbangan.
imbecile	kb. orang pandir/sinting.
imbecilic	ks. dungu.
imbecility	kb. (j. -ties) kb. kedunguan, kesintingan (otak).
imbibe	kkt. meminum.
imbroglio	kb. keruwetan, keadaan yang ruwet, huru-hara.
imbue	kkt. mengilhami, mengaruniai. may he be imbued with special qualities ! semoga dia dikaruniai sifat-sifat yang istimewa. !
imf	[international monetary found] dana keuangan internasional.
imitate	kkt. meniru, menyama-nyama, mencontoh, menuruti.
imitation	kb. 1 peniruan. i. is important in language learning peniruan penting dalam mempelajari bahasa. 2 tiruan, imitasi. a good i. tiruan yang baik.
imitative	ks. suka meniru, merupakan tiruan.
imitator	kb. peniru.
immaculate	ks. amat bersih, tidak bernoda, rapi sekali. immaculately kk. rapi/apik sekali. i. dressed berpakaian rapi sekali.
immanent	ks. tetap ada.
immaterial	ks. tidak penting/peduli. it's i. to me whether you go or stay saya tidak perduli apakah kau pergi atau tinggal.
immature	ks.belum matang/dewasa, masih hijau. he's still i. dia masih hijau. that project is i. proyek itu belum lengkap.
immaturity	kb. ketidakmatangan, ketidak dewasaan.
immeasurable	ks. yang tak terbatas/terkira-kira /terhingga. -immeasurably kk. yang tak terkira-kira.
immediacy	kb. (j. -cies) kesiapan, kesegaraan.
immediate	ks. 1 dengan segera. 2 dekat. -immediately kk. dengan segera, sekarang juga, dengan tidak melewatkan waktu, dengan serta merta. i. ofter segera sesudah.
immemorial	ks. sudah lama sekali. from time i. dari zaman dahulu.
immense	ks. 1 besar sekali. this city has on i. population bukan main banyaknya penduduk kota ini. 2 luas sekali. the problems here are i. persoalan - persoalan disini luas sekali. -immensely kk. sangat, amat. to enjoy o.s. i. merasa bukan main senangnya.
immensity	kb. (j. -ties) luasnya, keluasan
immerse	kkt. membenamkan, mencelupkan. he's immersed in his work dia terbenam dalam pekerjaannya.
immersion	kb. pencelupan.
immigrant	kb. imigran, pendatang.
immigrate	kkt. datang, pindah dari. he immigrated from..... dia pendatang dari....
immigration	kb. imigrasi.
imminence	kb. yang akan terjadi segera, kesegeraan
imminent	ks. dekat, sebentar lagi. i. deporture keberangkatan yang sudah dekat.
immobile	ks. tak bergerak/berobah-obah.
immobility	kb. keadaan/sifat tak bergerak.
immobilize	kkt. melumpuhkan, menghentikan. bad weather immobilized air traffic keadaan udara yuang buruk melumpuhkan lalu lintas udara.
immoderate	ks. 1 luar biasa, tidak wajar. i. eater tukang makan yang luar biasa. 2 melewati batas. i. speed kecepatan yang melampaui batas.
immodest	ks. tidak sopan, tak tahu adat.
immodesty	kb. ketidaksopanan.
immolate	kkt. mengorbankan, mengadakan upacara pengorbanan.
immolation	kb. pengorbanan, persembahan korban.
immoral	ks. tidak sopan, tunasusila, jahat, asusila. i. conduct tingkah laku (yang) asusila, tindakan/perlakuan tak bermoral.
immorality	kb. (j. -ties) tunasusila. ketidaksopanan, pelanggaran susila.
immortal	ks. abadi. no man is i. tak ada manusia yang akan hidup selama-lamanya.
immortality	kb. keabadian, kehidupan yang kekal, kekekalan
immortalize	kkt. mengabadikan.
immovable	ks. yang tak dapat digerakkan, tak bergerak.
immune	ks. kebal, imun i. to smallpox kebal terhadap cacar. 2 bebas. i. to criticsm bebas dari kecaman-kecaman.
immunity	kb. (j. -ties) kekebalan, kebebasan. diplomatic i. kekebalan diplomatik. i. to a disease kekebalan terhadap suatu penyakit.
immunization	kb. pengebalan.
immunize	kkt. mengebalkan.
immutable	ks. tetap, yang kekal/abadi.
imp	kb. 1 setan. 2 anak nakal.
imp.	1 [imperative] bentuk-perintah. 2 [imperfect] imperfek. 3 [import(er) ] importir.
impact	kb. 1 tubrukan. 2 pengaruh yang kuat.
impacted	ks. yang terjepit. i. wisdom tooth geraham bungsu yang terjepit.
impair	kkt. 1 merusak (o's health). 2 menghalangi, mengganggu, mengurangi (o's vision).
impairment	kb. perusakan, pemburukan, pelemahan.
impale	kkt. 1 menyulakan (on a spit, stake). 2 menembak (with spear). 3 memandang dengan tajam.
impalpable	ks. 1 tak terasa. 2 tak mudah dipahamkan.
impart	kkt. memberi, menanamkan (knowledge, a certain air).
impartiality	kb. sifat tidak memihak, sikap/sifat jujur, sifat/sikap adil, kejujuran, keadilan, sifat/sikap netral.
impassable	ks. tidak dapat dilalui.
impasse	kb. jalan buntu, kebuntuan.
impassioned	ks. yang bersemangat/ berapi-api. i. speech pidato yang bersemangat.
impassive	ks. tenang, tanpa perasaan. his i. face mukanya yg tenang itu.
impatience	kb. ketidaksabaran.
impatient	ks. tdk sabar.
impeach	kkt. menuduh, mendakwa.2 mencurigai.3 memanggil utk memberi pertanggungjawaban.
impeachment	kb. pendakwaan, tuduhan.2 panggilan utk pertanggungjawaban.
impeccable	ks. tdk tercela, tertib, tanpa cela.-impeccable kk. tanpa cela (dressed).
impecunious	ks. miskin, melarat.
impede	kkt. menghalangi, merintangi, mengganggu (negotiation, travel).
impediment	kb. kesukaran, rintangan, halangan. he has a speech i. dia sukar berbicara.
impel	kkt. (impelled) 1 memaksa.2 mendorong.3 mendorong, mendesak.
impending	ks. yg akan datang, yg mendatang.
impenetrable	ks. yg tidak dpt dimasuki/dilalui.
imperative	kb. gram. : bentuk perintah. ks. penting sekali, tdk boleh tdk.
imperceptible	ks. tdk kelihatan/ terasa.
imperfect	ks. tdk sempurna.2 gram. : imperfek
imperfection	kb. ketidaksempurnaan, cacat.
imperial	ks. dari atau berh. dgn kekaisaran atau kerajaan.
imperialism	kb. imperialisme.
imperialist	kb. imperialis.
imperialistic	ks. imperialistis.
imperil	kkt. membahayakan.
imperious	ks sombong, angkuh, bersifat mutlak.
imperishable	ks. kekal, abadi, tak terhancurkan.
impermanent	ks. sementara, tidak tetap/permanen.
impermeable	ks. tidak dapat ditembus, kedap, tertutup rapat-rapat.
impersonal	ks. tidak mengenai orang tertentu.
impersonate	kkt. menirukan, berkedok sebagai. to i. a police officer berkedok sebagai seorang perwira polisi.
impersonation	kb. peniruan, perbuatan meniru.
impersonator	kb. peniru.
impertinence	kb. kekurangajaran, ketidaksopanan.
impertinent	ks. 1 kurang ajar/sopan, tidak sopan. 2 tak ada hubungannya, tidak mengenai pokok persoalannya, diluar pokok persoalan/ pembicaraan, menyimpang (dari pokok pembicaraan).
imperturbable	ks. tenang sekali, tidak dapat diganggau.
impervious	ks. 1 tahan/kedap air, tidak dapat ditembus air. 2 tidak mempan, tahan. i. to critism tidak mempan kecaman.
impetigo	kb. penyakit kulit yang (gatal) menimbulkan bintul-bintul berisi nanah.
impetuous	ks. tidak sabar, bergerak dengan kekuatan dan kecepatan yang besar.
impetus	kb. daya pendorong, dorongan, keuletan.
impinge	kki. 1 mengenai, bergeseran dengan. this impinge on his field ini agak mengenai lapangannya. 2 menimpa, mengenai. the sun's rays impinged on our eyes sinar matahari itu menimpa mata kami.
impious	ks. tidak beriman/bertuhan.
impish	ks. nakal, tidak baik.
implacable	ks. bersikap kepala batu, gurat batu.
implant	kb. penanaman. -kkt. menanamkan.
implement	kb. alat, peralatan. -kkt. melaksanakan. to i. the new regulation melaksanakan peraturan baru itu.
implementation	kb. pelaksanaan, implementasi.
implicate	kkt. melibatkan, menyangkutkan. he was implicated in the crime dia terlibat dalam (perkara) kejahatan itu.
implication	kb. 1 maksud, pengertian. by i. sudah tersimpul didalamnya secara tersimpul. 2 implikasi, terlibatnya (in a plat).
implicit	ks. selengkapnya, yang harus dipatuhi. i. instructions intruksi- intruksi selengkapnya. -implicitly kk. secara mutlak.
implies	lih. imply.
implore	kkt. 1 memohon dgn sangat kpd.2 memohonkan dgn sangat.-imploring ks. yg bersifat memohon.
imply	kkt. (implied) menyatakan secara tdk langsung.-implied ks. termasuk, penuh.i. trust kepercayaan penuh.
impolite	ks. tdk sopan, kasar.
impoliteness	kb. ketidaksopanan.
imponderable	kb. the imponderables j. faktor-faktor yg tdk dpt diperhitungkan.-ks.yg tak dpt diperhitungkan.
import	kb.; im'powrt kkt./ kb. 1 impor. i. trade perdagangan impor.2 maksud, makna, arti.3 kepentingan.-imports j. barang-barang impor.-kkt. mengimpor, mendatangkan barang-barang dari luar negeri. imported goods barang-barang impor/ yg diimpor.
importance	kb. pentingnya, kepentingan.
important	ks. penting. i. reason alasan penting. he looks i. lagaknya/tingkah lakunya spt orang yg berkuasa/ berkedudukan penting.
importation	kb. 1 pemasukan.2 barang impor.
importer	kb. pengimpor, importir.
importune	kkt.1 meminta dgn sangat.2 mendesak.
impose	kkt.1 menjatuhkan.2 mengadakan (sanction).3 menentukan (condition).4 membebankan.5 memaksakan.-kki. mengganggu.-imposing ks. yg mengesankan/mengagumkan.
imposition	kb.1 pembebanan 2 kerugian, pengenaan, gangguan.
impossibility	kb. (j.-ties) ketidakmungkinan, kemustahilan.
impossible	kb. the i. hal yg mustahil.-ks. tdk mungkin, mustahil
impostor	kb. penyemu, penipu yg lihay.
impotence	kb.1 ketidakmampuan.2 kelemahan syahwat. sifat impoten.
impotent	ks.1 tdk bertenaga, tunadaya.2 (sexually) lemah syahwat, impoten.
