stubble	kb. 1 tunggul (jeram). 2 pangkal janggut (on o's chin).
stubborn	ks. 1 keras kepala, bandel. s. as a mule keras kepala seperti kemar. 2 susah dihilangkan (of a stain). 3 susah sembuh (of a cough).
stubbornness	kb. sikap keras kepala. s. of a stain cedera yang sukar hilang. s. of a cold pilek yang sukar sembuh.
stubby	ks. pendek dan gemuk/tegap.
stucco	kb. plester semen, plesteran. -kkt. memplesteri, melapisi (dengan semen).
stuck	lih stick.
stud	kb. 1 kuda pembiak/pacek, bapak kuda. 2 cloth.: kancing. 3 corp.: papan, tiang. -kkt. (studded) 1 menabur. 2 menatah. -studding ks. tunggak, tiang.
student	kb. 1 male) mahasiswa (at a college or university). 2 (female) mahasiswi. 3 pelajar (secondary school). 4 penyelidik (of human nature).
studied	lih study.
studies	lih study.
studio	kb. 1 studio. 2 studio, sanggar.
studious	ks. rajin belajar. to make a s. efferot to help others bersungguh-sungguh untuk menolong orang lain. -studiously kk. sangat berhati-hati.
studiousness	kb. kerajinan, kesungguhan hati.
study	kb. (j. -dies) 1 pelajaran. 2 mata pelajaran (in school). 3 penyelidikan. 4 bahan pelajaran. 5 lokakarya, kamar kerja. -kkt. 1 mempelajari (a map, customs). 2 belajar. 3 memikirkan (ways to do s.t.). 4 mernghapalkan (a part in a play). -kki. belajar.
stuff	kb. 1 bahan. 2 barang. 3 kesanggupan. -kkt. 1 mengisi (a turkey). 2 memasukkan (hands in the pocket, tobacco into a pipe). 3 menyumbat. 4 memasukkan, menyumpalkan. -stuffed ks. yang diisi. -stuffing ks. isian, pengisi.
stuffiness	kb. kekakuan (of a person). 2 kesesakan (of a room).
stuffy	ks. 1 kaku (of a person). 2 sesak (of a room). my head feels s. kepala saya rasanya tersumbat.
stultified	lih stultify.
stultify	kkt. melemahkan, mematikan semangat. stultifying atmosphere suasana yang melemahkan semangat.
stumble	kki. tersandung. be careful, don't s. hati-hati, jangan tersandung. stumbling block batu penarung, penghalang.
stumblebum	kb. sl.: orang yang janggal.
stump	kb. 1 tunggul (of a tree). 2 puntung (of arm, leg, tail). 3 ujung/puntung (of candle). 4 puntung/ujung (of pencil). -kkt. 1 membingungkan (s.o.). 2 membungkamkan (the experts). 3 kesandung (o's toes).
stumper	kb. inf.: pertanyaan yang sukar untuk dijawab.
stun	kkt. (stunned) 1 membisingkan. 2 menyebabkan kelenger/pingsan (from a blow). -stunning ks. 1 yang menarik perhatian, mempesonakan (outfit). 2 yang menulikan, membuat tuli (blow).
stung	lih sting.
stunk	lih stink.
stunner	kb. 1 inf.: seorang wanita yang menarik perhatian. 2 hal yang sungguh-sungguh mengejutkan.
stunt	kb. pertunjukan ketangkasan, akrobatik (at a circus, an motorcycles). -kkt. menghalangi,. memperlambat (o's growth). -stunted ks. terbantut (tree). 2 kerdil (person). 3 terhalang/terbantut/terintang (growth).
stuntman	kb. (j. -men) akrobat.
stupefaction	kb. 1 kelumpuhan, ketakutan. 2 keadaan kelenger.
stupefied	lih stupefy.
stupefy	kkt. (stupefied) 1 membuat seperti kena bius. 2 mengherankan. i am completely stupefied by what has happened saya sama sekali terpesona oleh apa yang terjadi.
stupendous	ks. 1 raksasa, mengagumkan. 2 menakjubkan.
stupid	ks. bodoh, dungu, tolol. don't be s. ! jangan bodoh (begitu) ! how s. of me ! alangkah tololnya saya ini ! -stupidly kk. (secara) tolol, berbuat bodoh. i s. left the key in the door saya berlaku bodoh meninggalkan kunci di pintu.
stupidity	kb. (j. ties) ketololan, kebodohan, kedunguan.
stupor	kb. keadaan kelenger/pingsan.
sturdiness	kb. ketegapan, kekokohan.
sturdy	ks. 1 kokoh, kuat (of a chair). 2 tegap, begap, kekar (of a person). -sturdily kk. 1 kokoh, kuat. 2 tegap (of a person).
sturgeon	kb. semacam ikan yang menghasilkan telur ikan.
stutter	kb. berbicara menggagap. -kki. menggagap, berbicara dengan gagap.
stutterer	kb. penggagap.
sty	kb. 1 tembel (in eye). 2 (pig) kandang babi.
style	kb. 1 corak mode. 2 gaya bahasa. 3 gaya. -kkt. to s. o.s. menyebut diri.
stylebook	kb. buku pedoman mengenai tanda baca dsb.
stylewise	ks. mahir dalam soal gaya. -kk. menurut mode.
styling	kb. potongan corak (of a car, suit).
stylish	ks. bergaya, luwes. -stylishly kk. penuh gaya. to dress s. berpakaian/berdandan dengan gaya.
stylishness	kb. keadaan bergaya.
stylist	kb. pengarang yang bagus gaya bahasanya.
stylistic	stylistics kb. ilmu gaya bahasa. -ks. yang mengenai gaya bahasa.
stylize	kkt., kki. menyesuaikan dengan mode.
stylus	kb. 1 jarum/pena untuk menulis diatas stensil. 2 (phonograph) jarum piringan hitam.
stymie	kkt. menghalang. we are stymied until.... kita terhalang sampai.....
styptic	kb. obat penahan darah. s. pencil sebatang kecil tawas.
su.	(sunday) hari minggu.
suave	ks. halus, lembut, sopan, ramah.
suavity	kb. (j. -ties) kehalusan, kelembutan, kesopanan, keramahan.
sub	kb. 1 kapal selam. 2 sport : pemain cadangan. -kki. (subbed) to s. for mengganti(kan).
sub.	1 [subject] subyek, pokok. 2 [substitute] pengganti. 3 [suburb] kota satelit, pinggiran kota. 4 [subscription] langganan.
subcommittee	kb. subpanitia, panitia seksi/kecil.
subconscious	kb. bawah-sadar, lubuk hati, hati kecil. -ks. mengenai bawah-sadar. his s. mind told him that... isi lubuk hatinya menyatakan kepadanya bahwa......
subconsciousness	kb. 1 lubuk hati. 2 pikiran bawah-sadar.
subcontinent	kb. anak/bagian benua.
subcontract	kb. kontrak tambahan. -kkt., kki. menyuruhkan pekerjaan yang ditugaskan/ dikontrakkan kepada orang lain.
subcontractor	kb. pemborong bawahan/eceran.
subculture	kb. cabang kebudayaan, kebudayaan cabang.
subdistrict	kb. kecamatan, wilayah.
subdivide	kkt. membagi lagi.
subdivision	kb. bagian, cabang.
subdue	kkt. 1 menundukkan, menaklikkan (rioters). 2 mengurangi. 3 mengatasi, menahan (o's fears). -subdued ks. 1 lunak, lemah (lights). 2 lembut (voice).
subfreezing	ks. dibawah titik beku (weather).
subgroup	kb. bagian/cabang jenis.
subhead(ing)	kb. anak judul.
subject	kb. 1 pokok, persoalan (for discussion). 2 gram.: pokok kalimat. 3 mata pelajaran (of intruction). 4 mata kuliah (of study). 5 warganegara.
subjective	ks. subyektip, berdasar pokok. -subjectively kk. secara subyektip
subjectivity	kb. kesubyektipan, subyektivitas.
subjugate	kkt. menaklukkan, menunjukkan.
subjugation	kb. penaklukan, penundukan.
subjugator	kb. penakluk, penunduk, penindas.
subjunctive	kb. gram.: bentuk pengandaian.
sublease	kkt. menyewakan lagi.
sublet	kkt. menyewakan lagi. to s. a contract to another firm memberikan lagi sebuah kontrak pada perusahaan lain.
sublimate	kkt. menghaluskan.
sublime	kb. yang mahamulia, luhur. from the s. to the ridiculous dari yang mahamulia sampai ke yang rendah. -ks. agung, indah. -sublimely kk. samasekali.
sublimity	kb. (j. -ties) keagungan, keindahan.
submachine	s. gun mitralyur ringan.
submarine	kb. kapal selam. s. chaser pemburu kapal selam. -ks. yang berhubungan dengan dasar laut. s. geology geology dasar laut.
submerge	kkt. menyelam kedalam air, merendamkan. -kki. menyelam (of a submarine). -submerged ks. dibawah permukaan air. s. rock batu karang dibawah permukaan air.
submersion	kb. 1 penyelaman (of sub, diver). 2 perendaman (of s.t.).
submission	kb. 1 ketundukan. to starve s.o. into s. membiarkan orang lapar supaya tunduk. 2 kepatuhan.
submissive	ks. bersikap tunduk, berkhidmat, bersikap patuh (to terhadap).
submit	kkt. (submitted) 1 mengajukan (a request, petition) (to kepada). 2 menyampaikan, menyerahkan (s.t.) -kki. tunduk, menyerah. to s. to punishment menerima/tunduk kepada hukuman.
subnormal	ks. dibawah normal.
subordinate	kb. seorang bawahan. -ks. gram.: berpangkat lebih rendah. -kkt. mengebawahkan, menempatkan lebih rendah, mengemudiankan, menangguhkan.
subpoena	kb. panggilan tertulis untuk menghadap sidang pengadilan. -kkt. memberi panggilan untuk menghadap sidang pengadilan.
subscribe	kkt. berjanji akan membayar. -kki. to s. to 1 berlangganan, berabonemen (a magazine). 2 menyumbang kepada (a fund). 3 menganut (an idea).
subscriber	kb. langganan.
subscript	kb. tulisan dibawah garis.
subscription	kb. 1 abonemen, langganan. s. ticket karcis langganan. 2 tandatangan. 3 sumbangan.
subsequent	ks. yang berikut. s. programs acara-acara berikutnya. s. to karena, akibat. -subsequently kk. kemudian, sesudah itu.
subservience	kb. 1 sikap tunduk/takluk. 2 sikap mengundi.
subservient	ks. bersikap tunduk/patuh (to kepada).
subside	kki. 1 surut (of flood waters). 2 turun 9of fever). 3 reda. 4 terduduk, terhenyak. to s. on to a sofa terduduk diatas dipan.
subsidiary	kb. (j. -ries) cabang, tambahan. -ks. tambahan. s. activity kegiatan tambahan.
subsidize	kkt. memberi subsidi/tunjangan.
subsidy	kb. (j. -dies) subsidi, tunjangan.
subsist	kki. hidup, mendapatkan nafkah (on dari).
subsistence	kb. nafkah hidup/penghidupan. bare s. wage upah sekedar untuk penyambung hidup. s. farming pertanian untuk penyambung hidup.
subsoil	kb. lapisan tanah sebelah bawah.
subsonic	ks. dibawah kecepatan suara.
subspecies	kb. bagian jenis.
substance	kb. 1 zat. chemical s. zat kimia. 2 isi pokok (of a paper). 3 hakekat. 4 bahan.
substandard	ks. tidak memenuhi syarat, bermutu dibawah standar/baku.
substantial	ks. 1 kokoh, kuat building). 2 besar (contribution, gun). 3 banyak (meal). 4 besar (difference). 5 penting (reasons). -substantially kk. 1 pada pokoknya. 2 banyak sekali.
substantiate	kkt. 1 memperkuat, menyokong. 2 membenarkan.
substantive	kb. gram.: katabenda. -ks. substantip, riil, yang sesungguhnya (issue). -substantively sebenarnya, sebetulnya, dalam kenyataannya.
substation	kb. cabang, post office s. kantor pos tambahan.
substitute	kb. 1 pengganti. 2 sport.: pemain cadangan. 3 tiruan. -kkt. mengganti. -kki. menggantikan guru, menjadi guru pengganti.
substitution	kb. penggantian (for dengan).
substratum	kb. (j. -rata) 1 lapisan bawah (of rock). 2 dasar (of truth).
subsume	kkt. menggolongkan, memasukkan. what is subsumed under the term "politics" ? apakah yang termasuk dalam pengertian "politik ?
subsurface	ks. dibawah permukaan tanah (water).
subteen	kb. anak dibawah umur, anak yang hampir berumur tigabelas tahun.
subterfuge	kb. dalih, alasan, akal. to resort to s. memakai dalih.
subterranean	ks. dibawah tanah.
subtitle	kb. 1 judul tambahan, anak judul. 2 film.: teks bawah pada film.
subtle	ks. 1 halus (tone). s. perfume minyak wangi yang lemah baunya. 2 tak kentara (poison). 3 hampir tidak kentara (smile). 4 licin, licik (endeavor). 5 tajam (observer). 6 cerdik. 7 halus (distinction).
subtlety	kb. (j. -ties) 1 seluk-beluk, kepelikan (of a language). 2 kehalusan (of expression).
subtotal	kb. jumlah yang kurang sedikit dari jumlah seluruhnya.
subtract	kkt. mengurangi.
subtraction	kb. hal mengurangi, pengurangan.
subtropical	ks. subtropis.
suburb	kb. bagian inggir kota, kota satelit, daerah pinggiran kota. to live in the suburbs hidup di bagian pinggir kota.
suburban	ks. di pinggir(an) kota.
suburbanite	kb. orang yang hidup di pinggiran kota.
suburbia	kb. (daerah) pinggiran kota.
subvention	kb. subsidi, tunjangan.
subversion	kb. subversi.
subversive	kb. orang subversip. -ks. subversip, bawah tanah. s. activities kegiatan-kegiatan subversip, gerakan bawah tanah.
subvert	kkt. menumbangkan (pemerintah).
subway	kb. kereta-api dibawah tanah.
succeed	kkt. 1 menggantikan (s.o. as). 2 mengganti. days secceed night hari mengganti malam. succeedingks. berturut-turut.
success	kb. 1 sukses., keberhasilan.s. in life sukses dalam hidup. 2 hasil baik (in school). s. story 1 cerita yang berakhir baik. 2 cerita mengenai sukses.
successful	ks. 1 berhasil. s. career karir yang berhasil. 2 berhasil baik (of a harvest). 3 berbahagia (of a marriage). -successfully kk. dengan berhasil/sukses.
succession	kb. 1 rangkaian. 2 penggantian. 3 turutan. in s. 1 berturut-turut. 2 beriring-iringan (of cars lined up).
successive	ks. berturut-turut. for three s. days selama tiga hari berturut-turut. -successively kk. berturut-turut.
successor	kb. pengganti. to appoint a s. mengangkat pengganti.
succinct	ks. ringkas. s. and to the point ringkas dan tepat. -succinctly kk. dengan ringkas.
succinctness	kb. kesingkatan, kependekan, kekompakan, kecekatan.
succor	kb. bantuan, pertolongan. -kkt. menolong, memberi pertolongan.
succotash	kb. campuran jagung dan kacang.
succulence	kb. sifat berair, penuh air.
succulent	ks. lezat, berair banyak.
succumb	kki. 1 mengalah. to s. to temptation mengalah pada godaan. 2 mati. to s. to a heart attack mati karena serangan jantung.
such	ks. 1 seperti itu, serupa itu. 2 sungguh, begitu, betul-betul, amat, sekali. 3 sedemikian, yang demikian. -kg. 1 demikian. 2 begitu.
suck	kb. isap, teguk (of a soft drink, at a bottle). -kkt. 1 mengisap, menghirup (thumb, lollipop, water). 2 menetek (the breast). 3 menelan. -kki. to s. at mengisap (a pipe).
sucker	kb. 1 (alat) pengisap. 2 (candy) inf.: kembang gula yang keras. 3 sejenis ikan. 4 sl.: orang yang tolol, orang yang mudah kena tipu.
suckle	kkt. menyusui, meneteki.
suckling	kb. yang masih menyusu, muda sekali. s. pig babi yang masih menyusu.
suction	kb. 1 (peng) isapan. s. pump pengisap. 2 sedotan. to adhere to s.t. by s. melekat kepada sesuatu dengan sedotan. s. cup mangkok sedotan/penyedot.
sudden	ks. mendadak, tiba-tiba. his s. death dengan tiba-tiba. -suddenly kk. (dengan) tiba-tiba.
suddenness	kb. ketiba-tibaan, kesekonyong-konyongan.
suds	kb., j. 1 buih, busa. 2 buih, sabun.
sudsy	ks. berbuih, berbusa (of water, beer).
sue	kkt. menggugat, menuntut. to s. for divorce menuntut/minta cerai. -kki. 1 menuntut, menggugat. 2 memohonkan. to s. for peace memohonkan perdamaian.
suede	kb. kulit lemah/lunak. s. jacket jaket kulit.
suet	kb. gemuk. lemak 89yang terdapat di sekitar panggul dan buah punggung sapi dan domba).
suffer	kkt. 1 menderita (damage, harm, defeat). he does not s. fools gladly ia tidak sabar menderita perlakuan yang tolol. 2 mendapat (injury, harm). -kki. menderita. to s. from menderita karena. -suffering kb. (pen)deritaan.
sufferance	kb. kesabaran menderita.
sufferer	kb. penderita.
suffice	kkt. mencukupi. a modest income suffices him gaji yang kecil sudah mencukupi baginya. -kki. mencukupi, cukup. s. it to say that.... cukup dikatakan bahwa.....
sufficiency	kb. (j. -cies) kecukupan. a s. of supplies tersedia perbekalan yang cukup.
sufficient	ks. cukup. this is s. to.... ini cukup untuk..... -sufficiently kk. dengan cukup, secukupnya.
suffix	kb. akhiran.
suffocate	kkt. mencekek, menyebabkan mati lemas. -kki. mati lemas.
suffocation	kb. mati lemas, kekurangan napas.
suffrage	kb. hak pilih.
suffuse	kkt. meliputi, menutupi.
sugar	kb. 1 gula. 2 inf.: sayang, manis, manisku. 3 sl.: uang. -kki. memberi gula kepada/menggulai (teh s.s.o. o's coffee/tea).
sugary	ks. 1 berisi/mengandung gula. 2 manis-manis mulut (tak dapat dipercaya).
suggest	kkt. 1 memberi kesan. 2 menasehatkan.. 3 menganjurkan. 4 mengusulkan.
suggestion	kb. 1 saran, usul. 2 kesan yang tipis. 3 anjuran. 4 bisikan.
suggestive	ks. yang bersifat usul yang tak senonoh (remarks). 2 bernada. a lone s. of anger suara yang bernada marah.
suicidal	ks. mengenai bunuh diri. such a trip would be s. perjalanan seperti itu akan sama dengan bunuh diri. s. tendencies kecenderungan untuk bunuh diri.
suicide	kb. 1 bunuh diri. to commit s. (melakukan) bunuh diri. 2 orang yang bunuh diri.
suit	kb. 1 setelan. 2 law : gugatan. 3 (courting) rayuan, lamaran, peminangan. 4 bridge : warna/rupa kartu main. -suiting kb. bahan setelan.
suitability	kb. pantas-tidaknya, kecocokan, keserasian.
suitable	ks. 1 pantas. s. marriage perkawinan yang pantas. 2 cocok. s. house rumah yang cocok. 3 sesuai. a s. date tanggal yang sesuai. -suitably kk. yang sesuai, yang cocok. to be s. attired mengenakan pakaian yang pantas.
suitcase	kb. kopor.
suitor	kb. pelamar, peminang.
sulfa	kb. sulfa, (campuran) belerang. s. drug obat sulfa.
sulfide	kb. sulfida.
sulfur	kb. belerang.
sulfuric	s. acid asam belerang.
sulk	kki. merajuk, mendongkol, merongseng.
sulky	kb. (j. -kies) kereta berkuda dan beroda (balap). -ks. rongseng, sebal hati. to be/become s. merajuk, mendongkol, merongseng.
sullen	ks. merengut, rengus, rongseng, cemberut.
sully	kkt. (sullied) menodai (s.o's reputation).
sulphur	lih sulfur.
sultan	kb. sultan.
sultanate	kb. kesultanan.
sultriness	kb. kepanas-lembaban (of the weather).
sultry	ks. 1 panas dan pengap, panas dan lembah, gerah (of weather). 2 gatal rela., penuh berahi (of a woman).
sum	kb. 1 jumlah. 2 hitungan. in s. singkatnya, ringkasnya. -kkt. (summed) to s. up 1 menjumlahkan (the total). 2 menyimpulkan, meringkaskan (the main points)
sumatran	kb. orang sumatra, yang berasal dari sumatra.
summarize	kkt. meringkaskan.
summary	kb. (j. -ries) ringkasan, ikhtisar, rekapitulasi. -ks. 1 ringkas. 2 sumir. -summarily` kk. dengan cepat.
summation	kb. penyajian terakhir (of a legal case).
summer	kb. musim panas. in s. dalam musim panas. warm s. day hari musim panas yang panas. -kki. bermusim panas.
summertime	kb. musim panas.
summit	kb. puncak. s. conference konperensi tingkat tinggi.
summon	kkt. 1memanggil (s.o). 2 memerintahkan, memanggil. 3 mengumpulkan.
summons	kb. 1 panggilan. 2 surat perintah/panggilan, saman.
sump	kb. tempat air/oli/minyak berkumpul, bah. s. pump pompa bah.
sumptuous	ks. mewah.
sumptuousness	kb. kemewahan.
sun	kb. matahari. to fly with the s. terbang searah dengan jalannya matahari. -kkt. (sunned) to s. o.s berjemur diri. sun-baked ks. terjemur, kering karena sinar matahari. sun-drenched ks. disinari penuh dengan oleh matahari.
sun.	[sunday] hari minggu/ahad.
sunbathe	kki. berjemur diri, berpanas-panas.
sunbather	kb. orang yang mandi sinar matahari.
sunbeam	kb. sinar matahari.
sunburn	kb., kki. terbakar sinar matahari. i s. easily kulit saya mudah terbakar matahari. -sunburned, sunburnt ks. yang kena bakar sinar matahari.
sund.	[sunday] hari minggu/ahad.
sundae	kb. eskrim berisi setrup. chocolate s. eskrim ditutup coklat.
sundanese	kb. 1 orang sunda. 2 bahasa sunda. -ks. sunda.
sunday	kb. hari minggu/ahad.
sundeck	kb. nau.: geladak paling atas. 2 (geladak) tempat berjemur.
sunder	kkt. memisahkan.
sundial	kb. alat penunjuk waktu dengan bantuan bayangan sinar matahari.
sundown	kb. terbenamnya matahari.
sundry	kb. (j. -ries) serba-serbi. -ks. berbagai, bermacam. all and s. semuanya, semua orang.
sunflower	kb. bunga matahari.
sung	lih sing.
sunglasses	kb., j. kacamata hitam.
sunk	lih sink.
sunken	ks. 1 karam, tenggelam (of a ship). 2 tenggelam (of a rock, log). 3 cekung (of eyes). 4 terendam (of a garden).
sunlit	ks. yang disinari matahari (of a room).
sunniness	kb. keadaan terang, penuh sinar matahari.
sunny	ks. 1 cerah (of a day). 2 gembira, riang (disposition). 3 yang mendapat banyak cahaya matahari (of a room). sunny-side up ks. telor mata-sapi.
sunrise	kb. matahari terbit.
sunset	kb. matahari terbenam.
sunshade	kb. kere penghalang sinar matahari.
sunshine	kb. 1 sinar/cahaya matahari. in the bright s. dalam sinar matahari yang terang-benderang. 2 tempat yang kena panas matahari. 3 kegembiraan.
sunshiny	ks. cerah (day).
sunspot	kb. bintik pada matahari.
sunstroke	kb. kelengar (kena) matahari.
sunsuit	kb. pakaian bermain.
suntan	kb. warna coklat karena berjemur. s. lotion minyak gosok untuk berjemur diri.
sunup	kb. matahari terbit.
sup	kb. teguk. a s. of milk seteguk susu. -kki. (supped) makan malam.
sup.	1 [supreme] tetinggi. 2 [superior] unggul, atasan.
super	ks. inf.: hebat, luarbiasa baiknya. super-duper ks. sl.: 1 enak sekali. 2 hebat.
superabundance	kb. keadaan berlimpah-limpah.
superabundant	ks. berlimpah-limpah, sangat berlebih-lebihan.
superannuated	ks. purnawirawan, pensiun, wredatama.
superannuation	kb. pensiun. s. fund dana pensiun.
superb	ks. hebat. -superbly kk. bagus, gagah, agung.
supercharged	ks. diperlengkapi dengan alat penambah tenaga.
supercharger	kb. pompa konpresor.
supercilious	ks. congkak, sombong.
superciliousness	kb. keangkuhan.
superficial	ks. 1 dangkal, cerek, tohor (burn, knowledge). 2 luaran, tidak benar-benar. s. measurement ukuran pada permukaan, ukuran luaran.
superficiality	kb. (j. -ties) kedangkalan.
superfluity	kb. (j. -ties) jumlah yang berlebih-lebihan. s. of knowledge pengetahuan yang berlebih-lebihan.
superfluous	ks. 1 berlebih-lebihan (space). 2 yang tak berguna (of arguments).
superhighway	kb. jalan raya untuk lalu-lintas cepat, jalan megah.
superhuman	ks. melebihi yang dimiliki manusia, luar biasa.
superimpose	kkt. melapiskan keatas. to s. thin paper over a map melapiskan kertas tipis keatas peta.
superintend	kkt. mengatasi, menjadi pengawas pada.
superintendent	kb. 1 pengawas, pemimpin. 2 inspektur. s. of police inspektur polisi.
superior	kb. rel.: (orang) atasan, pemimpin, kepala biara. -ks. 1 ulung, unggul, tinggi (person, quality, instrument). 2 sombong, tinggi hati (of attitude). 3 lebih besar. 4 mulia.
superiority	kb. (j. -ties) keunggulan, keulungan. s. in men material kelebihan orang dan alat. s. complex rasa unggul diri.
superlative	kb. gram.: bentuk superlatif. to talk in superlatives bicara berlebih-lebihan. -ks. terbaik, unggul sekali. s. voice suara yang sangat baik.
superman	kb. (j. -men) manusia unggul.
supermarket	kb. toko pangan serba-ada, maha-pasar.
supernatural	kb. the s. hal-hal yang gaib. -ks. gaib.
supernumerary	kb. (j. -ries) 1 seorang yang dijadikan cadangan. 2 seorang pemain figuran/ekstra.
superscript	kb. huruf atau angka yang ditulis di atas.
supersecret	ks. sangat/amat rahasia.
supersede	kkt. menggantikan.
supersonic	ks. supersonik.
superstition	kb. takhyul, ketakhyulan.
superstitious	ks. bertakhyul.
superstructure	kb. bangunan bagian atas.
supervise	kkt. mengawasi.
supervision	kb. pengawasan. to keep s.o. under strict s. mengawasi seseorang dengan keras.
supervisor	kb. 1pengawas. 2 pengamat. school s. guru pengamat.
supervisory	ks. dalam kedudukan sebagai pengawas. to be employed iin a s. capacity bekerja dalam kedudukan sebagai pengawas.
supine	ks. telentang. in a s. position dalam keadaan telentang.
suplicant	kb. pemohon.
supper	kb. makan malam.
suppertime	kb. waktu makan malam.
suppl.	[supplement] lampiran, tambahan, suplemen.
supplant	kkt. menggantikan.
supple	ks. 1 gemulai, lemas (of a body). 2 supel, fleksibel, luwes (of mind).
supplement	kb. lampiran, tambahan, suplemen. -kkt. menambah (o's income).
supplemental	ks. tambahan. s. budget anggaran tambahan.
supplementary	ks. tambahan. s. income penghasilan tambahan. s. angle sudut pelurus.
suppleness	kb. kelemah-lembutan.
suppletion	kb. gram.: pelengkap.
suppliant	kb. pemohon.
supplicate	kkt. memohonkan.
supplication	kb. permohonan.
supplied	lih supply.
supplier	kb. leveransir.
supplies	lih supply.
supply	kb. (j. -lies) 1 persediaan. 2 perbekalan. -kkt. (supplied) 1 menyediakan. 2 memenuhi. 3 memberikan, menyampaikan (information) (to kepada).
support	kb. 1 sokongan. 2 bantuan. 3 cagak, tiang. 4 sandaran. 5 bantalan/sandaran (for the back). 5 penyokong. -supporting ks. yang menyangga. s. wall dinding penyangga yang membantu.
supporter	kb. penyokong, pendukung.
suppose	kkt. 1 mengira. 2 andaikata, andaikan. 3 mengharuskan. -supposed ks. disangka benar. -supposedly kk. menurut dugaan . -supposing ksam. seandainya, sekiranya.
supposition	kb. 1 perkiraan, anggapan. basic s. anggapan pokok. 2 pengandaian.
suppository	kb. (j. -ries) suppositoria, obat rangsang (supaya buang air) yang dimasukkan kedalam dubur.
suppress	kkt. 1 menindas, menekan (an outbreak). 2 mendiamkan, menahan (the bad news). 3 membereder, memberangus (the news, press). 4 menyembunyikan (a smile, amusement). 5 memberangus (a newspaper). 6 mengganyang (racism). -suppressed ks. yang ditekan-tekan.
suppression	kb. penindasan, penindihan. s. of free speech penindasan kemerdekaan berbicara.
suppressive	ks. yang bersifat menindas. s. measures tindakan penindasan.
suppressor	kb. penindas.
suppurate	kki. bernanah.
supranational	ks. melampaui batas-batas negara.
supremacy	kb. supremasi, keunggulan.
supreme	ks. tertinggi. s. commander panglima tertinggi. -supremely kk. amat, sangat. s. happy bahagia sekali.
supt.	[superintendent] 1 pengawas. 2 inspektur, komisaris.
surcharge	kb. 1 biaya tambahan (for services). 2 tambahan ekstra (on a stamp). -kkt. menambah harga (a stamp).
sure	kb. for s. (dengan) pasti. -ks. 1 pasti. 2 yakin. 3 yang selalu mengenai (for aim). kk. 1 benar-benar, sungguh-sungguh. 2 tentu (saja). sure-footed ks. berkaki cekatan. -surely kk. tentu saja.
surename	kb. nama keluarga.
sureness	kb. ketentuan, kepastian.
surety	kb. (j. -ties) jaminan, penanggung.
surf	kb. ombak (besar) yang memecah. -kki. menaiki ombak dengan papan luncur. -surfing kb. olahraga menaiki ombak dengan papan luncur.
surface	kb. 1 permukaan (of the water). 2 luaran. -ks. dangkal (dari luar). -kkt. meratakan/melicinkan permukaan -kki. muncul dipermukaan.
surfboard	kb. papan luncur (di laut).
surfeit	kb. kekenyangan, kejenuhan, kejemuan. -kkt. to. s. s.o. with menyediakan pada seseorang (sehingga membosankan).
surge	kb. 1 gelombang, gelora (of a crowd of indignation). 2 sentakan. -kki. 1 melanda (of a wave). 2 menggelora. -surging ks. yang (bergerak) bergelombang.
surgeon	kb. ahli bedah. s. general kepala jawatan kesehatan.
surgery	kb. (j. -ries) 1 pembedahan. to undergo s. menjalani pembedahan. 2 med.: ilmu bedah. 3 operasi. oral s. operasi mulut.
surgical	ks. yang berkaitan dengan pembedahan. s. dressing pembalut/perban operasi.
surliness	kb. kebengisan, kemasaman.
surly	ks. merengut, memberengut, bermuka masam.
surmise	kb. dugaan, sangkaan. -kkt., kki. menduga, mengira.
surmount	kkt. 1 mengatasi (on obstacle). 2 berada diatas. mengatapi (the roof of a building). 3 melebihi.
surpass	kkt. melebihi, melampaui, mengungguli. to s. one expectations melebihi dari apa yang kita harapkan. -surpassing ks. jauh melebihi yang lain-lain.
surplice	kb. baju jubah.
surplus	kb. kelebihan. s. goods bahan-bahan kelebihan. s. crop of wheat panen gandum yang berlebihan.
surprise	kb. 1 keheranan. 2 sesuatu yang tak diberitahu kepada orang lain. -kkt. 1 mengagetkan, mengherankan. 2 menterkejutkan. -surprising ks. yang mengherankan. -surprisingly kk. (dengan) sangat mengherankan, heran benar.
surrealism	kb. surrealisme.
surrender	kb. penyerahan. -kkt. 1 menyerahkan (a town) (to kepada). 2 melepaskan. -kki. menyerah.
surreptitious	ks. dengan sembunyi-sembunyi, curi-curi. s. meetings pertemuan-pertemuan rahasia. -surreptitiously kk. dengan diam-diam/rahasia.
surrogate	kb. wakil, pengganti, wali.
surround	kkt. 1 mengepung (the enemy). 2 mengelilingi. 3 melingkungi. -surrounding ks. (yang ada) disekeliling. -surroundings kb., j. keadaan sekitar/sekeliling.
surtax	kb. pajak tambahan.
surveillance	kb. pengawasan, penjagaan, pengamat-amatan. to be under s. berada dibawah pengawasan.
survey	kb. 1 penelitian, peninjauan. 2 penyelidikan. 3 pemeriksaan. -kkt. 1 mengukur (land). 2 memeriksa, meninjau (the situation). 3 melihat, memandang. 4 melihat-lihat (a library collection). -surveying kb. pengukuran tanah.
surveyor	kb. pengukur (tanah), menteri ukur.
survival	kb. 1 kelangsungan hidup. 2 peninggalan (from an older period). 3 sisa (of a tradition).
survive	kkt. 1 menyelamatkan nyawa. 2 hidup lebih lama. -kki. hidup terus, bertahan (of a tree, custom). -surviving ks. masih hidup.
survivor	kb. orang yang selamat. there were no survivors tak ada yang selamat.
susceptibility	kb. (j. -ties) kelemahan, kerentanan (to terhadap).
susceptible	ks. 1 mudah kena. s. to flattery mudah kena bujukan. 2 rentan. he is s. to colds dia mudah sekali masuk angin.
suspect	kb. orang yang dicurigai, sitersangka. -ks. yang tersangka. -kkt. 1 mencurigai (s.o., a trick). 2 kira, duga.
suspend	kkt. 1 menggantungkan (a lamp from the ceiling). 2 menutup, memadakan (classes). 3 menunda, menangguhkan. 4 menghentikan (work). 5 menskors (from school). 6 menangguhkan (payment). 7 menyingkirkan (a constitution). 8 mencabut (a license).
suspender	kb. bretel, tali selempang.
suspense	kb. 1 ketegangan, perasaan tegang. to be in s. merasa tegang sekali. to keep s.o. in s. membimbangkan seseorang.
suspension	kb. 1 penyekorsan, pengskorsan (of a student, from office). 2 auto.: sistim penggantungan roda mobil.
suspicion	kb. 1 kecurigaan. his suspicions are well founded kecurigaannya beralasan benar. 2 syak (wasangka).
suspicious	ks. curiga, syak hati. he's s. of newcomers ia curiga terhadap orang baru. 2mencurigakan. s. action tindakan yang menimbulkan syak hati.
suspiciousness	kb. kecurigaan.
sustain	kkt. 1 menopang (a roof, wall). 2 menderita (a loss). 3 menyokong. 4 membenarkan. 5 menahan. 6 memungkinkan (life). 7 memperpanjang (a musical note). 8 meneruskan (tanpa henti-hentinya) (an attack). -sustained ks. 1 terus-menerus. 2 berlarut-larut.
sustenance	kb. makanan.
suture	kb. 1 jahitan pada luka, jahitan bedah. 2 benang bedah, benang penjahit operasi.
suzerainty	kb. (j. -ties) kekuasaan raja.
svelte	ks. langsing, ramping (figure).
sw	[southwest] barat-daya.
sw.	1 [swedish] dari swedia ; bahasa swedia. 2 [sweden] swedia.
swab	kb. 1 kain penyeka/pel. 2 alat pengepel. -kkt. (swabbed) 1 mengepel (a deck). 2 menyeka (a wound, a throat).
swaddle	kkt. membedung (a baby). swadling clothes kain-kain bedung.
swag	kb. inf.: barang rampasan/curian.
swagger	kb. cara berjalan dengan berlaga. to walk with a s. berjalan dengan langkah yang angkuh. -kki. berjalan dengan sikap yang angkuh.
swallow	kb. 1 teguk (of liquid). 2 burung layang-layang. -kkt. 1 menelan (food, drink). 2 mengenyampingkan (o's pride). 3 menerima.
swam	lih swim.
swamp	kb. rawa, paya. s. fever malaria. -kkt. 1 mengisi/menimpa hingga tenggelam (of a boat). 2 membanjiri.
swampland	kb. tanah paya/rawa, daerah rawa.
swampy	ks. berpaya-paya. s. area daerah yang berpaya-paya.
swan	kb. sejenis angsa. s. dive selam(an) angsa. swan's-down bulu halus angsa (untuk pakaian, dsb).
swank	ks. indah, megah (apartment).
swanky	ks. inf.: 1 megah (car, house). 2 bergaya.
swap	kb. inf.: tukar-menukar, barter. -kkt. (swapped) menukar.
swarm	kb. kawan. a s. of bees sekawanan lebah. -kki. berkerumun, mengerumuni.
swarthy	ks. hitam, kehitam-hitaman (complexion).
swashbuckler	kb. jagoan, pembual.
swat	kb. inf.: pukulan, tamparan. to give s.o. a s. on the head memukul kepala seseorang dengan cepat. -kkt. (swatted) memukul dengan keras (lalat, nyamuk).
swatch	kb. contoh, carikan (of cloth).
swath	kb. petak (of grass). to cut a wide s. membuat lubang cangkulan yang dalam.
swathe	kkt. menggosok, menyapu (with oil).
swatter	kb. inf.: pemukul. fly s. pemukul lalat.
sway	kb. 1 goyangan (of a bridge). 2 kekuasaan. 3 lenggang (of work). 4 goyangan (of a fast train). -kkt. 1 mengubah/menggoncangkan (pendirian). 2 mempengaruhi. 3 menggoyangkan.
sway-back(ed)	ks. berpunggung lengkung. -swaying kb. 1 ayunan (of trees). 2 goyangan (of leaves).
swear	kkt. (swore, sworn) mengucapkan sumpah, bersumpah. -kki. bersumpah. -sworn ks. bersumpah.
swearword	kb. kata kutukan.
sweat	kb. 1 peluh, keringat. 2 air yang melengket (on a glass of ice water). -kki. 1 berkeringat. 2 berair sebelah luar (of a pitcher of ice water).
sweatband	kb. pita penahan keringat.
sweatbox	kb. sl.: sel siksaan, tempat mengurung seorang hukuman.
sweater	kb. kemeja dari wol.
sweatheart	kb. kekasih, kesayangan, pacar, jantung/tangkai hati. they are sweathearts mereka berdua berkasih-kasihan/berpacar-pacaran.
sweatshop	kb. tempat dimana pekerja-pekerja membanting tulang dengan gaji yang rendah.
sweaty	ks. berkeringat.
swed.	1 [swedish] dari swedia ; bahasa swedia. 2 [sweden] swedia.
swede	kb. orang swedia.
swedish	kb. bahasa swedia. -ks. dari swedia. he's s. dia orang swedia.
sweep	kb. 1 usapan, sikatan (of abrush). 2 ayunan (of o's hand, of an oar). 3 jalan. 4 keluasan (of the road and fields). -kkt.(swept) 1 menyapu (the floor). 2 menjuarai (the race). 3 meluas di, menjalar di.
sweeper	kb. 1 penyapu. 2 alat penyapu.
sweepstakes	kb. undian, taruhan.
sweet	kb. 1 manis. 2 gula-gula. 3 enak. sweet-tempered ks. baik hati, manis, bersifat peramah. -sweetly kk. (dengan) manis
sweetbread	kb. daging kelenjar perut atau kerongkongan anak sapi.
sweeten	kkt. 1 membubuhi gula, mempermanis, memaniskan (tea, coffee). 2 membuat lebih menartik (an offer). -kki. menjadi manis (sambil masak). -sweetening kb. bahan pemanis.
sweetener	kb. bahan pemanis.
sweetie	kb. inf.: kekasih, jantung-hati.
sweetness	kb. rasa/sifat manis. he has been all s. and light dia senantiasa manis dan ramah.
swell	kb. gelombang besar. -ks. inf.: 1 baik (hati) (fellow). 2 hebat. -kkt. (swelled, swelled atau swollen) 1 membengkakkan. 2 menambah besar. -kki. 1 mengembang. 2 bertambah.
swell-headed	ks. besar kepala, sombong.
swelled, swollen	ks. 1 bengkak, gembung (knee). 2 bengul, balut, (of eyes from weeping) -swelling kb. bengkak.
swelter	kki. merasa terik, berkeringat banyak, menderita kepanasan. -sweltering ks. panas sekali, terik.
sweltry	ks. panas sekali, panas-terik.
swept	lih sweep.
swept-back	ks. 1 yang berlekuk kebelakang (of plane wing). 2 yang disisir kebelakang (of hair). -sweeping ks.1 besar, meyakinkan. 2 luas.
swerve	kkt. membelokkan, membanting (a car). -kki. mengelak, melencong.
swift	kb. sejenis (burung) layang-layang. -ks. 1 cepat, laju. 2 tangkas. -swift-footed ks. cepat-kaki, dapat berlari cepat.
swiftness	kb. kecepatan.
swig	kb. teguk. a s. of brandy seteguk berandi.
swill	kb. sisa-sisa dapur bercampur air, air cucian. -kkt. meminum dengan lahap.
swim	kb. renang. -kkt. (swam, swum) 1 merenangi (a river). 2 berenang. -swimming kb. berenang.
swimmer	kb. perenang.
swimmingly	kk. dengan berhasil sekali. to get along s. berjalan lancar.
swimsuit	kb. pakaian renang.
swimwear	kb. pakaian renang.
swindle	kb. penipuan, pengecohan. -kkt. menipu, mengecoh, menggait.
swindler	kb. penipu, pengecoh.
swine	kb. babi.
swing	kb. 1 ayunan, buaian (from a tree). 2 irama (of poetry, music). 3 musik swing, irama swing. 4 perjalanan. -kkt. (swung) 1 mengayunkan. 2 menggoyangkan. 3 memutar, membelokkan 4 melancarkan, menjalankan.
swinger	kb. inf.: pengikut mode remaja yang giat.
swinging	ks. sl.: mengikuti arus mode terakhir. s. door pintu kupu-kupu/ayun.
swipe	kb. inf.: pukulan. to take a s. at mengayunkan/melayangkan pukulan arah (s.o. or s.t.). -kkt. 1 inf.: memukul. 2 sl.: mencuri, menyikat.
swirl	kb. 1 putaran angin (of dust). 2 lingkar. her hat had a s. of lace around it topinya dilingkari renda. 3 keramaian (of a farewell reception). -kkt. mengaduk. -kki. beterbangan berputar-putar (of dust in the air).
swish	kb. 1 desir (of oars in the water). 2 desis (of a dress). 3 bunyi mendesing (of a rope, whip). 4 kibasan (of a tail). -kkt., kki. berdesir, mendesir.
switch	kb. 1 tombol/kenop (pemutar), saklar, pemetik. 2 perubahan (in plans). 3 penggantian (in officers of a club). 4 rr.: wesel. 5 ranting, rotan, semacam cemeti. 6 kibasan (of a tail)
switchblade	kb. pisau lipat otomatis.
switchboard	kb. papan wesel/hubung, weselbor. s. operator pelayan telpon penghubung (telpon).
switcher	kb. rr.: lokomotip pelangsir.
switchover	kb. peralihan, pergantian, pertukaran.
switchyard	kb. pelataran langsir.
swivel	kb. kili-kili. s. chair kursi putar.
swob	= swab.
swollen	swollen
swoon	kb. pingsan. to fall into a s. jatuh pingsan -kki. jatuh pingsan.
swoop	kb. tukikan, sambar(an) (of a bird, plane). -kki. to s. down menyambar/menukik kebawah (on ke).
swoosh	kb. desah, raung, deru (of birds, planes).
swop	= swap.
sword	kb. pedang. to wear a s. membawa pedang.
swordfish	kb. ikan todak.
swordsman	kb. (j. -men) ahli pemain anggar.
swore	lih swear.
sworn	lih swear.
swum	lih swim.
swung	lih swung.
sycamore	kb. sejenis pohon.
sycophant	kb. penjilat, peleceh.
syllabary	kb. (j. -ries) daftar suku kata.
syllabic	ks. yang merupakan suku-kata tersendiri.
syllabification	kb. pembagian atas suku-suku kata.
syllabus	kb. ikhtisar rencana pelajaran, sillabus.
syllogism	kb. silogisme
sylph	kb. peri, bidadari.
sylphlike	ks. langsing, ramping, dan indah (of a figure).
sylvan	ks. berhutan-hutan, berpohon-pohon. s. setting tempat yang banyak hutannya.
symbiosis	kb. simbiosis.
symbiotic	ks. simbiotik.
symbol	kb. 1 lambang. the lion is the s. of courage singa merupakan lambang keberanian. 2 simbul, tanda. "&" is a s. for "and" "&" adalah tanda pengganti untuk "dan".
symbolic	ks. simbolis. s. logic ilmu logika yang dinyatakan dengan simbul-simbul.
symbolism	kb. simbolisme.
symbolize	kkt. menandakan, melambangkan, menyimbulkan.
symmetrical	ks. simetris, setangkup.
symmetry	kb. (j. -ries) simetri.
sympathetic	ks. simpatik. to be s. to bersimpatik kepada. s. audience pendengar/publik yang menaruh perhatian.
sympathize	kki. 1 ikut berbelasungkawa.. i can s. with you saya dapat menyatakan simpati kepada saudara. 2 setuju dengan (with o's plans).
sympathizer	kb. simpatisan.
sympathy	kb. (j. -thies) simpati. you have my s. saudara mendapat simpati saya.
symphonic	ks. yang berhubungan dengan simfoni. s. music musik simfoni.
symphony	kb. (j. -nies) simfoni. s. orchestra orkes simfoni.
symposium	kb. (j. -ums, -ia) 1 simposium. national s. simposium nasional. 2 (book) kumpulan karangan.
symptom	kb. gejala. to show symptoms of memperlihatkan tanda.
symptomatic	ks. yang merupakan gejala.
synagogue	kb. gereja kaum yahudi.
synchronic	ks. sinkronis.
synchronization	kb. keserempakan, sinkronisasi, penyelarasan.
synchronize	kkt. 1 men(g)sinkronisasikan, menyerempakkan. 2 menyamakan (watches).
synchrotron	kb. sinkrotron.
syncopation	kb. sinkopasi.
syncope	kb. ling.: penyingkatan ucapan kata.
syncretism	kb. penyatuan aliran, sinkretisma.
syndicate	kb. kongsi, gabungan perusahaan. -kkt. mempersatukan menjadi sindikat.
syndrome	kb. sindrom.
synod	kb. muktamar gereja.
synonym	kb. sinonim, kata searti, muradif.
synonymous	kb. yang searti (with dengan).
synopsis	kb. ikhtisar, ringkasan.
syntactic(al)	ks. yang berhubungan dengan sintaksis.
syntax	kb. sintaksis, ilmu nahu/kalimat.
synthesis	kb. sintese, perpaduan.
synthesize	kkt. mengumpulkan dan menjadikan satu, mempersatukan.
synthetic	kb. buatan, tiruan. -ks. sintetis, buatan, tiruan. s. rubber karet buatan.
syphilis	kb. sipilis, penyakit raja singa.
syrian	kb. orang suria. -ks. suria.
syringe	kb. semprot(an), alat semp(e)rit. -kkt. menyemprot, menyemprit.
syrup	kb. sirop, seterup, air gula.
system	kb. 1 sistim, susunan. school s. sistem sekolah. 2 jaringan. 3 cara.
systematic	ks. 1 sistematis. 2 secara teratur, rapi (of a person). -systematically kk. 1 menurut sistim/susunan teratur. 2 secara sistematis.
systematize	kkt. mengatur, menyusun.
systemic	ks. yang berhubungan dengan suatu sistim atau susunan yang teratur.
t,t	kb. huruf ke-20 dari abjad inggris. t-bone (steak) bistik dari daging pinggang lembu, dengan tulang yang berbentuk t. t-shirt kaos oblong. t-square garisan siku-siku.
t.	1 (time) waktu. 2 (transitive) transitip. 3 [ton(s) ] ton.
t.h.	[territory of hawaii] sekarang negara bagian di as.
t.p.	[title page] halaman judul.
t/o	[table of organization] skema organisasi.
tab	kb. 1 punca, label. 2 carikan kain. 3 biaya, rekening. to pick up the t. membayar rekening. 4 etiket. -kkt. (tabbed) menyebut.
tabby	kb. (j. -bies) kucing betina.
tabernacle	kb. tempat beribadat.
table	kb. 1 meja. 2 daftar. 3 table, daftar angka. 4 skema. -kki. menangguhkan. t. d'hote makanan yang disajikan pada waktu tertentu dengan harga yang sudah ditentukan. t. lamp lampu meja/duduk. t. linen kain-kain yang dipakai dalam mengatur meja.
tableau	kb. tablo.
tablecloth	kb. tapelak, kain alas, ulas meja.
tablespoon	kb. sendok makan (besar). a t. of coffe kopi sesendok makan.
tablespoonful	kb. sesendok makan penuh.
tablet	kb. 1 tablet, pel, gentel. aspirin t. tablet aspirin. 2 buku/kertas catatan. 3 lembaran. clay t. lembaran dari tanah liat.
tabletop	kb. bagian atas (seperti bagian atas pada meja).
tableware	kb. alat-alat makan-minum, barang-barang pecah-belah.
tabloid	kb. surat kabar kecil (biasanya menggemparkan.
taboo	kb. 1 tabu. 2 larangan, pantang(an). -kkt. menabukan.
tabular	ks. tersusun dalam tabel atau daftar. t. data data dalam tabel.
tabulate	kkt. menyusun menjadi tabel, menstabulasi.
tabulation	kb. tabulasi, pengolahan.
tabulator	kb. tabulator, pembuat tabel.
tacit	ks. diam-diam, tak diucapkan. t. understanding/agreement tahu sama tahu.
taciturn	ks. bersifat (per)diam.
tack	kb. 1 paku rebana. 2 nau.: arah jalannya kapal. -kkt. 1 memakukan (a carpet). 2 nau.: berpal-pal. 3 melekatkan, melampirkan
tackle	kb. 1 katrol, takal. 2 alat. -kkt. 1 memegang, menangkap (s.o.). 2 mengerjakan, melakukan. 3 sport : menggasak, mentackle.
tacky	ks. inf.: jembel.
tact	kb. kebijaksanaan. he is tottally devoid of t. ia sama sekali tak bijaksana.
tactful	ks. bjaksana. to be t. bijaksana, pandai, berakal-budi. -tactfully kk. dengan bijaksana, dengan memakai akal-budi.
tactical	ks. taktis, bersiasat.
tactician	kb. ahli siasat.
tactics	kb. taktik, siasat. i don't like his t. aku tak suka pada cara-caranya.
tactless	ks. tak bijaksana, canggung.
tactlessness	kb. ketidakbijaksanaan, kecanggungan.
tadpole	kb. berudu, cebong.
taffeta	kb. kain taf.
taffy	kb. (j. -fies) sejenis gula-gula.
tag	kb. 1 etiket, label (on a box). 2 kartu. price t. kartu harga. 3 pening, kepingan untuk nama, tanda pengenal. -kkt. (tagged) membubuhi /memasang etiket (luggage, a bird).
tail	kb. 1 ekor (of an animal). 2 ekor, kotek (of a comet, kite). 3 buntut (of a wagon). 4 bagian bawah dari mata logam. 5 bagian belakang. -tails j. inf.: jas berekor. -kkt. mengikuti dengan diam-diam, mengekor, membuntuti (s.o.).
tailgate	kki mengikuti mobil lain terlalu dekat.
tailor	kb. tukang jahit, penjahit. -kkt. 1 membuat/menjahit pakaian. 2 menyesuaikan. tailor-made ks. buatan tukang jahit. -tailoring kb. 1 pekerjaan menjahit. 2 jahitan.
taint	kb. noda. to be free from the t. of sin bersih dari noda dosa. -kkt. menodai, mencemari. that food is tainted makanan itu sudah busuk.
take	kb. 1 akibat 2 sl.: pendapatan, penerimaan (at a sale). 3 sl.: pengambilan (of a movie). -kkt. (took, taken) 1 mengambil). 2 menerima (a bribe).3 memerlukan.4 membawa. 5 menggunakan.6 melakukan. 7 memegang (o's hand). 8 naik (a vehicle). 9 menuruti.
take-off	kb. 1 keberangkatan (of plane). 2 karikatur, imitasi. take-over kb. pengambilan-alih. -taking kb. pengambilan. ks. yang menarik/yang memikat hati.
taken	lih take.
taker	kb. 1 pengambilan. 2 orang yang menerima taruhan, penerima taruhan (of bets).
talc	kb. talek.
talcum	kb. talek. t. powder bedak talek.
tale	kb. hikayat, kisah, cerita, dongeng. t. of woe kisah kesusahan. 2 kebohongan.
talent	kb. bakat, pembawaan. he is loaded with t. ia berbakat sekali.
talisman	kb. jimat, azimat.
talk	kb. 1 percakapan. 2 pembicaraan, perbincangan. 3 ceramah. 4 omongan. 5 kabar angin, desas-desus. -kkt. berbicara. talking-point kb. hal yang dibicarakan. talking-to kb. inf.: teguran.
talkative	ks. suka (ber)bicara, banyak bicara.
talker	kb. pembicara. he's quite a t. ia jago ngomong/berpidato/ngecap. ia tukang bicara.
talkie	kb. inf.: pilem bicara.
tall	ks. 1 jangkung, tinggi (person). 2 tinggi (of a building, mountain).
tallow	kb. gemuk, lemak.
tally	kb. (j. -lies) 1perhitungan, jumlah, hitungan. 2 bridge : catatan angka. -kkt. (tallied) mendapat. -kki. cocok (with dengan).
talon	kb. kuku, cakar.
tamarind	kb. asam jawa.
tambourine	kb. rebana.
tame	ks. 1 jinak. 2 lemah (of style). -kkt. menjinakkan. -taming kb. penjinakan.
tameness	kb. kejinakan.
tamer	kb. penjinak.
tamil	kb. 1 orang tamil/keling. 2 bahasa tamil. -ks. tamil, keling.
tamp	kkt. memadatkan (earth). 2 memasukkan (dynamite into a hole).
tamper	kb. 1 pencangkul. 2 alat semacam cangkul. -kki. to t. with 1 merusakkan (a door, lock). 2 menyogok, memberi suap (a jury).
tan	kb. warna coklat. -ks. berwarna coklat. -kkt. (tanned) 1 menyamak (a hide). 2 inf.: mencambuk, mendera (a child for misbehaving). -tanning kb. penyamakan.
tandem	ks. dua-dua. to be in t. formation berurutan dua-dua. -kk. berdua-dua, berduaan.
tang	kb. 1 rasa keras, rasa tajam (of spices). 2 bau (of onions in milk). 3 bau tajam (of the morning air).
tangent	kb. garis singgung. to fly/go off on a t. menyeleweng/menyentuh persoalan.
tangerine	kb. jeruk kepruk.
tangible	ks. nyata. t. evidence bukti yang nyata.
tangle	kb. 1 kekusutan (of hair). 2 kekusutan, kekacauan (of conflicting opinions). -kkt. mengusutkan (string, twine). -kki. menjerat.
tango	kb. tango. -kki. berdansa tango.
tangy	ks. yang tajam rasanya. t. orange juice air jeruk yang tajam rasanya.
tank	kb. 1 teng, tangki (for liquids). 2 mil.: tank. -kki. to t. up 1 mengisi penuh dengan bensin. 2 sl.: meminum banyak (minuman keras). t. car gerbong tangki, truk pengangkut bahan cair.
tanker	kb. 1 kapal tangki, kapal pengangkut minyak. 2 truk tangki.
tankful	kb. tangki penuh.
tanner	kb. penyamak (kulit) , tukang samak (kulit).
tantalize	kkt. menggoda, menggiurkan. -tantalizing ks. menggiurkan.
tantamount	ks. serupa, sama. the letter was t. to an officer of a job surat itu serupa dengan suatu tawaran pekerjaan yang resmi.
tantrum	kb. inf.: kemarahan, kemurkaan. to throw a t. mengeluarkan amarah yang hebat (untuk mencapai maksudnya).
tap	kb. 1 ketukan (on door). 2 ketukan (with a hammer). 3 keran (for water). -kkt. (tapped) 1 menepuk. 2 menyadap (a tree). 3 membuka sumbat (a barrel). 4 memasang alat pendengar rahasia pada telepon. 5 memberi/membuka jalan kepada (talent). 6 menyediakan.
tape	kb. 1 pita. 2 pita, plester, pengikat (on a bandage). 3 tep, pita (on recorder, computer). -kkt. 1 memperban, membalut (a wrist). 2 mengetep, merekam (music). t. machine/recorder alat perekam, teprekorder. -taping kb. perekaman.
taper	kki. meruncing. to t. to a point meruncing ke ujung. -tapering kb. lonjong. ks. tirus, lancip.
tapestry	kb. (j. -ries) permadani hiasan dinding. -kkt. mengalas dengan kain permadani. tapestried sofa bangku berkasur yang dialasi dengan kain permadani.
tapeworm	kb. cacing pita, gelang-gelang raya.
tapioca	kb. tapioka, tepung ubi kayu.
tapir	kb. tenuk, babi alu.
tapper	kb. penyadap, tukang sadap (of rubber).
tar	kb. 1 ter, belangkin. 2 aspal (on road). 3 getah tembakau (in cigarettes). -kkt. (tarred) mengaspal.
tarantula	kb. laba-laba besar.
tardiness	kb. kelambatan, kelambanan.
tardy	ks. (ter) lambat.
target	kb. 1 sasaran, bulan-bulanan. to hit the t. mengenai sasaran. 2 sasaran usaha (of a firm).
tariff	kb. 1 bea, cukai. t. wall bea yang menghalang kelancaran perdagangan. 2 pajak, cukai (on spirits). 3 tarip, ongkos (at a hotel).
tarnation	kb. sl.: persetan. what in t. are you talking about ? persetan, apa yang kau katakan itu ?
tarnish	kb. noda, becak. -kkt. 1 menodai (silver). 2 memudarkan, mencurahkan, kilauan (silver, brass).
taro	kb. talas, keladi.
tarpaulin	kb. kain terpal.
tarried	lih tarry.
tarry	ks. t. substance bahan semacam ter/rasidi.
tarsus	kb. pangkal/pergelangan kaki.
tart	kb. 1 kue tarcis. 2 sl.: pelacur. -ks. asam.
tartan	kb. pola pertek-petak (pakaian di skotlandia).
tartar	kb. kotoran kuning yang keras, karang gigi.
tartness	kb. kegetiran, kepahitan, rasa pahit atau tajam.
task	kb. tugas. difficult t. tugas yang sulit. 2 gugus tugas. to take s.o. to t. for menegur seseorang karena.
taskmaster	kb. pemberi tugas.
tassel	kb. 1 jumbai, rumbai, gunjai, malai, jembul, kuncir. 2 bunga jantan (on cornstalk).
tasseled	ks. berkuncir, berjambul (cap).
taste	kb. 1 rasa. 2. selera, pengecap(an). 3 citarasa. 4 perasaan. -kkt. 1 merasakan (happiness). 2 mencicipi (food). -kki. berasa. to t. of 1 rasanya seperti. 2 mencicipi (several dishes). t. bud pengecap/perasa pada lidah.
tasteful	ks. penuh perasaan/citarasa/selera. -tastefully kk. (dengan) penuh selera.
tasteless	ks. hambar, tawar.
taster	kb. juru pengecap, ahli pencicip (of coffee, wine).
tasty	ks. enak, lezat, gurih.
tatter	kb. sobekan kain. in tatters kecai-kecai, sobek-sobek, compang-camping.
tattle	kki. membuka rahasia, mengadukan. to t. on s.o membuka rahasia seseorang.
tattletale	kb. inf.: pengadu, pembuka rahasia.
tattoo	kb. tanda rajah, cacahan. -kkt. merajah, mencacah. -tattooing kb. merajah, mencacah.
taught	lih teach.
taunt	kb. celaan,ejekan. -kkt. mencela, mengejek.
taurus	kb. zod.: vrisaba.
taut	ks. 1 tegang (cable). 2 rapi (ship).
tautology	kb. (j. -gies) pengulangan kata tanpa menambah kejelasan.
tavern	kb. kedai minuman.
tawdry	ks. mentereng tetapi tidak berharga.
tax	kb. 1 pajak. 2 harga, ongkos. 3 beban (on o's heart). tax-dodger kb. orang yang tak membayar pajak. tax-exempt ks. bebas pajak (income). tax-free ks. bebas cukai (articles).
taxable	ks. yang dapat dikenakan pajak, yang kena wajib pajak (income).
taxation	kb. 1 pajak. heavy t. pajak yang tinggi. 2 perpajakan.
taxi	kb. taksi. to go t. pergi dengan taksi. t. driver sopir taksi. t. stand pangkalan taksi. -kkt. menjalankan pesawat terbang pelan-pelan (a plane). -kki. berjalan keluar menuju landasan terbang.
taxicab	kb. taksi.
taxidermy	kb. kepandaian mengisi kulit binatang dengan kapas, dll sehingga nampak seperti binatang hidup.
taxonomy	kb. sistim klasifikasi khususnya dalam dunia tumbuh-tumbuhan dan binatang.
taxpayer	kb. pembayar pajak.
tb	kb. tbc, tebese.
tbs(p)	[tablespoon(s)] sendok makan.
tea	kb. teh. 2 minuman teh. t. cosy tekosi, tutup teko. t. leaves menebak/membaca nasib.
teacart	kb. meja kecil beroda untuk menghidangkan makanan atau minuman seperti teh.
teach	kkt. (taught) 1 mengajar. 2 mengajarkan. 3 menghajar. -kki. mengajar. teach-in kb. diskusi meneliti soal umum di kampus. -teaching kb. 1 mengajar. 2 ajaran.
teachable	ks. dapat diajarkan/diajari.
teacher	kb. guru, pengajar.
teacup	kb. cangkir teh.
teak	kb. (kayu) jati.
teakettle	kb. teko/ceret teh.
team	kb. 1 regu (of athletes, workers). 2 regu, rombongan. 3 sepasang(an) (of horse). -kki. to t. up bekerja-sama. to t. up with bersekutu dengan. t. spirit semangat kesatuan/kelompok.
teammate	kb. kawan seregu.
teamster	kb. 1 pengemudi (truk). 2 buruh pengangkutan.
teamwork	kb. kerjasama sekelompok.
teaplanter	kb. 1 penanam teh. 2 pengusaha perkebunan teh.
teapot	kb. teko/ceret teh.
tear	kb. air mata. -kki. berlinang. tear-stained ks. dibasahi.
teardrop	kb. tetes(an) airmata.
tearduct	kb. pembuluh air mata.
tearful	ks. menyedihkan, berkesan, menangis. in t. voice dengan suara menangis/sedih. -tearfully kk. dengan suara sedih.
tearoom	kb. kedai teh, restoran kecil.
tease	kb. penggoda, pengusik. -kkt. 1 menggoda, mengusik (s.o.). 2 menyisir (rambut hingga terpisah helaian-helaiannya). -teasing kb. sindiran, ejekan, olok-olokan, gangguan.
teaser	kb. inf.: penggoda, pengusik, pengejek.
teaspoon	kb. sendok teh. a t. of cough syrup obat batuk sesendok teh.
teaspoonful	kb. sesendok teh penuh.
teat	kb. mata/puting susu, pentil (susu).
tech.	1 [technology] teknologi. 2 [technical] teknis, teknik.
technical	ks. teknis. his job is highly t. pekerjaannya sangat bersifat teknis. -technically kk. secara tehnik.
technicality	kb. (j. -ties) alasan-alasan / dasar - dasar tehnis.
technician	kb. ahli/juru teknik.
technique	kb. teknik. the t. of painting teknik melukis.
technological	ks. secara teknologi, serbamesin. t. advances kemajuan-kemajuan teknologi.
technology	kb. teknologi. institute of t. institut teknologi.
tedious	ks. boyak, membosankan.
tediousness	kb. keboyakan.
tedium	kb. rasa bosan/jemu.
tee	kb. 1 tempat permulaan permainan golf. 2 tee. -kkt. to t. off 1 (golf) mulai memukul bola dari tempat permulaan. 2 sl.: membuat marah.
teem	kki. penuh, berkerumun. to t. with new ideas penuh dengan ide-ide baru. -teeming ks. padat, sesak (crowd).
teen-age	ks. umur belasan (tahun). t.-age group kelompok umur belasan tahun.
teen-aged	ks. belasan tahun, tanggung.
teen-ager	kb. anak tanggung, anak berumur belasan tahun.
teens	kb., j. umur belasan tahun.
teeny(-weeny)	ks. inf.: amat kecil.
teeter	kki. berdiri atau berjalan sambil mengimbangi badan (supaya tidak jatuh). teeter-board kb. papan jungkitan/jungkat-jungkit.
teeth	lih tooth.
teethe	kki. mendapat/keluar/tumbuh gigi. -teething kb. tumbuh gigi. t. ring gelang untuk digigit.
teetotaler	kb. orang yang tak meminum minuman keras.
tehee	kseru. (tertawa) terkekeh-kekeh.
tel.	[telephone] telpon. 2 [telegram] telgram. 3 [telegraph] telgrap.
telecast	kb. siaran televisi. -kkt. menyiarkan melalui televisi.
telecommunication	kb. telekomunikasi.
telegram	kb. telgram, surat kawat.
telegraph	kb. telgrap. -kkt. mengawatkan, mengirim telgram. t. office kantor telegrap. t. operator pengirim/pengetok kawat. t. pole tiang telgrap.
telegrapher	kb. pengirim,/pengetok kawat.
telegraphy	kb. telegrafi.
telemetry	kb. telemetri.
teleology	kb. teleologi.
telephaty	kb. telepati.
telephone	kb. telpon. by t. lewat telpon.you are wanted on the t. saudara dipanggil ke telpon. -kkt., kki. menelpon.
telephonic	ks. lewat telpon. t. message pesan lewat telpon.
telephoto	kb. potret jarak jauh. t. lens lensa potret jarak jauh.
telescope	kb. teleskop, teropong. -kkt. saling menerobos. -kki. memaksa bagian yang satu masuk ke bagian yang lain.
telescopic	ks. teleskopis. t. lens lensa teleskopis.
teletype	kb. teletip. -kkt. mengirim dengan teletip.
teletypewriter	kb. mesin tulis teletip.
televise	kkt. menyiarkan melalui televisi.
television	kb. televisi, telepisi. tv. to see s.t. on t. melihat sesuatu di televisi. t. viewer pirsawan.
tell	kkt. (told) 1 menceritakan. 2 memberitahukan, menceritakan. 3 mengatakan. 4 menyuruh. 5 mengetahui. 6 mengenalkan, mengenali. -kki. mengadukan. -telling kb. penceritaan, pemberitaan.
teller	kb. 1 bank : kasir. 2 tukang cerita, orang yang bercerita.
telltale	kb. pengadu, pembuka rahasia. -ks. yang memberikan petunjuk. t. signs of tanda-tanda yang memberikan petunjuk tentang.
temerity	kb. 1 keberanian. 2 kesemberonoan.
temp.	1 [temporary] sementara. 2 [temperature] suhu.
temper	kb. 1 sifat, watak. 2 kemarahan. 3 tabiat/keadaan marah. 4 kekerasan (of steel, clay). -kkt. 1 memperlembut, melembutkan. 2 mengeraskan (metal). t. tantrum tingkat marah, ledakan amarah.
temperament	kb. perangai, tabiat, watak. he's an artist by t. ia berwatak seniman.
temperamental	ks. berperasaan yang mudah tergugah. she's very t. banyak sekali tingkahnya. ia amat emosionil.
temperance	kb. 1 kesederhanaan. 2 pemantangan minuman keras.
temperate	ks. 1 dengan kepala dingin. t. approach to problems pendekatan dengan kepala dingin terhadap masalah-masalah. 2 sedang. t. climate iklim sedang. t. zone daerah beriklim sedang. 3 tenang, sabar, tidak memihak (habits).
temperature	kb. 1 panas, demam. 2 suhu. what's the t. outside ? berapa suhu di luar.
tempest	kb. prahara, (angin) badai, angin ribut. t. in a teapot kehebohan yang tak berarti.
tempestuous	ks. 1 bergelombang hebat (of the seas). 2 galak, menggelora, bergejolak (of disposition).
temple	kb. 1 (balinese) kuil. 2 (chinese) kelenteng. 3 (hindu) candi. 4 anat.: pelipis.
tempo	kb. 1 tempo (of music). 2 kecepatan (of the work).
temporal	ks. 1 sementara. 2 duniawi, keduaniawian. t affairs hal-hal keduniawian.
temporary	ks. 1 sementara. t. appointment pengangkatan sementara. t. housing perumahan sementara. -temporarily kk. untuk sementara (waktu).
temporize	kki. menunggu kesempatan yang baik, bertindak mempergunakan kesempatan, menunda bertahan.
tempt	kkt. menggoda (s.o). -tempting ks. menarik, menggiurkan (offer). t. dish masakan yang menggiurkan.
temptation	kb. godaan. to yield to t. menyerah kepada godaan. to throw t. in s.o's way melemparkan godaan kepada jalan seseorang.
