percis	see persis.
percit	spurt forth strongly.
percul	dart away.
percuma	see cuma.
perdana	1 principal. perdana-mentreri prime minister, premier. 2 inaugural, first introduction to the public.
perdata	(leg.) 1 court of justice. 2 civil (cases).
perdatam	[departemen] perindustrian dasar dan pertambangan] (department) of basic industries and mining.
perdeo	see prodeo.
perdikan	freed from payment of taxes (in villages) as result of assuming some burden or responsibility.
perdiping	story, floor.
perdom	(coll.) mild swear word.
perdu	1 clump (of bamboo, etc.). 2 lowest part of tree trunk.
perduli	see peduli.
pere	see perai 1.
pereaksi	reagent.
perebutan	struggle, fight.
peredaan	quieting down, slowing down (of activity, etc.).
peredam	k.o. device to reduce noise or light.
peredus	1 pregnant. 2 potbellied.
pereh	be overly meticulous.
perei	see perai 1.
perek	/prek/ [perempuan eksperimental] loose and freewheeling girl. /pere`k/ see prek.
perekat	glue. adhesive.
perekik	see prikik.
peremajaan	rejuvenation, renovation.
pereman	see preman.
perembetan	involvement.
perembukan	1 discussion, deliberation. 2 conference, consultation.
perempuan	1 woman, female. 2 feminine.
perenang	see renang, centang-perenang.
perenggi	(lit.) european.
perentang	see centang-perenang.
perenung	daydreamer.
peres	see peras. /pe`re`s/ leveled off.
peresmian	1 official announcement or appointment. 2 official appointment. 3 formal ceremony (of dedication, etc.).
peretas	1 o. who breaks through. 2 instrument for opening s.t.
peretel	see pretel.
perewa	(m) o. who lives outside customary law.
perewangan	see prewangan.
perfeksionis	perfectionist.
perfeksionisme	perfectionism.
perforasi	perforation.
perforator	hole puncher.
pergajul	see bergajul.
pergat	(naut.) frigate.
pergaulan	1 association, social intercourse. 2 society. 3 sexual intercourse.
pergedel	see perkedel.
pergi	1 go. 2 leave, be out. 3 (coll.) go to.
pergigian	dentition, dentistry.
pergok	1 catch by surprise. 2 catch s.o. red-handed.
pergol	/pergul/ gold-plated.
pergolakan	pergolakan
pergulatan	1 wrestling. 2 struggle, encounter, contact.
pergumulan	1 wrestling. 2 stuggle.
pergundikan	concubinage.
perguruan	1 instituation, school. 2 school (building). 3 instruction.
perhal	see peri 1.
perhatian	1 attention, notice. 2 interest.
perhentian	1 cessation, discontinuance, closing down (of factory program, etc.). 2 stopping place (of bus, etc.).
perhiasan	1 jewelry (esp, gold). 2 decoration (in building, etc.).
perhimpunan	1 association, organization. 2 gathering place, place of assembly.
perhitungan	1 calculation, computation. 2 accounting. 3 consideration.
perhubungan	1 communications (radio, highway, etc.). 2 liaison. 3 relationship.
perhutanan	1 forestry affairs. 2 forestry service.
peri	1. 1) having to do with. 2) attitude. 2. (lit.) k.o. female celestial being of exceeding beauty.
peria	1. see pria. 2. see pare.
periai	see priyayi.
perian	bamboo for carrying water.
peribadatan	observance of religious duties.
peribahasa	proverb.
peribumi	see pribumi.
peridi	fertile (of animals).
peridolar	see peri 1.
perigi	well, spring.
perih	see pedih.
perijam	see peri 1.
periksa	1 investigation, inspection, examination. 2. get o.s. examinated.
perilaku	behavior.
perimnas	[perumahan nasional] national housing authority.
perinci	see rinci.
perincian	1 details, the way s.t. is broken down (of calculation, etc.). 2 subsection.
perincis	specify.
perindustrian	industry, industrial affairs.
pering	1. bamboo. 2.stink.
peringan	s.t. which lightens s.t.
peringanan	1 lightening of s.t. 2 (leg.) commutation of a sentence.
peringkat	1 level. 2 rank.
perintah	order, command.
perintis	see rintis.
periode	period (of time).
periodik	periodic, rotating.
periodisasi	division of history into periods.
perisai	shield.
periskop	periscope.
peristirahatan	place provide for employees or members of a given group to spend their vacation.
peristiwa	1 event, incident, happening, affair. 2 phenomenon.
periuk	caldron, cooking pot.
perjajakan	1 measuring. 2 investigation.
perjaka	young, unmarried man.
perjalanan	1 trip , journey , tour 2 course .
perjanka	[perushaan jawatan kereta api] state railway corporation.
perji	see farji.
perjurit	see prajurit.
perkabaran	news, news report.
perkabungan	1.mourning, grieving. 2. sugar palm. 3. measure of four cubits' length. 4. slice, fragment.
perkadian	arbitration.
perkakas	tools, implements, apparatus
perkalian	(math.) 1 multiplication. 2 product.
perkamen	parchment.
perkantoran	1 office affairs. 2 office complex.
perkara	1 matter, case. 2 the fact that. 3 (leg.) lawsuit, case.
perkasa	1 brave, courageous. 2 physically powerful, strong and robust.
perkataan	word, words.
perkawinan	1 marriage. 2 wedding. 3 mating, breeding of animals.
perkedel	croquette of spicy ground meat and boiled potatoes or other starch.
perkemahan	1 camping. 2 a camp out. 3 (mil.) camp, encamment, bivouac.
perkembangan	1 development 2 blooming, flowering. 3 expansion.
perkenalan	1introduce s.o. or s.t. 2 inform s.o. of s.t.
perkenalkan	1introduce s.o. or s.t. 2 inform s.o. of s.t.
perkeneng	license for a vehicle.
perkintakaan	archival matters.
perkosa	1 violent. 2 violence. perkosa-an rape, violation.
perkulitan	cover, jacket.
perkumpulan	1 club, association. 2 meeting.
perkusi	percussion.
perkutut	small turtledove.
perla	[perhubungan laut] sea communications.
perladangan	1 unirrigated agricultural field. 2 cultivation (of such fields).
perlahan	1 slow. 2 soft of voice.
perlak	1. varnished, lacquered. 2. (lit.) garden close to house. 3. rubber sheet used under bed sheets.
perlakuan	treatment, way of treating s.t. or s.o.
perlambang	omen.
perlambangan	symbolism, symbilization.
perlaya	die in battle.
perleng	extend, prolong.
perlengkapan	1 equipment, outfit. 2 equipping. 3 supply.
perlente	(coll.) elegant, swell, dandy.
perlina	lost.
perlindungan	1) protection. 2) patronage, sponsorship.
perling	glitter.
perlintih	see perlente.
perlip	fall in love. perlip-perlip-an flirt.
perlipatan	1 multiplication, increase. 2 method of folding.
perlonco	see pelonco.
perlontaran	1 hurling. 2 bringing up.
perlop	1 leave, furlough. 2 be on leave.
perlu	1 necessary, be needed. 2 need to. 3 (coll.) need.
perlup	be engaged to be married.
perlus	fall into a hole.
perlusin	by the dozen
permadani	carpet.
permaduan	polygamy.
permai	pretty, beautiful.
permainan	1 game. 2 performance, show. 3 acting. 4 tricks played on o.
permaisuri	consort of king.
permak	altered, changed.
permakluman	1 announcement, declaration, proclamation. 2 statement.
perman	see firman.
permana	1. quantity. 2. (java) careful.
permandian	1 bathing place. 2 baptism.
permanen	permanent.
permanesi	permanence.
permata	jewel, precious stone.
permati	final, with no further change.
permen	1 hard candy. 2 candy (in general). permen-karet chewing gum.
permesta	[perjuangan semesta] the total struggle, the uprising in sulawesi in late 1950's.
permias	[persatuan mahasiswa indonesia di amerika serikat] indonesian students' association in america.
permiintaan	1 request. 2 demand.
permil	per thousand.
permili	permili
perminyakan	petroleum or refinery affairs.
permisi	1 ask permission. 2 ask to be exused (to leave).
permohonan	1 request, appeal, petition. 2 application.
permukaan	surface.
pernafasan	breathing, respiration.
pernah	1. once, ever. 2. (java) be related in a certain way.
pernak-pernik	needless complications, complexities.
pernama	see purnama.
pernel	see pelanel.
pernik	1 small beads. 2 little things.
pernilaian	1.judgment 2.evalution,appraisal.
pernis	varnish.
pernyataan	1 declaration, pronouncement. 2 expression.
perocot	see procot.
perogol	see rogol.
peroi	crumbly.
perokok	smoker, habitual smoker.
peroksida	peroxide.
perolehan	result, achievement, gain, acquisition.
perombakan	1 reorganizing, making radical changes. 2 destroying and rebuilding. 3 renovation.
peron	railroad platform.
peronyok	crushed, crumpled.
perop	see prop 1.
perosok	sink in, slip into.
perosot	see rosot.
perotes	see protes.
perotian	1 matters concerning bread. 2 bakery.
perpaduan	1 merger, unification. 2 blend, synthesis.
perpanjangan	extension, prolongation.
perpati	see merpati.
perpautan	relation, connection.
perpelancongan	see lancong.
perpisahan	1 discord. 2 leave-taking, parting.
perpres	[peraturan presiden] presidential regulation.
perpu	1. [peraturan pemerintah pengganti undang-undang] gvt. regulation to raplace law number... 2. [peraturan pemilihan umum] regulations for the general elections.
perpustakaan	library.
perron	see peron.
pers	press.
persabungan	1 cock (kite, etc.) fight. 2 conflict. 3 pit for cockfighting.
persada	homeland, group of nation that have a connection.
persahabatan	friendship.
persajakan	1 poetry. 2 rhyme
persamaan	1 similarity, agreement. 2 comparison. 3 equality. 4 (math.) equation.
persasat	like, as if.
persawangan	(m) wasteland, dangerous wilderness.
persebaran	the spread, dissemination.
persediaan	1 stock, supply. 2 preparations.
persegi	(math.) 1 sided. 2 square.
persekot	cash advance.
persekotin	1 (coll.) give an advance to. 2 (sl.) make pregnant before marriage.
persekutuan	1 federation. 2 partnership. 3 league, alliance.
perselah	see perslah.
perselisihan	disagreement, quarrel, dispute.
perselokan	drainage system.
persemaian	seedbed, nursery.
persemakmuran	commonwealth.
persemayaman	1 throne. 2 residence.
persembahan	1 tribute, gift. 2 dedication.
persembunyian	shelter, hiding place, hide-away.
persen	1 percent. 2 tip. 3 present to a subordinate.
persenan	percentage or tip given.
persendian	1 pivot, base. 2 the body joints.
persenggamaan	coital act..
persengketaan	contention, dispute, conflict.
persenjataan	armament, arms, weaponry.
persentage	/persentase/ percentage, rate.
persepak-bolaan	soccer affairs.
persepatuan	matters pertaining to shoes and shoemaking.
persepsi	perception.
persepuluhan	decimal.
perserikatan	organization, association, union.
persero	1 share. 2 shareholder, partner. persero-terbatas limited liability company, ltd., inc. see sero.
perseroan	company.
persesaran	faulting, faulting system.
persesuaian	agreement, concurrence, compatibility.
persetan	to hell with.
persetruan	enmity, hostility.
persetubuhan	copulation.
persetujuan	1 treaty, agreement. 2 approval, agreement.
persewaan	rental.
persiapan	1 preparations. 2 set-up, arrangement. 3 supply, equipment, etc., prepared for some purpose.
persidangan	1 meeting, assembly. 2 court session (over several days).
persih	see bersih.
persik	peach.
persil	lot, plot. te-persil protrude, bulge.
persilangan	1 crossing. 2 contradiction, conflict.
persilatan	matters pertaining to systems of self-defense.
persimpang-siuran	1 crisscrossing. 2 confusion, mix-up.
persimpangan	intersection, branching off.
persinggahan	1 stop-over, transit. 2 port of call.
persiraman	(lit.) bathing place.
persis	exactly, precisely.
persit	[persatuan isteri tentara] army wives' organization.
perslah	report, account.
persneling	gear, transmission.
persoalan	1 problem, matter, issue. 2 discussion, debate.
persona	see pesona.
persona-non-grata	persons non grata.
personalia	personnel.
personawi	personal.
personifikasi	personification.
personil	staff, personnel.
perspektif	perspective.
perstatistikan	matters pertaining to statistics.
persuasi	persuasion.
persuasif	persuasive.
persubakan	matter pertaining to this water-control system.
persundalan	1 prostitution. 2 fornication.
persurat-kabaran	press.
persuratan	1 matters pertaining to correspondence. 2 (lit.) literature.
persutraan	matters pertaining to silk.
persyaratan	rules and regulations.
pertadbiran	administration, management.
pertahanan	1 defense. 2 stronghold, fortress.
pertaksian	taxi matters.
pertal	mem-pertal translate. pertal-an translation.
pertalian	1 relation, relationship. 2 connection.
pertama	first, the first.
pertamanan	1 gardens. 2 horticulture, garden affairs.
pertambahan	increase, growth, accretion.
pertambangan	mining, mine workings.
pertambatan	1 ship moorings. 2 connection, relationship.
pertanahan	land affairs, land matters.
pertanda	1 sign, indication, augury. 2 landmark.
pertandaan	indication.
pertandang	(m) visitor.
pertandingan	1 contest, competition. 2 comparison.
pertanggungan	1 responsibility. 2 guarantee, security. 3 insurance.
pertanggungjawaban	pertanggungjawaban
pertanian	agriculture.
pertanyaan	question, query.
pertapa	hermit, ascetic.
pertapaan	1 hermit's abode, retreat. 2 asceticism. 3 penance.
pertapaian	matters pertaining to fermentation.
pertarakan	abstinence.
pertaruhan	1 s.t. placed s.w. 2 bet. 3 savings. 4 articles entrusted to s.o.
pertarungan	fight, struggle.
pertautan	1 contact, bond. 2 joining, uniting. 3 (chem.) linkage.
pertebalan	thickening.
pertebaran	(phys.) dispersion.
pertekstilan	matters pertaining to textiles or textile industry.
pertelaan	proceedings, report.
perteleponan	pertaining to telecommunication.
pertelevisian	matters pertaining to television.
pertembakauan	tobacco affairs.
pertempuran	battle, combat.
pertemuan	1 meeting. 2 companionship.
pertengahan	1 the middle. 2 the average.
pertengkaran	dispute, fracas.
pertenisan	matters pertaining to tennis. dunia-pertenisan world of tennis.
pertentangan	1 conflict, controversy. 2 contradiction, contrast. 3 opposition, resistance.
pertentaraan	1 military barracks. 2 army base.
pertenunan	1 textile mill. 2 textiles.
pertenungan	fortune-telling, soothsaying.
pertepatan	coincidence.
perteraan	print office.
pertigaan	t-intersection.
pertikaian	conflic, controversy, disagreement.
pertikaman	a fight with daggers or similar weapons.
pertimbangan	1 judgment, opinion. 2 consideration. 3 review (of books, etc.).
pertindihan	overlapping.
pertinjuan	1 matters pertaining to fist fighting. 2 fist fight.
pertionghoaan	chinese affairs.
pertiwi	earth.
pertokoan	1 shop matters. 2 shopping complex.
pertolongan	help, aid.
pertopangan	1 contradiction. 2 conflict, dispute.
pertuanan	1 sovereignty, suzerainty. 2 ruling class, upper class. 3 rule, gvt.
pertubuhan	organization.
pertukangan	1 trade. 2 handicraft, craftsmanship. 3 craft, guild, association.
pertukaran	1 exchange. 2 change.
pertulisan	inscription.
pertumbangan	collapse.
pertumbuhan	growth, development.
pertumpahan	spillage.
pertunaian	matters pertaining to cash.
pertunangan	engagement.
pertunjukan	1 show, exhibition. 2 performance.
perturutan	1 continuation. 2 repetitiveness.
pertusis	/pertussis/ (med.) whooping cough.
pertuturan	1 conversation. 2 word, phrase. 3 pronunciation. 4 (ling.) speech act.
peruan	(naut.) yardarm. peruan-gema sonic depth finder.
peruangan	monetary affairs.
perubah	variable.
perubahan	change, alteration.
perugul	see rogol.
peruk	put s.t. in a place.
perukupan	censer.
perulangan	repetition, recurrence.
perum	(naut.) sounding lead.
perumisasi	conversion of state into public corporations.
perumnas	[perusahaan nasional] national housing authority.
perumpamaan	parable.
perumtel	[perusahaan umum telekomunikasi] national telephone and telegraph corporation.
perumuman	1 generalizing. 2 generalization.
perun	1 heap of dried plants for burning. 2 trash, garbage heap.
perundang-undangan	legislation.
perundingan	1 negotiation, deliberation. 2 discussion.
perunggasan	poultry husbandry.
perunggu	bronze.
perungus	1. fiery, hot-tempered. 2. hothead, spitfire.
peruntukan	allotment, allocation.
peruntungan	fortune, luck.
perupahan	wage matters.
peruraian	disentanglement.
peruri	[percetakan uang republik indonesia] the indonesian national mint.
perus	stern, grim.
perusa	1 violate, rape. 2 force, compel. 3 annoy, disturb.
perusahaan	business, enterprise, undertaking, concern.
perusi	see prusi.
perusuh	1 rioter. 2 terrorist (in the 1950s).
perut	(anat.) 1 stomach, belly. 2 womb.
perutusan	delegation, deputation.
perwakilan	1 delegation. 2 agency. 3 representation. 4 (mil.) liaison unit.
perwalian	1 guardianship. 2 custody (of child), trusteeship. 3 protectorate.
perwara	1 (lit.) ladies-in-waiting of queen. 2 ancillary.
perwari	[persatuan wanita republik indonesia] organization of indonesian women, a social and charitable woman's club.
perwarisan	matters pertaining to inheritance.
perwasitan	matters pertaining to referees.
perwatakan	characterization.
perwatasan	(ling.) modification.
perwilayahan	matters relating to districts.
perwira	1 (mil.) officer. 2 brave, courageous.
perwujudan	1 shape, form. 2 realization, materialization. 3 phenomenon.
perzinahan	sexual acts outside of marriage.
pes	bubonic plague.
pes.	[pesawat] (tel.) telephone extention.
pesagi	(coll.) see persegi.
pesai	fall to pieces.
pesak	gusset, patch sewu between sleeves and main part of garment or pants legs and main part of trousers.
pesaka	see pusaka.
pesalin	new suit of clothes.
pesam	lukewarm (of water).
pesan	1 order. 2 order, instruction, command. 3 message.
pesan-pesan	k.o. poisonous centipede.
pesanggerahan	traveler's rest house.
pesanggrahan	see pasanggrahan.
pesangon	separation pay.
pesantren	(islam) school of koranic studies for children and young people, most of whom are boarders.
pesara	see pusara.
pesarean	see pasarean.
pesasir	see pasasir.
pesat	quick, speedy, rapid.
pesawat	1 instrument, machiine. 2 telephone instrument. 3 telephone extension. 4 plane.
peseban	see paseban.
pesek	flat-nosed.
pesenam	gymnast.
peser	half cent of colonial period.
pesero	1. shareholder. 2. see persero.
peserta	participant.
pesiar	1 trip, journey. 2 take a trip, go for a ride, excursion. pesiar-pengantin baru honeymoon.
pesimis	pessimist, pessimistic.
pesimisme	pessimism.
pesimistis	pessimistic.
pesinden	(java) woman singer with gamelan orchestra.
pesing	stench of urine.
pesirah	village chief in s. sumatra.
pesisir	1. beach, coastal area. 2. see pasasir.
pesok	dented.
pesolek	1 o. who uses makeup. 2 a woman who likes to dress up.
pesona	1 enchantment, spell. 2 magic formula.
pesong	crooked.
pesta	party, festivity.
pestaka	1 divining manual. 2 magic formula. 3 magic power investing a weapon or s.t. else.
pestipal	festival.
pestisida	pesticide.
pestol	see pistol.
pesuk	hole.
pesuruh	messenger.
pesut	1. porpoise. 2. cleaning rag.
pet	cap with a visor.
peta	1 map. 2 chart. 3 picture.
petah	petah-lidah 1 eloquent. 2 witty.
petai	k.o. tree that produces beans with pungent odor, widely eaten raw and cooked. peta-cina k.o. tree planted to shade coffee or other plants, the leaves of which serve as fodder and green manure and beans of which are edible.
petak	1. 1) compartment, partition, cabin. 2) garden bed, portion of a rice paddy. 2. white mark, blaze (on horse). 3. petak-umpat (jakarta) hide and seek.
petaka	accident, disaster, misfortune.
petakan	plot of land.
petakilan	(java) moving about too much, fidgety, improper becouse of fidgeting too much.
petal	1 press s.t downward. 2 loosen, remove by pressing.
petala	1 layer, stratum. 2 floor, story.
petam	band tied around forehead.
petan	main-petan play hide and seek.
petanaman	planting area.
petang	1 afternoon. 2 dark. /pe`tang/ divination.
petangan	prediction.
petani	farmer.
petari	see patri.
petaruh	1 final instructions, last will and testament. 2 security.
petas	see beras.
petasan	firecracker.
petatah-petitih	see petitih.
petatar	trainee.
petatas	see patatas.
pete	see petai.
petelur	egg layer.
petenah	see fitnah.
petenis	tennis player.
petentengan	/petenteng-petenteng/ with o.'s arms on the hips in an arrogant way.
peterah	see fitrah.
peterana	1 throne. 2 bridal chair.
peternak	breeder.
peternakan	animal husbandry.
peterseli	parsley.
petetirahan	vacation resort for health.
peti	case, chest.
petik	pick, pluck.
petikan	1 playing, plucking (of guitar). 2 quotation, excerpt.
petilan	episode, fragment of performance, interview, etc.
petilasan	remains of the past.
petinggi	s.o. wih formal authority or acknowledged influence within a certain region.
petinju	boxer.
petir	thunderclap, thunderbolt.
petirahan	health resort.
petiraman	oyster field or bed.
petis	condiment of the fermented fish or shrimp.
petisi	petition.
petitih	proverb, saying.
petopan	1 gambling den. 2 gambling place.
petor	district commissioner.
petrokimia	petrochemical.
petromax	/petromak/ kerosene pressure lantern.
petruk	(java) 1 o. of the clowns in the wayang stories. 2 funny-looking man.
petrus	[penembak misterius] (coll.) mysterious gunman.
petsai	(china) see pecai.
petuah	1 religious advice. 2 advice in general.
petualang	1 wanderer, tramp. 2 advenrurer who is trying to make a better life for himself.
petualangan	1 wandering about. 2 adventure, escapade.
petugas	1 functionary, official. 2 employee.
petungan	reckoning, calculation.
petunjuk	1 instruction, guidline. 2 advice, guidance. 3 indication, clue, hint. 4 direction.
petunjukan	appointment (to job, etc.).
peuyeum	/peyem/ (sunda) fermented cassava.
pewadahan	provision of a place or container.
pewajib	s.o. who is liable.
pewangi	s.t. to impart fragrance.
pewaris	heir.
pewarisan	1 inheriting. 2 inheritance.
pewarna	dye.
pewarta	1 correspondent, reporter. 2 news bulletin.
pewartaan	reporting.
pewatas	(ling.) modifier, qualifier.
pewawancara	interviewer.
pewawancaraan	interviewing.
pewayangan	things pertaining to the wayang.
peyek	see rempeyek.
peyok	/peyot/ see peok, peot 1.
peziarah	/penziarah/ visitor to a sacred place or grave.
pezina	adulterer, fornicator.
pf.	[pour feliciter] abbreviation written on card of congratulations.
pgc	[pasukan gerakcepat] (mil.) shock troops.
pgp,pgpn	[peraturan gaji pegawai (negeri) ] 1 regulations regarding civil service grade. 2 officially appointed to a certain grade.
pgri	[persatuan guru republik indonesia] indonesian teacher's union.
ph	[piringan hitam] phonograph record.
ph.	[per hektar] per hectare.
pharmakologik	see farmakologi.
pharmasi	see farmasi.
phh.	1. [perhubungan] communications. 2. [penghubung] liaison (officer).
philatelis	see filatelis.
phinisi	k.o. bugis cargo boat.
phobi	/fobi/ phobia, opposed to s.t. that o. should favor.
photo	see foto.
pi	1. [ambon) see pergi. 2. see papi.
pia	(china) k.o. tea cake.
piagam	charter, contract, deed.
piah	(china) take a ride.
pial	1 wattle. 2 gill.
piala	1 (lit.) cup, goblet. 2 loving cup. piala-ginjal (anat.) pelvic region.
pialang	intermediary, broker.
piama	see piyama.
piancang	(china) warrior.
pianggang	k.o. cricket.
pianica	k.o. musical instrument.
pianis	pianist.
piano	piano.
piao	(china) a dart.
piar	combed (of hair).
piara	see pelihara.
piarit	1 harpoon. 2 antenna of insects.
pias	1. margin, line. 2. pale.
piat-piut	descendants.
piatu	motherless child.
piau	(china) secret weapon in martial arts.
piawai	skilled, expert, sophisticated.
pica	neglect.
picah	see pecah.
picah-beling	k.o. flowering ornamental herb.
picak	see pecak.
pici	rimless cap, us. of black velvet, similar in shape to an ovenseas cap.
picik	1 narrow. 2 narrow-minded.
picing	wink.
picis	amounts in multiples of 10 cents.
picisan	1 10-cent pieces. 2 small-time, two-bit. 3 worth 10 cents.
picu	trigger, cock, hammer (of gun).
pidana	(leg.) 1 criminal. 2 punishment.
pidanawan	(leg.) prisoner.
pidato	speech, address.
pidi	mem-pidi aim, direct.
pigi	(coll.) see pergi.
pigimana	see bagaimana.
pigmen	/pikmen/ pigment.
pigura	1 picture, painting. 2 figure, representation. 3 picture frame.
pihak	1 side. 2 party (in a dispute, etc.).
pihutang	see piutang.
piil	see fiil.
pijah	spawn.
pijak	/pijak-pijak/ pedals.
pijar	blazing, red-hot, glowing.
pijar-pijar	borax.
pijat	get a massage.
pijat-pijat	bedbug.
pijet	/pijit/ see pijat.
pik	(china) eight (mainly used in commercial transactions). pik-ban 80,000. pik-ban go 85,000. pik-cap 80. pik-cap go 85. pik-ceng 8,000. pik-pek 800. pik-pekceng 800,000. pik-pek go 850. pik-pek go ceng 850,000. pik-tiau 8 million. pik-tiau pua 8,500,000.
pik.	[pikul] 137 lbs.
pikap	(coll.) 1 van, pick-up truck. 2 phonograph, hi-fi.
pikat	1. horsefly. 2. 1) trap birds with sticky substance. 2) attract, be attractive.
pikau	utter cries of fear.
pike	see kain.
pikep	see pikap.
piket	1 picket in a strike. 2 posted guard. 3 duty officer, o. on duty during off hours. 4 be on duty during off hours.
pikir	1 opinion, idea. 2 thought.
piknik	go on an excursion, picnic.
pikul	137 lbs.
pikun	senile, senility.
pil	pill, tablet.
pilah	sort, classify.
pilar	pillar.
pilek	have a cold.
pilem	see film.
pilih	fastidious, squeamish, choosy.
pilihan	1 choise. 2 selection.
pilin	spiral, twist.
pilinan	a twist, cord.
pilipina	see filipin.
pilis	camphor-based compress applied to forehead.
pilon	1 stupid. 2 innocent, naive.
pilot	plane pilot.
pilsapat	see filsafah.
pilu	1 moved, touched, affected. 2 sympathetic.
pilun	see pilon.
pilus	k.o. snack made of fried grated sweet potatoes.
pimpin	lead, guide.
pimpinan	leadership, guidance. 2 management, administration.
pimping	k.o. tall grass.
pimpong	see pingpong.
pinak	descendant.
pinalti	see penalti.
pinang	areca nut.
pinangan	1 proposal submitted. 2 o. whose hand is asked.
pinatua	church elder.
pincang	1 lame, crippled. 2 having a defect so that things are not even or smooth.
pincil	bunch, strand.
pincuk	1. 1) a folded-over banana leaf used as a container for portions of food. 2 k.o. fruit salad served with a spicy fish sauce. 2. make s.o. fall in love.
pincut	mem-pincut(kan) enthrall, make s.o. fall in love.
pinda	see penda.
pindah	1 move. 2 change, transfer to s.t. else.
pindai	scrutinize, look at carefully.
pindakas	peanut butter.
pindang	preserve large fish or meat with salt without drying.
pinding	see kepinding.
pines	thumbtack.
pingai	light yellow.
pinggan	dish, plate.
pinggang	1 waist. 2 loins.
pinggir	1 edge, seam. 2 border.
pinggiran	edges, coastal areas, outskirts.
pinggul	1 hip. 2 behind, rear.
pingin	see kepingin.
pingit	secluded (of marriageable girl).
pingkal	see pingkel.
pingkau	see pikau.
pingkel	double up with laughter.
pingpong	1 pingpong. 2 the football treatment, sending from pillar to post.
pingsan	1 unconscious. 2 fainted. 3 have a fit.
pingster	(rel.) pentecostal sect.
pinguin	/pingwin/ penguin.
pinhong	(china) screen.
pinisepuh	(java) elders (of a village or any organization).
pinisi	see phinisi.
pinjak	see pijak.
pinjal	flea.
pinjam	borrow .
pinjaman	loan.
pinset	tweezers, pincers.
pinsil	see pensil.
pinta	1.request. 2. /pintak/ fate, destiny.
pintaan	request, question.
pintal	spin, twine.
pintalan	ball of twine.
pintar	1 clever, smart. 2 skilled at, able.
pintas	a second (of time).
pintasan	short cut.
pinter	see pintar.
pintil	1. skin of yarn. 2. see pentil.
pintoo	(china) 1 buddhist priest. 2 term of address to buddhist priest.
pintu	door, gate.
pinus	k.o. tree, pine.
pinusisasi	reforestation with pines.
pion	(che.) pawn.
pionir	pioneer.
pipa	1 pipe, for smoking. 2 pipe, conduit, tube.
pipet	(chem.) pipette.
pipi	cheek.
pipih	flat, thin.
pipil	loosen beans, grains from shell.
pipilan	s.t. shelled.
pipis	1. (child language) urinate. 2. mash, crush up.
pipit	1. sparrow. 2. (child language) penis. 3. mouthpiece of a wind instrument.
pirai	(med.) gout.
piramid	/piramida/ pyramid.
piramidal	pyramidal.
pirang	see perang.
piranti	see peranti.
pirasa	see rasa.
pirasat	see firasat.
pirau	dark brown.
piraun	see firaun.
pirdaus	see firdaus.
pirik	mem-pirik rub down, pulverize.
piring	plate.
pirometer	pyrometer.
pirsa	pem-(p)irsa tv audience.
pirsawan	tv audience.
pirsider	refrigerator.
pirus	turquoise (gem).
pis	1. bolt of cloth. 2. see pipis 1.
pisah	1 part. 2 separated.
pisang	banana.
pisau	knife. pisau-bedah scalpel. pisau-belati dagger. pisau-cukur razor.
pisik	see fisik.
pisin	(sunda) saucer.
pisit	1. svelte. 2. press, compress.
pispot	chamber pot.
pistol	pistol, revolver.
pisuh	curse, use bad language in anger.
pisuhan	s.t. said in cussing.
pit	1. (china) brush pen. 2. bike, motorbike.
pita	1 ribbon. 2 tape.
pitam	1 dizziness. 2 fit. 3 apoplexy. 4 paralytic stroke.
pitar	mem-pitar aim a weapon. pem-pitar (gun) sight.
pitenah	see fitnah.
pites	strush between the fingernails.
piting	1. hold with forearms, clinch. 2. see fiting.
pitrah	see fitrah 1.
pituas	/pituwas/ 1 compensation, reward. 2 wage.
piuh	distorted.
piun	see pion.
piut	descendant 5th removed.
piutang	1 credit. 2 claim, accounts receivable.
piwulang	(java, sunda) lesson, teaching.
piyama	pajamas.
piyut	choke.
pj.	[pejabat] official.
pjka	[perusahaan jawatan kereta api] indonesian railway systems.
pjs.	[pejabat sementara] temporary official.
pk	1. [partai komunis] communist party. 2. [poardekracht] horsepower. 3. /p3k/ [pertolongan pertama pada kecelakaan] first aid.
pk.	[pukul] o'clock.
pki	[partai komunis indonesia] indonesian communist party.
pkk	[pendidikan kesejahteraan keluarga] program at village level to educate women on various aspects of family welfare.
pkl.	[pukul] o'clock.
pkus	[partai komunis uni sofyet] communist party of the soviet union.
pl-	see also entries with pel-.
pl.	[perjanjian lama] (bib.) old testament.
plafon	/plafond/ ceiling.
plagiat	plagiarism.
plagiator	plagiarist.
plak	1. /plak/ sound of slap. 2. plaque (on teeth).
plakat	poster.
plaksegel	receipt stamp or seal.
plamir	/plamur/ putty, spackle for pinting.
plan-plan	see pelan.
plane	/plein/ airplane.
plang	1 signpost. 2 gate.
planit	planet.
plankton	plankton.
planologoi	city planning.
plas-plosan	see ceplas-ceplos.
plastik	plastic.
plastis	plastic.
plastisitas	plasticity.
plat	see pelat.
platina	1 platinum. 2 (auto.) distributor contract, points.
plebisit	plebiscite.
pledooy	/pledoy,pleidoi/ (leg.) defense.
plek	stain, spot.
plempem	(java) large pipe (for drainage, etc.).
pleno	full, plenary.
plentong	lightbulb.
ples	bottle, flask.
plester	1 plaster. 2 adhesive plaster. plester-an covered with plaster. /pleste`r/ cement. plester-an cement floor.
pletat-pletot	not neat, not straight, not round.
pletik	onomatopoetic word for s.t. small ejected.
pletikan	a small thing ejected .
pliket	see peliket.
plin-plan	/plintat-plintut/ now this way now that, swaying with the wind, following whatever opinion is dominant.
plin-planisme	tendency to follow whatever idea is dominant.
plintir	see pelintir.
plisir	see pelisir.
plm	[perahu layar motor] k.o. sailboat equipped with auxiliary engines.
pln	[perusahaan listrik negara] state electricity enterprise.
ploi	pleat.
ploksok	connecting pipe socket with two different sizes.
plombir	1 fill (tooth). 2 stop, plug up.
plonci	see pelonci.
plonco	see pelonco.
plong	1 freed of cares, relieved. 2 hole.
plp	[pendidikan latihan pertempuran] (mil.) combat training.
pluit	see peluit.
pluk	sound of splashing water.
plung	sound of splashing water.
plus	1 (math.) plus. 2 having a surplus.
plutokrasi	plutocracy.
plutokrat	plutocrat.
pm	1. [perdana menteri] prime minister. 2. [polisi militer] military police.
pma	[penanaman modal asing] foreign investment.
pmdk	[penelusuran minat dan kemampuan] talent scouting for admission to state university system.
pmdn	[penanaman modal dalam negeri] domestic investment.
pmi	[palang merah indonesia] indonesian red cross.
pmk	[pasukan mencegah kebakaran] fire department.
pn	[perusahaan negara] state enterprise.
pneumonia	/pnemonia/ pneumonia.
png	[papua-nugini] papua-new guinea.
pni	[partai national indonesia] indonesian nationalist party.
po	(china) k.o. card game.
poatang	(jakarta, china) get caught, get found out.
poci	teapot.
pocok	(java) fill a certain position temporarily.
pocokan	/poco'an/ fill-in.
pocong	(java) wrap in a shroud. pocong-an (java) shroud.
podak	see pudak.
podeng	/poding/ pudding.
pof	puffed (of sleeves).
pohbor	see popor.
pohon	1. 1) tree. 2) origin, cause. 2. see mohon.
pojok	1 corner. 2 k.o. newpaper column containing pithy comments on the news.
pojokan	street corner.
pok	see mpok.
pokal	ruse.
pokat	see advokat 2.
poket	(mil.) pocket of uniform.
pokok	1 main, principal, basic, fundamental, base. 2 beginning. 3 capital, stake. 4 subject. 5 reason, central theme. 7 main or lower part of s.t.
pokrol	atorney, lawyer.
pokrol-prokrolan	pettifoggery.
pol	1. 1) complete, fully done. 2) to the fullest extent. 3) filled up. 2. see volt.
pola	1 pattern. 2 system, model of how s.t. is done.
polah	polah-tingkah behavior.
polan	mr. so-and-so, mr. what's-his-name.
polandia	poland.
polang-paling	whirl.
polang-poleng	checkered or camouflage pattern.
polantas	[polisi lau lintas] traffic police.
polarisasi	polarization.
polas-poles	paint, smear s.t.
poldan	1 paid up. 2 finished ! all done ! (in card games, etc.).
polemik	polemic.
poleng	see polang-poleng.
polenter	volunteer.
poles	polish.
polgas	at full speed.
poli	[poliklinik] polyclinic.
poliandri	polyandry.
poligami	polygamy.
poligamis	polygamist.
poligon	polygon.
poliklinik	polyclinic.
polio	1. polio. 2. see folio.
polip	(med.) polyp.
polis	(insurance) policy.
polisi	policeman.
polisionil	having to do with the police.
politeis	polytheist.
politeisme	polytheism.
politeknik	polytechnic.
politik	1 politics, political. 2 policy.
politikus	politican.
politis	political.
politisasi	politicization.
politisi	politicians.
politur	see pelitur.
polmah	(leg.) power of attorney.
polo	(sports) polo.
polok	swallow, bolt down.
polong	1. ghost evil spirit. 2. pod. polong-polong-an legumes of various sorts.
polongan	outlet, drainpipe.
polos	1 smooth. 2 plain (material, paper, etc.). 3 straightforward, without guile.
polowijo	see palawija.
polri	[polisi republik indonesia] indonesian police.
polsus	[polisi khusus] special police.
polsuska	[polisi khusus kereta api] railway police.
polusi	pollution.
polutan	pollutant.
polwan	[polisi wanita] policewoman.
polwil	[polisi wilayah] local police.
pom	[polisi militer] military police.
pomade	pomade.
pombensin	gas station.
pomg	[persatuan orang tua murid dan guru] parent-teacher's association.
pompa	pump.
pompanisasi	provision of water pumps in an area.
pompen	push-ups.
pompong	see kepompong.
pon	[pekan olahraga nasional] national games.
ponakan	see keponakan.
ponco	poncho.
pondamen.	see fondamen.
pondik	arrogant, conceited.
pondoh	edible pith of coconut palm trunk.
pondok	1 cottage, hut, cabin. 2 (islam) muslim boarding school. pondok-an lodgings, rooming house.
pondong	carry in o.'s arms.
ponem	see fonem.
pongah	conceited, stuck up.
ponggang	see siponggang.
ponggawa	see punggawa.
pongo	(java) be open-mouthed from surprise or bewilderment.
poni	bangs.
ponim	see fonem.
ponis	see vonis.
ponok	camel's hump.
ponokawan	see punakawan.
pontang-panting	run helter skelter, in any direction.
ponten	1 marks, grades. 2 points in a game. /ponte`n/ 1 fountain. 2 public bath and toilet.
ponton	pontoon.
ponyard	dagger used by naval cadets.
pop	pop culture.
popi	doll.
popok	diaper.
popokan	ghost. see momok.
popor	rifle butt.
popularitas	popularity.
populasi	population (in a study).
populer	popular.
populis	of popular culture.
popure	(china) talisman.
pora	see pedang, pesta.
porak-poranda	/porak-parik, porak-peranda/ a mess, in disorder.
pordeo	see prodeo.
porek	see porok.
pori	pore.
porkas	[pekan olahraga untuk kesejahteraan sosial] weekly lottery based on soccer scores.
pormil	see formil.
pormulir	see formulir.
porno	pornography.
porok	fork.
poros	axis, pivot, shaft.
porot	1 gnaw at, bite into. 2 steal.
porsekot	see persekot.
porselen	china, porcelain.
porsi	portion.
porstel	proposal, suggestion.
portal	gate (blocking entrance, r.r. crossing, etc.).
portepel	portfolio.
portir	1 ticket collector at gate. 2 porter.
porto	cost of sending s.t. porto-udara air freight costs. bebas-porto sent free of postage.
portret	see potret.
portuges	portuguese.
pos	1 mail. 2 item, entry. 3 post, situation.
pose	pose (in photo).
posing	see pusing.
posisi	position.
