nambor	(coll.) name-plaque.
namnam	k.o. fruit-bearing tree.
nampak	visible, evident. nampak-nya apparently.
nampan	tray.
namun	yet, however.
nan	(lit.) which, a particle between a noun and its modifying adjective.
nanah	suppuration, pus.
nanak-nunuk	(java) slow-moving (person), slowpoke.
nanap	1 with wide-open eyes. 2 amazed.
nanar	1 confused. 2 angry.
nanas	pineapple.
nanda	see anakanda.
nang-ning-nong	sound of metallic resonance (e.g. gamelan, bell, etc.).
nangka	jackfruit.
nangkir	(islam) o. of the two angels that observe and record o.'s deeds.
nangkring	see tangkring.
nanti	1 wait. 2 later, presently. 3 presently at (such-and-such a time), to(night), this (noon, afternoon, etc.). 4 next, it might happen that (so watch out).
nantiasa	see senantiasa.
nanyang	/nan-yang/ the overseas chinese, esp. of s.e. asia.
napal	k.o. clay (eaten for medicinal purposes).
napas	1 roan (of horses). 2. see nafas.
napekah	see nafkah.
napi	1. [narapidana] inmate, prisoner. 2. see nafi.
napoli	naples.
napsi	see nafsi.
napsu	see nafsu.
naqli	(islam) reference to relevant citation from koran.
naradakwa	accused, defendant.
naraka	see neraka.
narapidana	1 convict, prisoner, prison inmate. 2 (leg.) convicted criminal.
narapraja	gvt. official.
narasumber	resource person, informant.
narayana	1 a boyhood name of kresna. 2 (lit.) (time) of o.'s youth.
narkose	narcotics.
narkotika	narcotics.
narsisisme	narcissism.
narwastu	spikenard oil.
nas	(islam) authoritative quotation (from the koran).
nasab	1 lineage, descent (in the male line). 2 (family) tie.
nasabah	1 customer, client. 2 relationship.
nasakh	abrogated.
nasakom	[nasionalisme, agama, komunisme] "nationalism, religion, communism," political concept in sukarno era.
nasar	1 vulture. 2 see penasaran.
nasarani	see nasrani.
nasehat	see nasihat.
nasgitel	[panas legi kentel] (sl.) hot, sweet, and syrupy.
nasi	1. 1) cooked rice. 2) a meal (of rice). 2. see natie.
nasib	fate, destiny.
nasihat	advice, admonition.
nasion	nation.
nasional	national.
nasionalis	nationalist, nationalistic.
nasionalisasi	nationalization.
nasionalisir	me-nasionalisir nationalize.
nasionalisme	nationalism.
nasip	see nasib.
naskah	1 manuscript. 2 document, original text.
nasofaring	(anat.) nasopharynx.
nasrani	1 christian. 2 (lit.) portuguese, of portuguese creole descent.
natal	christmas. natal-an christmas celebration.
natalitas	birth rate.
natang	(lit.) small window, opening.
natar	basic color, background.
natie	/nasi/ (lit.) nation.
natijah	(lit.) core issue (of argument, etc.).
natirlek	(coll.) of course, naturally.
nato	[naskah asli ditetapkan oleh] (leg.) certified to be a true copy by.
natura	in kind.
naturalisasi	naturalization.
naturalisme	naturalism.
naturel	neutral-colored shoe polish.
naudu-billahi	/nauzu-billahi, naudzu-billahi/ (islam) i find protection in god, god bless us, god forbid that i should ever do it ! (uttered when hearing of a despicable act or fact).
naung	1 shadow, shade. 2 shelter, protection.
nautik	nautical.
nautika	nautical science.
nautis	nautical.
navigasi	navigation.
navigator	navigator.
nayaga	see niyaga.
nayuban	see tayub.
nazam	poem, composition.
nazar	1. (rel.) vow (to do s.t. if prayer is gratted). 2. eagle.
nazir	see nadir.
ndableg	/ndablek/ (java) 1 stubborn. 2 thick skinned.
ndak	1 (coll.) no, not. 2. see hendak.
ndang-ndut	see dang dang dut.
ndoro	(java) master, term of address for a member of the aristocracy.
ndoroisme	feudal attitude.
nduk	(java) see genduk.
ndut-ndutan	(coll.) pulsate, throb (with pain, etc.).
ne	(china) term address for o.'s mother.
nebeng	(jakarta) 1 sponge off s.o. 2 hitchhike.
necis	(coll.) neat, well groomed.
nederlan	/nederland/ the netherlands.
nefo,nefos	[new emerging forces] newly independent countries (sukarno-era term).
neg.	1. [negeri] country. 2 [negara] nation, state.
negara	state. tamu-negara state guest. negara-berkembang developing country. negara-hukum constitutional state. negara-terbelakang underdeveloped state.
negarawan	statesman.
negasi	negation.
negatif	/negatip/ negative.
neger	/neher/ (coll.) negro, a black (esp. in colonial period).
negeri	1 country, land. 2 (m, e. indonesia) village. 3 state-owned, state-run.
negosiasi	negotiation.
neher	see neger.
nek	1. 1) too rich (foods). 2) indigestion due to greasy foods. 2. see enek. /ne`k/ see nenek.
neka	see aneka.
nekad	see nekat.
nekar	marbles.
nekara	(lit.) kettledrum.
nekat	determined, to do s.t. no matter what, ready to take serious risks.
nekel	see nikel.
neko-neko	(java) 1 all k.o. things. 2 do diverse things unnecessarily.
nekolim	[neokolonialisme, kolonialisme, imperialisme] neocolonialism, colonialism, imperialism (sukarno-era term).
nekrologi	necrology.
nelangsa	(java) arousing pity.
nelayan	fisherman.
nelongso	pathetic.
nem	see enam.
nempil	(java) buy s.t. from a place of business that does not normally sell that item, e.g. buy (uncooked) rice from a food stall.
nemplok	1. position o.s. 2. 1) lean on. 2) depend.
nemu	see temu 2.
nen	see nan.
nenas	see nanas.
nenda	see nenekanda.
nenek	1 grandmother, great-aunt. 2 (in some regions) grandfather, great-uncle. 3 respectful term of reference and address (esp. as nek) for elderly persons (esp. women) and, in some areas, dangerous wild animals, e.g. tigers, etc.
nenekanda	/nenenda/ grandmother (esp. in letters).
nener	young milkfish.
neng	(jakarta, sunda) polite form of address to younger woman.
neng-nong	sound of metallic ringing (e.g. railway crossing bells, gamelan, etc.).
neo	neo-. neo-kolonialisme neocolonialim.
neolitis	neolithic.
neologisme	neologism.
neon	fluorescent or neon light.
neonisasi	provision of flourescent lamps for street lights.
nepotisme	nepotism.
neraca	1 pair of scales. 2 balance.
neraka	1 hell. 2 destruction, misfortune.
nerawang	translucent, lacy.
nerimo	(java) passive, acquiescent to o.'s fate.
nerocos	see crocos.
nesan	see nisan.
nestapa	sorrow, grief.
net	1. clear, precise. 2 (sport) net.
netral	1 neutral. 2 uncommitted, nonaligned.
netralis	neutralist.
netralisasi	neutralization.
netralisir	neutralize.
netralisme	neutralism.
netralitas	/netralitet/ neutrality.
netron	see neutron.
netto	(fin.) net.
neurolog	(med.) /nerolokh/ neurologist.
neurologi	(med.) /nerologi, nerolokhi/ neurology.
neutron	/netron/ neutron.
neven	ancillary (of an organization).
ng-	see also entries with k-.
ngabehi,ngabei	(java) title of nobility.
ngaben	(bali) cremation.
ngablak	open wide.
ngabrukin	(jakarta) slam or set s.t. down with a crash.
ngabuburit	(sunda) seek amusement and distractions while waiting for day's fast to end.
ngacau	see kacau.
ngaceng	(coll.) 1 be erect. 2 have an erection.
ngacir	1. flee, run away. 2. (coll.) 1) in disarray. 2) helter-skelter.
ngaco	1. (coll.) talk at random, talk without knowing what o. is talking about. 2. see kacau.
ngadak-ngadak	make a fuss.
ngadat	1. break down, sulk, go wrong. 2. 1) make a fuss, cry and be naughty. 2) not run properly (of car).
ngahari	see gahari.
ngai	(china) i.
ngak-ngik-ngok	/ngak-ngik-nguk/ 1 sound of cacophonic music. 2 low grade music (esp. pop music).
ngakak	boisterous laughter.
ngalor-ngidul	(java) in all directions, without direction.
ngambek	pout, mope.
ngambreng	have a pervasive odor.
ngambul	(java) sulk.
ngamen	1 beg while singing playing musical instruments or reciting prayers. 2 be persistent (like a singing beggar).
ngana	(coll., menado, n. maluku) you (singular).
nganga	agape.
ngangeni	see kangen.
ngangut	mumble to o.s.
ngantek	1. (java) until. 2. (coll.) be a lackey.
ngantuk	see kantuk.
ngap-ngap	gasp for breath, pant.
ngapa	(coll.) see mengapa.
ngarai	(m) chasm, gorge.
ngarep	see harap.
ngarit	see arit.
ngarsa-dalem	/ngarso dalem/ (java) the sultan (of yogya).
ngarti	(jakarta, sunda) understand, comprehend.
ngaung	sound of s.t. resonating (airplane, etc.).
ngawur	do s.t. haphazardly or without basis.
ngayau	see kayau 1,2.
nge-	see also entries with e-. or the root alone.
ngeak	sound of a baby crying.
ngebet	(coll.) want s.t. intensely, desire s.t. very stroungly
ngebluk	see kebluk.
ngebodoin	(jakarta) see bodo 2.
ngeden	(java, jakarta) strain during bowel movement.
ngedumel	grumble, complain under o.'s breath.
ngek-ngek	sickly.
ngel-	see also entries ngl-, l-.
ngelantur	1 stray (from a path). 2 digress.
ngelayap	(jakarta) wander around.
ngelayat	make a visit of condolence.
ngeledek	(jakarta) tease.
ngelendot	hang on to (arm, sarong edge, etc., e.g. a child hanging on to his mother).
ngelesot	(java) sit on the ground or floor.
ngelindur	(java, jakarta) talk in o.'s sleep.
ngelmu	esoteric knowledge.
ngeloneng	see loneng.
ngelotok	(jakarta) burst open (of fruit).
ngeloyor	1 (jakarta) slither. 2 (coll.) leave without saying goodbye.
ngelu	(java) have a headache.
ngeluyur	1 loaf around, stroll about without purpose. 2 hang around.
ngemong	see emong.
ngemut	see kemut 2.
ngenes	(java) deeply saddened.
ngengap	gasp for breath, pant.
ngengat	moth.
ngenger	(java) live with s.o. (esp. relatives) and do chores in return for room and board.
ngengkel	see engkel.
ngentit	(coll.) shortchange s.o. cheat s.o.
ngentot	see entot.
ngenyek	see enyek.
ngeong	meow.
ngepas	1 try clothes on. 2 fit (of clothes). 3 be just enough.
ngepiah	see piah.
ngepot	see kepot 1.
ngepres	1 tight (of clothing). 2 urgent.
nger-	see also entries r-.
ngeram	see eram.
ngeran	see keran 4.
ngereh	(java) boss around.
ngerem	see rem.
ngeres	1 (java) unpleasant or irritating sensation due to sand or dust (of sand in o.'s sheets, dust in o.'s eyes, etc.). 2 (coll.) touching, sad.
ngeri	1 horrified. 2 horrifying.
ngerokok	smoke s.t.
nges	(java) very agreeable.
ngeslong	see slong.
ngetem	wait for sufficient numbers (of passengers).
ngeteng	see keteng.
ngetop	be on top.
ngetrek	1 operate a public vehicle along such a route. 2 drive a vehicle very fast.
nggak	(coll.) no, not.
ngglenggem	see glenggem 2.
nggreges	see greges.
nggrengseng	see grengseng.
ngiang	sound of whining or steady humming.
ngiau	meow.
ngibrit	(coll.) run out of a place.
ngibul	tell a lie.
ngicip	see icip.
ngijo	see ijo 1.
ngik-ngik	1 sound of squeaking or screeching (e.g. asthmatic wheezing, violin screeching, etc.). 2 suffer from asthma.
ngikik	see kikih.
ngiler	see iler.
ngilu	pain, smart.
ngincer	see incar.
ngiprit	(sunda) marry a beautiful woman who is in reality a supernatural snake that can make her husband rich.
ngirab	see kirab 2.
ngiung-ngiung	1 sound of a siren, etc. 2 motorcade.
ngl-	see also with kl-, l-.
nglomprot	be sloppy.
nglunjak	insolent, impertinent.
ngluyur	see keluyur.
ngo	(china) i.
ngobrol	see obrol.
ngoceh	talk nonsense.
ngocok	(coll.) 1 shake, mix, rub. 2 masturbate.
ngok	(jakarta, sl.) loud smacking kiss.
ngoko	(java) speech level of java used among intimates or when speaking to certain people of lower status.
ngolor	see kolor.
ngomel	see omel.
ngomong	see omong.
ngompol	wet the bed or o.'s pants.
ngompoli	make s.t. wet by urinating in it.
ngompyang	grumble angrily (continuously).
ngoni	(coll., menado, n. maluku) you (plural).
ngorok	snore.
ngos-ngosan	(coll.) gasp and pant.
ngot-ngotan	1 unpredictable. 2 furious.
ngotot	see otot 2.
ngowos	(coll.) 1 leak (of a tire). 2 talk nonsense.
ngoyo	(java) exert o.s.
ngrasani	(java) backbite, gossip about.
ngreh	(java) look down on.
ngrewes	(java) tidak-ngrewes indifferent.
ngublak-ngublek	(java) turn upside down to find s.t.
ngubleg-ngubleg	(java) pester s.o.
ngudang	(java) coo, talk babytalk.
nguing-nguing	sound of siren.
nguler	wormlike.
ngunduh	see unduh.
ngungu	sound of repeated sobbing, choking etc.
ngupil	1 pick o.'s nose. 2 form scab on a wound.
ngurek	1 (java) gnaw. 2 (coll.) be inguisitive.
ngut-ngut	(lit.) nervous movement of mouth, twitch.
ngutngit	gnawing.
ni	(bali) respectful title for women. 2. (china) you. 3 see nih.
niaga	commerce, trade.
niagawan	trader.
nian	very, really.
niat	intention, plan, aim. berniat intend.
nibung	k.o. palm, the nibong.
nica	/nika/ [netherlands indies civil administration] postwar adminitrative system imposed by the dutch in occupied territories.
nifas	1 childbirth, porturition. 2 (islam) the 40-day period after childbirth during which sexual intercourse is forbidden.
nigong	dental plaque, film adhering to teeth.
nih	1 particle pointing to s.t. nearby. 2 see ini.
nihil	nothing, nil.
nihilis	nihilist.
nihilisme	nihilism.
nihilistis	nihilistic.
nik	see noni.
nikah	1 marriage, wedding. 2 marry.
nikel	nickel (metal).
nikmat	1 comfort, luxury. 2 deeply enjoyable, pleasant. 3 (islam) grace.
nikotin	nicotine.
nil	nile.
nila	blue dye, indigo.
nilai	1 price, value. 2 school grades. 3 percentage, ptoportion. 4 moral value.
nilakandi	1 sapphire. 2 sapphire blue, azure.
nilam	1. k.o. shrub yielding fragrant oil, patchouli. 2. see batu. 3. see burung.
nilem	see nilam 1.
nilep	take s.t. on the sly.
nilon	nyilon.
nimbrung	(coll.) join on in conversation where o. is not wanted, butt into discussion.
ninabobo	/ninabobok/ lullaby.
ning	see neng.
ning-neng	/ning-nong/ sound of jiggling such as horse drawn carriage, etc.
ningrat	nobility, aristocracy.
ningratisme	feudal way of thingking and behaving.
nini	see nenek.
ninik	(china) term of address for liitle girl.
ninik-mamak	(m) village elders.
ninitowok	/ninitowong/ (java) 1 k.o. spirit possession involving figure made of coconut shell. 2 such a figure of coconut shell.
nip	[nomor induk pegawai] 1 official registry number of civil servants. 2 letter of appointment for civil servant
nipah	thatch palm, nipa palm.
nipis	1. see tipis 1. 2. see jeruk.
nipon	(coll.) japan.
nir	1. (coll.) kidney. 2. (lit.) not, non.
nira	sap obtained by tapping inflorescences of various palms used to make sugar.
nirair	anhydrous.
nirakal	insensible.
nirarti	meaningless.
nirasa	apathy.
nirbangun	amorphous.
nirbau	odorless.
nirbhaya	without danger.
nirgelar	nondegree.
nirhawa	without air.
nirlaras	disharmonious.
nirleka	prehistoric.
nirmala	clean, pure.
nirmana	mode.
niru	1. see tiru. 2. see nyiru.
nirwana	nirvana.
nirwarna	colorless.
nisan	gravestone.
nisbah	1 family name, name descriptive of origin or relationship. 2 (fin.) ratio.
nisbi	/nisbiah/ relative, proportionate.
niscaya	certainly, surely.
niskala	abstract, immaterial.
nista	1 insult, abuse. 2 stigma. 3 insulted, humiliated.
nitis	1 ( java) become incarnate. 2 (coll.) descend into o.'s offspring (of traits, etc.)
nitrat	(chem.) nitrate.
niugini	see papua nugini.
nivo	the level of s.t.
niyaga	/niyogo/ (java) performers in gamelan orchestra.
njelirit	(java) form a thin line, like a thin line.
njlimet	see jelimet.
nkk	[normalisasi kehidupan kampus] a gvt. measure to reduce student militancy in late 1970's.
nn.	[nona] miss.
no	(china, jakarta) two, in commercial transactions. no-ban 20,000. no-cap twenty. no-ceng 2,000.
noban	see no.
nobat	royal drum used at installation ceremonies.
nocap,noceng	see no.
noda	1 stain, spot of dirt. 2 shame, disgrace.
nodul	/nodule/ (med.) nodule.
nojos	(jakarta) perforate, pierce.
nok	see denok.
noktah	1 dot, poiunt. 2 period (of punctuation)
nol	nought, zero.
nomade	/nomaden/ nomad, nomadic.
nombor	see nomer.
nomenklatur	nomenclature.
nomer	1 number. 2 issue (of a periodical). 3 number in a musical show.
nominal	nominal (in statistics, research, mathematics).
nomor	see nomer.
nompang	see tumpang.
nomplok	(coll.) be s.w. in large quantities.
non	1. (pol.) noncooperative. 2. nun. 3. see noni.
non-aliansi	nonalliance.
non-eksakta	(acad.) pertaining to humanities and social sciences rather than exact sciences
non-formal	/non-formil/ 1 outside the regular system, irregular. 2 (coll.) informal.
nona	1 miss, unmarried european, china, or westernized well-to-do indonesian girl in western dress. 2 term of address for such women. 3 (ambon) unmarried woman.
nonaktif	inactive, laid-off.
none	(jakarta) see nona.
nongkrong	1 (coll.) squat. 2 (coll.) sit around doing nothing , hang out. 3 idle, not in use.
nongol	(jakarta) stick the head out, appear, be conspicious.
noni	/nonik/ (coll.) 1 young girl, esp. european or in european clothes. 2 affectionate term of address for such a girl, esp as nik or non.
nonius	(tech.) vernier.
nonok	(jakarta, vulg.) vagina.
nonpribumi	of foreign descent, nonnative (esp. referring to ethnic chinese).
nonsen	nonsene, ridiculous.
nonton	see tonton.
nonya	see nyonya.
noot	/not/ see not.
nopember	november.
nopol	[nomor polisi] vehicle registration number.
nora	/norak/ (jakarta) tacky, in bad taste, vulgar, lower than normal.
norit	general term for carbon-based medicine for stomach problems.
norma	norm, standard.
normal	normal.
normalisasi	normalization.
norotos	sound of firecrackers.
norwegia	norway.
nostalgi	/nostalgia/ nostalgia.
nostalgis	nostalgic.
not	musical note.
nota	1 note. 2 statement of account, bill. 3 memorandum.
nota-bene	nota bene.
notariat	office of notary.
notariil	notarial.
notaris	notary public.
notasi	notation.
notes	small notebook, notepad.
notifikasi	notification.
notilen	minute, notes (of a meeting).
notok	1. (java) to the very end. 2. see tutuk.
notulen	see notilen.
notulis	recorder of the minutes of a meeting.
novel	novel.
novela	novella.
novelis	novelist.
novis	novice.
novisiat	novitiate.
nr.	[nomor] number.
nri	[negara republik indonesia] republic of indonesia.
nrimo	see nerimo.
nrp	[nomer registrasi pokok] soldier's registration number.
ntar	(coll.) see sebentar.
ntb	[nusa tenggara barat] western lesser sundas.
ntr	[nikah, talak, rujuk] be married, divorced, and recorciled.
ntt	[nusa tenggara timur] east lesser sundas.
nu	[nahdlatul ulama] association of muslim scholars, a muslim political party of the 1970s.
nuansa	nuance.
nubuat	(rel., islam) prophecy, divine revelation.
nudis	nudist.
nudisme	nudism.
nuduh	see tuduh.
nuftah	(biol.) germ, sperm.
nugat	nougat.
nugini	see papua nugini.
nuh	(bib.) noah.
nujum	fortune-telling, esp. with stars.
nukhter	objective, balanced (of views, etc.).
nukil	1 quotation, quote. 2 excerpt.
nuklir	(phys.) nuchlear.
nul	see nol.
numpang	see tumpang.
numplek	1 pour out, empty all at o. time. 2 be splled out, be in a huge crowd in a place.
nun	(lit.) younder.
nunak-nunuk	(coll.) 1slow in doing s.t. 2 snoop around.
nuntius	papal nuncio.
nunut	(java) ride along with.
nur	(lit.) light, ray of light.
nuraga	sympathy.
nurani	1 lustrous, illuminated. 2 pure. 3 inner.
nurbisa	(lit.) antidote, esp. charm or incantation against venom.
nuri	k.o. parrot.
nurmala	see nirmala.
nus	k.o. flat-headed squid.
nusa	island, esp. in island names.
nusakambangan	a penal island off the s. coast of java.
nusantara	1 archipelago. 2 the indonesian archipelago.
nusra	[nusa tenggara] the lesser sundas.
nusrabar	[nusa tenggara barat] western lesser sundas.
nusrateng	[nusa tenggara tengah] central lesser sundas.
nusratim	[nusa tenggara timur] east lesser sundas.
nusteng	[nusa tenggara] the lesser sundas.
nusus	/nusyur/ (islam) disobedient (of wives, esp. with regard to granting of conjugal rights).
nutrisi	nutrition.
nutrisionis	nutritionist.
nuzulul-qur'an	(islam) day commemorating descent of the koran.
nv	[naamloze vennootschap] inc., ltd.
ny-	see also entries with s-, c-.
ny.	[nyonya] mrs.
nya	see nyonya.
nyabun	see sabun 1.
nyadran	see sadran.
nyah	1 see enyah. 2. see nyonya.
nyaho	(jakarta) 1 know, understand. 2 find out the hard way.
nyai	1 term of reference and address for concubine of european or china in colonial period. 2 (java) respectful term of address to older woman.
nyak	1. (jakarta) term of address and reference for o.'s mother. 2. see nyonya.
nyala	flame.
nyalang	clear (of vision).
nyalangwadi	(java) arousing suspicion, having s.t. secret about it.
nyale	see salai.
nyali	1 gall, bile. 2 guts, daring o. shows in a crisis situation.
nyaman	pleasant, comfortable.
nyambi	see sambi.
nyamikan	/nyamii'an/ 1 (java) sweet anacks, candy. 2 (coll.) mistress.
nyampang	in case, just in case, by chace.1 supposing that, if 2 (lit.) although.
nyampoh	k.o. tree.
nyamuk	mosquito. nyamuk-pers newspaper reporter.
nyana	expect, presume, think.
nyandu	see candu.
nyang	(coll.) see yang 1.
nyangkut	nyangkut
nyanyah	(java) me-nyanyah chew.
nyanyi	sing.
nyap-nyap	(jakarta) angry.
nyaring	1 high-pitched, piercing. 2 (ling.) sonorant.
nyaris	nearly (of s.t. unpleasant).
nyaru	disguised.
nyasar	see sasar.
nyata	1 obvious, evident. 2 real, tangible.
nyatut	see catut.
nyawa	life-sustaining principle, soul.
nyawang	(java) look.
nyekar	see sekar.
nyelang	see nyalang 1, selang 1.
nyelekit	(java) offensive, tending to hurt o.'s feeling.
nyelonong	see selonong.
nyemek-nyemek	become soggy.
nyemplak	go to a prostitute.
nyengir	turn up o.'s nose, make a wry face (due to s.t. distasteful).
nyengir-nyengir	see cengir.
nyeni	see seni 1.
nyentrik	1 eccentric, act in such a way that o. stands out as different. 2 (coll.) stick out, be different from every o. else.
nyenyai	loosely woven.
nyenyak	be sound (of sleep).
nyenyeh	(java) suppurating, not healing well (of wound).
nyenyep	very quiet.
nyepi	1. last day of balinese calendar, when no work is done. 2. see sepi.
nyepor	see sepur.
nyepret	see cepret.
nyepur	(coll.) go by train.
nyeri	painful, sharp (pain).
nyerimpung	see serimpung.
nyerocos	see crocos.
nyetek	see setek.
nyi	(java) respectful title for women.
nyilu	see ngilu.
nyinyir	talkative, fond of chatting.
nyiplak	see ciplak 1.
nyiru	k.o. flat basket.
nyiur	(lit.) coconut.
nylentik	see slentik.
nylon	see nilon.
nyok	(jakarta) see ayo.
nyolnyolan	(coll.) unladylike (of coarse, mannish behavior).
nyolok	see colok 2.
nyolong	see colong.
nyolot	be blazing with anger.
nyong	1 (ambon) young man. 2 (ambon) polite term of address for males younger than speaker. 3 (jakarta) term of address among intimate male friends.
nyontek	cheat on exams.
nyonya	1 mrs. (esp. of non-indonesian, i.e. china, foreigners). 2 lady. 3 (coll.) wife. 4 term of address (esp. as nya or nyah) for china and western women.
nyora	(e. indonesia) term of polite address for certain women of high status (e.g. minister's wife, etc.).
nyrempet	see serempet.
nyruput	sip noisily, slurp.
nyungsep	fall or slip down in mud headfirst.
nyureng	see cureng.
nyut	sensation of stabbing pain.
nyutnyut	(java) be soggy (of s.t. that was crisp.).
o	1. the 15th letter of the alphabet. 2. 1) oh, interjection expressing surprise. 2) oh that, interjection expressing perception or remembering. 3) interjection expressing strong emotional feeling. 3. (lit.) oh, vocative marker.
o.	[otomat] (tel.) dial telephone.
oase	oasis.
obah	see ubah.
oban	see uban.
obar	see kobar.
obat	1 medicine, potion. 2 toiletry. 3 chemical preparation (e.g. cleaner, repellent, etc.). 4 gunpowder.
obeng	screwdriver. obeng-belimbing/bintang/kembang philips screwdriver.
oberal	see obral.
obituari	obituary.
oblak	1 (java, jakarta) spacious. 2 loose, not firm.
oblek	(jakarta) tremble.
obligasi	(fin.) debenture, bond.
oblok-oblok	1 dish consisting of leftovers or vegetables mixed with spices. 2 (coll.) offspring of an interethnic marriage.
oblong	see kaos 1.
obor	1 torch. 2 (lit.) guide.
obrak-abrik	1 destroy, ruin. 2 upset, tip over, turn upside down.
obral	1 clearance sale. 2 do s.t. without prior consideration, be quick to do s.t.
obralan	sale items.
obras	machine hemming.
obrol	chat.
obros	(coll.) lieutenant colonel.
observasi	observation.
observatorium	(astr.) observatory.
obsesi	obsession.
obstetri	(med.) obstetrics.
obstetrikus	(med.) obstetrician.
obyek	1. 1) object, thing. 2) (ling.) object. 3) object, aim. 2. earning on the side, moonlighting.
obyekan	sideline business, a deal.
obyektif	1 objective, unbiased. 2 objective, goal.
obyektivisme	objectivism.
obyektivitas	objectivity.
oc.	1. [opus citatum] op. cit. 2. [organizing committee].
ocak-ocak	(java) choke.
oceanografi	see oseanografi.
oceanologi	see oseonologi.
oceh	babble, talk nonsense.
ocehan	twaddle, gossip.
odalan	(bali) temple festival.
odeklonyo	see odoklonyo.
odiensi	see audiensi.
oditir	(coll.) see oditur.
oditur	(mil. leg.) military prosecuting attorney, judge advocate.
oditurat	the office of the military prosecutor.
odoh	1 ugly. 2 very stupid.
odok	(coll., jakarta) take s.t. out from inside.
odoklonyo	cologne.
odol	(coll.) toothpaste.
ofensi	(mil.) offensive attack.
ofensif	/offensif/ 1 offensive (of behavior). 2 (mil.) offensive attack.
oferte	(coll.) offer.
ofisial	(sport) an official.
ofisiil	official, formal.
ogah	1. (java, jakarta) be averse to. 2. meng-ogah shake s.t. to loosen it.
ogak-ogak	(lit.) jester.
ogal-agil	unsteady, shaky.
ogal-ogalan	see ugal-ugalan.
oh	see o 2.
oha	[orang hukuman] convict, prisoner.
ohm	(elect.) ohm.
oi!	1 hey there ! (interjection to call o.'s attention). 2 interjection to express astonishment or recognition.
oja	/ojah/ encourage, incite, egg on.
ojeg	/ojek/ motorcycle or bicycle used for public transport.
ojo	(java) do not. ojo-ngoyo ! take it easy, do not work hard !.
ojok	(coll.) make s.o. do s.t. bad.
ok	/oke/ ok.
okb	[orang kaya baru] nouveau-riche.
okd	[organisasi keamanan desa] village security organization (in the 1960s.).
oke	see ok.
oker	ocher.
okey	see ok.
okm	[orang kaya mendadak] nouveau-rich.
oknum	1 a person in a certain capacity, esp. with negative connotation. 2 (rel., lit.) person (of god).
okol	(coll.) arm-wrestling.
oksid	/oksida/ (chem.) oxide.
oksidasi	(chem.) oxidation.
oksigen	(chem.) oxygen.
oktaf	octace.
oktan	octane.
oktober	october.
oktroi	(leg.) 1 patent rights. 2 sole agency or manufacturer rights.
okulasi	grafting.
okuler	/okulir/ ocular.
okulis	oculist.
okultisme	occultism.
okupasi	1 (lit.) job. 2 illegal occupation of land.
olah	1. 1) manner, way of doing things. 2) trick. 2. olah-data data processing.
olahan	1) fickle. 2) whim, caprice.
olahraga	1 sport. 2 physical exercise.
olahragawan	sportsman, athlete.
olahragawati	female athlete.
olak	circulation of surface water. olak-an whirling, eddying, turning.
olanda	(lit.) the netherlands, dutch.
old-and-new	/ol en nu/ (coll.) ber-old-and-new celebrate new year's eve with a party.
oldcrack	/olkrek/ (coll.) experienced (of old timer).
oldefo	[old established forces] w. capitalist powers (sukarno-era phrase).
oleh	1. 1) because of. 2) by (means or agency). 2. oleh-oleh gift brought back from a trip.
oleng	1 shaky. 2 having a strong roll (of ship).
oles	meng-oles spread s.t. oily on, lubricate. oles-an a smear.
oli	oil, esp. lubricating oil.
olibol	k.o. filled doughnut.
olie	see oli.
oligarki	oligarchy.
oligarkis	oligarchic.
oliman	(coll.) person in charge of hibricating (on a ship, in a factory, etc.).
olimpiade	(sport) olympiad.
olimpik	(sport) olympic.
olok	/olok-olok/ 1 joke, funny remark. 2 ridicule.
olympiade	see olimpiade.
om	1. 1)(coll.) term of address and reference for western and westernized men, older than the speaker. 2) uncle, term of reference and address in westernized families and in certain regions. 2. (elec.) ohm.
oma	1 (coll.) term of address and reference for grandmother. 2 (coll.) grandmother, term of reference and address in westernized families and in certain regions. 3 (in some regions only) great-aunt.
ombak	wave.
ombang-ambing	bob up and down, oscillate.
ombyok	(java) bunch.
ombyokan	(coll.) 1 those belonging to a clique, party, etc. 2 commonplace.
omel	grumble and complain.
omelan	gripe, griping.
omong	1 way of talking. 2 talk, say.
ompol	(coll.) urine expelled in bed or in o.'s pants.
ompong	toothless (of mouths, combs, saw, etc.).
ompreng	1. k.o. small basket made of bamboo. 2. operate office or gvt. vehicles for personal profit.
omprengan	unregistered public transportation.
omprong	smoke.
omprongan	(coll.) lamp chimney.
ompu	honorary title among the batak.
omset	turnover (in commercial enterprise).
omslag	/omslah, omslakh/ cover (of magazine).
omzet	see omset.
on	1) 100 grams. 2) ounce.
onak	curved thorn.
onani	masturbation.
onar	noisy sensation, stir.
oncar	(java) irrigate.
oncek	(java) peel, shell.
oncom	fermanted cake made from soybean sediment.
oncor	(java) torch.
onde-onde	/ondeh-ondeh/ k.o. round fried cake made of rice flour filled with sweetened ground mung beans sprinkled with sesame seeds.
ondel-ondel	(jakarta) giant puppets used in parades.
onderdil	spare parts.
onderdistrik	subdistrict (in colonial area).
onderneming	estate (esp. in colonial era).
onderok	slip or other k.o. skirtlike undergarment.
ondo	(java) ladder.
ondok	hide.
oneng-oneng	remote descendants.
onggok	heaps, stacks, piles.
ongkang-ongkang	1 (java) sit with legs dangling. 2 (coll.) do nothing.
ongklok	pierced.
ongkok	(m) meng-ongkok-ongkok walk with a stoop.
ongkos	cost, expenses, charges.
ongol-ongol	k.o. cake made of tapioca.
onh	[ongkos naik haji] expenses for pilgrimage to mecca.
onkol	/onkolen/ decarbonize.
ons	see on.
onslah	(coll.) dismissal from a job.
onta	see unta.
ontang-anting	(java) only child.
ontologi	ontology.
ontong	(java) the whole banana flower including petals.
ontslag	/onstslah/ see onslah.
onyah-anyih	(java) dally, dawdle.
oom	see om 1.
op	[otomat pemerintah] gvt. telephone dialing system.
opa	1 (coll.) term of address and reference for westernized men same age as o.'s grandfather. 2 (coll.) grandfather, term of reference and address in westernized families and in certain regions. 3 (in some regions only) great-uncle.
opah	see upah.
opak	k.o. fried crispy chip made from a roll of steamed rice or cassava.
opal	1. opal. 2. (naut.) tack.
opas	see upas 2.
opelet	k.o. small urban bus or jitney.
open	1. (java, jakarta) attentive, careful. 2. see oven.
openkap	1 (auto.) convertible car. 2 (auto.) convertible with the top down. 3 (coll.) scantily dressed, esp. having a low neckline.
oper	1 transfer. 2 (auto.) shift gears.
opera	1 opera. 2 (coll.) musical drama.
operasi	1 operation, campaign, action. 2 (med.) surgical operation.
operasional	operational.
operasionalisasi	process of making s.t. operational.
operasionil	see operasional.
operatif	/operatip/ 1 protocol, set of instructions. 2 operative, come into effect.
operator	operator.
operbelas	overloaded.
operet	operetta.
opini	opinion.
opisil	see ofisiil.
oplag	/oplah, oplak, oplakh/ 1 circulation (of periodical). 2 total printing (of book).
oplet	see opelet.
opm	[organisasi papua merdeka] free papua organization, secessionist movement of w. new guinea.
opnaisel	tuck (in sewing).
opname	1. 1) photograhic shot. 2) shooting. 2. hospitalization, be hospitalized. 3. see stock.
oponen	(sport) opponent.
opor	meat or chicken dish cooked with coconut cream and various spices.
oportunis	1 opportunist. 2 opportunistic.
oposan	o. who opposes s.t.
oposisi	opposition.
opr	[organisasi pertahanan rakyat] civil defense.
opset	1.typesetting. 2. (sport) off-sides. 3. meng-opset stuff (animals).
opseter	1. typesetter. 2 supervisor.
opsi	option.
opsihter	see opseter 2.
opsinder	/opsiner/ supervisor on plantations, schools, etc. in colonial period, as term of address often siner.
opsir	(mil.) officer.
opspek	[orientasi program dan pengenalan kampus] university student's orientation.
opstib	[operasi tertib] anticorruption operation. meng-opstib-kan bring order by cracking down on graft.
opsus	[operasi khusus] special intelligence operation of the military.
optik	/optika/ optics.
optimal	best, optimum.
optimis	optimist, optimistic.
optimisme	optimism.
optimistis	optimistic.
optimum	optimum.
optimumisasi	optimizing.
opyok	(jakarta) apply s.t. wet to the head.
opzhicter	see opseter 2.
or	[olah raga] sports.
orak	1. uncoil, unfold. 2. (jakarta) 1) shake s.t. violently. 2) bring s.t. to disorder.
orak-arik	(java) stir-fried cabbage with eggs.
orang	1. 1) person. 2) follower, assistant. 3) one, s.o., an indefinite other party. 4) people in general. 5) numeral clasifier for humans. 6) (ling.) person. 2. (coll., java) 1 because. 2 what are you (they) talking about ! (exclamation of disagreement).
orang-oranganmata	(anat.) pupil of the eye.
oranye-krus	orange soda pop.
orasi	oration.
oratoris	oratorical.
oratorium	reflective gathering with poetry reading, prayers, etc. to commemorate or protest s.t.
orba	[orde baru]sosiopolotical order in indonesia since 1965.
orbit	orbit.
orde	1. sociopolitical or economic system. 2. /,order/ 1 order. 2 forced labor (colonial period).
ordinat	[math] the y cartesian coordinate.
ordner	ring binder.
ordo	1 catholic order. 2 (biol.) order.
ordonan	/ordonans/ (mil.) orderly.
ordonansi	/ordonnansi/ decree, ordinance.
orek-orek	/oret-oret/ (java, coll.) 1 doodling, graffity. 2 doodle.
org.	[orang] person.
organa	organ (musical instrument).
organik	organic.
organis	1. organic. 2 organist.
organisasi	organization.
organisator	organizer.
organisatoris	organizational.
organisir	organize.
organisma	/organisme/ organism.
organsa	k.o. fabric, organdy.
orgel	organ (musical instrument).
orhiba	[olahraga hidup baru] k.o. aerobics.
ori	k.o. bamboo.
orientalis	orientalist.
orientasi	orientation.
orijinal	/orisinal, orisinil/ 1 original. 2 the original (copy) of s.t.
orkeb	[organisasi kebudayaan] cultural organization.
orkes	musical group.
orkestra	orchestra (of classical music).
orla	[orde lama] sociopolitical order during sukarno era.
orloji	see arloji.
orlon	a synthetic fabric, orlon.
ormas	[organisasi massa] mass organization.
ornamen	1 ornament. 2 jewelry.
ornitologi	ornithology.
oro-oro	1. k.o. legume. 2. (java) large, empty field.
orok	1. (jakarta, sunda, java) newborn baby. 2. (jakarta) 1 snort, drone. 2 snore.
orok-orok	k.o. sweetmeat made of steamed cassava.
orong	see urung.
orong-orong	(java) k.o. insect, mole cricket.
orpol	[organisasi politik] political organization.
ortodoks	orthodox.
ortodonsi	orthodontics.
ortodonti	orthodontia.
ortografi	orthography.
ortopedi	(med.) orthopedics.
oseania	oceania.
oseanografi	oceanography.
oseanologi	oceanology.
oseng-oseng	stir-fried with chili peppers.
osilasi	oscillation.
osio	see wesio.
osmosa	/osmose/ osmosis.
ot	[orang tahanan] detained person.
otak	brain.
otak-atik	tinker with s.t.
otak-otak	snack made of seafood steamed in banana leaves.
otak-otakan	otak-otakan
otarki	see autarki.
ote	see ot.
ote-ote	k.o. fritter filled with meat or seafood.
otek	1. (java, jakarta) loose, esp. of teeth. 2. see ikan.
oteng-oteng	(jakarta) k.o. insect.
otentik	authentic.
otentikasi	authentication.
otentisitas	authenticity.
oto	1. automotive vehicle, car. 2. cloth binder wrapped around infant's stomach and chest fastened by strings.
otobiografi	see autobiografi.
otobis	(lit.) bus.
otodidak	autodidact, self-taught person.
otokrasi	autocracy.
otokratis	autocratic.
otokratisme	autocratism.
otokritik	self-criticism
otomat	(tel.) automatic dialing.
otomatis	1 automatic. 2 automatically, of its own.
otomatisasi	automation.
otomobil	automobile.
otomotif	automotive (industry).
otonom	autonomous.
otonomi	autonomy.
otopet	toy scooter.
otopsi	see autopsi.
otorisasi	authorization.
otorita	/otoritas/authority.
otoriter	1 authoritative. 2 authoritarian.
otot	1. 1) muscle. 2) tendon, sinew. ber-otot strong, very muscled. 2. (me)ng-otot 1) persevere, persist. 2) be obstinate, stubborn.
oval	oval.
oven	(coll.) oven. meng-oven bake in an oven.
overlaping	/overleping/ overlapping authority.
overste	/obros/ (coll.) lieutenant colonel.
ovulasi	(biol.) ovulation.
owe	(china) 1 i, me (used by men only). 2 yes (used by men in affirmative answers).
oyak	1. (m) shake s.t. loose. 2. (java) chase after.
oyek	(java) k.o. dish made from cassava.
oyok	see oyak 2.
oyong	k.o. squashlike vegetable.
oyot-oyotan	(java) various k.o. roots.
ozon	ozone.
p	the 16th letter of the alphabet.
p'cis.	[perancis] france.
p.	1. [pulau] (geog.) island. 2. [pangeran] prince.
p3	see ppp.
p4	1. [panitia penyelesaian perselisihan perburuhan] labor dispute arbitration committee. 2. [pedoman penghayatan dan pengamalan pancasila] guidelines for carrying out the principles of pancasila.
pa	[port authority] the port area as a place of work (e.g. tanjung priok in jakarta).
paal	act, deed.
pabean	customs office.
paberik	see pabrik.
pabian	see pabean.
pabila	see apabila.
pabrik	factory. pabrik-an manufacturer.
pacai	sandalwood dust.
pacak	1. roasting spit. 2. mate (of animals). 3. skilled, experienced.
pacal	slave.
pacang	affiance.
pacangan	1 fiance, fiancee. 2 partner (boy or girl).
pacar	(coll.) fiance or fiancee, boyfriend or girlfriend.
pacaran	1 go put with members of opposite sex. 2 be boy and girlfriends. 3 engage. in sexual play.
pacat	leech.
pace	(java) the mengkudu tree and its fruit.
pacek	see pacak 2.
paceklik	1 famine. 2 time of scarcity before harvest. 3 lack of s.t. important.
pacet	see pacat.
pacinko	k.o. gambling game in japan.
pacomberan	see comberan.
pacu	spur. pacu-jantung heart pacemaker. race.
pacuk	see patuk.
pacul	1. hoe. 2. squeeze or press out.
pada	1.1) at or to (person or instituation), have a feeling toward. 2) in the direction of to or on, from the surface, tip or edge of. 3) at, in (an abstract place). 4 at (a certain time). 5 preposition preceding complement of instransitive verb or noun.
padah	omen, warning.
padahal	1 whereas, but actually the case is. 2 besides.
padahan	unfortunate result, just deserts.
padam	1 extinguished. 2 calmed, suppressed, quenched.
padan	1. equal ,match.
padanan	1) parable. 2) comparison. 2. border, frontier. 3. promise. 4 dishonest (in gambling).
padang	plain, field.
padas	rock or a layer of hardened soil.
padasan	cistern, vat.
padat	1 solid, compact. 2 dense.
padepokan	see depok.
paderi	1 (rel.) catholic priest. 2 islam purists from w. sumatra in the early 19th century.
padi	1 rice plant, unhusked rice. 2 tiny, very small. padi-an grain.
padma	lotus.
