menang	1 win, come out on top. 2 pass an examination.
menangani	1 handle, take in hand (job, problem, etc.). 2 strike with the hand.
menanggali	1 strip s.o. or s.t. 2 strip s.t. off.
menanggalkan	1. 1) strip off, take off. 2) pull out. 2. date.
menanggam	dovetail s.t.
menanggang	restrain o.'s appetites.
menanggap	1. 1) listen carefully. 2) note attentively. 2. hire a performer.
menanggapi	receive, perceive.
menangguhkan	postpone, delay s.t., put off.
menangguk	fish with such a net or scoop.
menanggul	build a dike, embankment.
menanggulangi	ward off, cope with.
menanggung	1 carry on o.'s shoulders. 2 bear s.t. (emotion, duty, etc.). 3 guarantee, assume liability for.
menanggungkan	1 bear. 2 be responsible for s.t.
menangis	weep.
menangisi	weep over, bemoan.
menangkal	avoid, ward off a (catastrophe).
menangkap	1 catch. 2 seize, arrest. 3 comprehend, grasp.
menangkapi	1 arrest repeatedly. 2 seize or arrest a large number of people.
menangkapkan	capture on behalf of.
menangkis	1 ward off parry. 2 repulse, repel.
menangkisi	parry or repulse several things.
menangkring	1 (coll.) sir, sir high where easily visible.
menangkul	fish with a net.
menangkup	1 close (of two sides uniting). 2 fall face downward.
menangkupkan	lay s.t. face down.
menangsel	(coll.) 1 wedge s.t. 2 insert s.t.
menanjak	1 slope upward. 2 ascend, climb.
menanjakan	1 cause s.t. to slope upward. 2 bring s.t. upward.
menanjul	snare s.t. with such a noose.
menanjung	1 look like a cape. 2 sail along the cape.
menantang	challenge.
menanti	wait.
menanti-nanti	1 wait a long time. 2 look forward to.
menantikan	1 wait for. 2 watch for.
menantu	son-or daughter-in-law.
menanya	1 (coll.) ask. 2 ask for a woman's hand in marriage.
menanyai	repeatedly question, interrogate.
menanyakan	ask about s.t.
menapai	1 become fermented. 2 ferment s.t.
menapak	1 measure with the palm of the hand or sole of the foot. 2 step, tread on. 3 follow in the footsteps of, do same thing s.o. else did.
menapaki	follow in the footsteps of.
menapakkan	set (foot) down.
menapal	1. apply a poultice or plaster. 2. make horseshoes.
menapis	1 filter s.t. 2 sort through s.t. 3 censor s.t.
menaplaki	cover s.t. with a tablecloth.
menapuk	(java) slap.
menara	tower,minaret.
menarafkan	1 evaluate, grade s.t. 2 give the rank of.
menarah	plane s.t. smooth.
menari	dance, esp. non-western dances..
menari-nari	jump (with joy), dance up and down.
menarik	1 draw, pull. 2 draw out, extract. 3 drive. 4 collect. 5 attractive, interesting.
menarik-narik	1 repeatedly drag, pull. 2implicate s.o.
menarikan	dance s.t., dance a certain k.o. dance.
menariki	pull repeatedly on.
menarikkan	draw or pull for s.o.
menaruh	1 put, place. 2 maintain..
menaruhi	1 put s.t. on s.t. 2 bet on s.t.
menaruhkan	1 place, put. 2 bet.
menasak	stanch bleeding.
menat	see minat.
menata	put in order, organize.
menatah	inlay s.t.
menatang	carry in outstretched palm of hands.
menatap	observe intently.
menatapi	examine s.t. closely.
menatar	upgrade s.t.
menatih	1 teach s.o. to walk by holding his hands. 2 give support with the hand to s.o. walking.
menatu	see penatu.
menawaki	(lit.) throw stone at.
menawan	1 capture in war. 2 subdue. 3 intern, imprison.
menawar	1. weaken (strength or effectiveness of s.t.). 2. 1) bargain. 2) offer a price for s.t.
menawari	1. 1) make magic or venom ineffective by using spells, charms, potions, etc. 2) seduce, tempt. 3) pacify, calm down. 2. 1) offer to s.o. 2) repeatedly bargain.
menawarkan	1. make (magic, etc.) ineffective. 2. offer s.o. or s.t. (for sale, use, in marriage, etc.).
menayang	1 carry s.t. resting on o.'s palms. 2 (lit.) carry, waft.
menayangkan	(lit.) present.
menayub	dance with a professional dancer in k.o. traditional dance.
menc-	see also entries with c-.
mencabik	1 rip s.t. 2 lacerate.
mencacah	1 chop s.t. into fine bits, mince (meat, etc.). 2 chop up food for animals.
mencaci	1 scorn, jeer at, ridicule. 2 curse out, swear at.
mencak	mencak-mencak 1 be out of sorts. 2 move convulsively.
mencanai	1 sharpen, polish (on grindstone). 2 make even (with ruler). 3 smooth (the way).
mencang-mencong	not in a straight line, contorted.
mencangkul	be engaged in hoeing, prepare (ground) for cultivation.
mencantelkan	put s.t. on a hook.
mencapit	snap at, bite (of crabs).
mencarah	1 cut into small bits. 2 sell piecemeal.
mencarak	1. swallow in a gulp (such as sucking a raw egg, pouring water down o.'s throat, etc.). 2. begin to be visible (e.g., rising sun).
mencatat	1 make a note of, record. 2 register, chalk up.
mencawiskan	prepare.
mencegah	1 restrain, prevent, prohibit. 2 combat, guard against.
mencekal	1 hold firmly, grasp tightly, seize. 2 arrest, capture.
mencekoki	1 force s.o. or s.t. to take medicine. 2 indoctrinate.
mencelanai	put trousers on s.o. or s.t.
mencelur	1 boil (an egg). 2 scald (a chicken to remove feather).
menceng	slanted, skewed.
menceret	see ceret.
mencereweti	1 criticize, find fault with. 2 order about.
mencicit	squeak (of mouse, etc.). 2) tweet (of canary).
mencipta	1 compose. 2 be creative.
mencit	mouse.
mencium	1 kiss. 2 smell, sniff. 3 sense, learn about.
mencla-mencle	(java) inconsistent, unreliable.
menclok	(java) perch (of birds).
mencok	see menclok.
mencomot	1) seizy, nab, grab and hold. 2) snatch off. 3) pick.
mencong	1 askew, aslant. 2 without any specific direction or aim.
mencopot	1 take off, remove (shoes, etc.). 2 pull out, extract (a nail). 3 untie. 4 remove, take away.
mencorong	1) shine, glare. 2) radiate.
mencos	(jakarta) miss a target, fail, not be in a straight line.
mencret	see ceret.
mencuaikan	1 neglect. 2 look down on, hold in contempt. 3 ignore.
mencuat , cuar	1) be flipped, pushed away with a springy motion. 2) spring back. 3) bend outward to project in a point.
mencurahi	1 pour on. 2 bestow upon, shower. 3 expend.
mend-	see also entries with d-.
mendadak	see dadak.
mendagri	[menteri dalam negerei] minister for internal affairs.
mendak	1 sink down, bow down. 2 approach bowing.
mendam	drunk.
mendampak	bump into, collid with.
mendap	1 sink, settle. 2 sediment, deposit.
mende	see mente.
mendedeli	rip out (a seam, etc.).
mendepak	1) kick (ball, etc.). 2) fire, dismiss, kick out, expel s.o.
mendera	banyan tree.
menderum	kneel (of elephant, camel, etc.).
mendesak	1 push, shove. 2 urge, insist.
mendestruksi	destroy.
mendesuskan	spread s.t. as gossip.
mendewakan	1 deify. 2 idolize s.o.
mendiang	the late.
mendieselkan	change (bus engines, etc.). to diesel fuel.
mendikai	small watermelon.
mendikbud	[menteri pendidikan dan kebudayaan] minister of education and culture.
mendikte	1 dictate to s.o. 2 command s.o.
mending	1 fairly good, well off, mild (of climate). 2 average, middling.
mendingan	1 fairing well, well off. 2 average, middling. 3 better, preferable.
mendisketkan	store on a disc.
mendobrak	1 batter down, break in. 2 (mil.) penetrate (defenses).
mendodosi	1 dig s.t. up. 2 (coll.) steal little by little.
mendonan	immigrant, stranger.
mendongengkan	narrate (stories, etc.).
mendongkel	1 lift up, pry loose. 2 remove by force, oust s.o. 3 reveal (secrets).
mendongkrak	1 jack up (car, etc.). 2 assist s.o. in achieving his purpose. 3 praise, esp. in sycophantic manner.
mendreng	see mindering.
mendudu	follow s.o., continue on (without looking back).
mendudut	(java) pull, tug at.
menduga	1 (naut.) take depth bearings. 2 understand, fathom. 3 presume, expect.
mendung	cloudy, overcast.
mendusel	(java) snuggle up close.
mendusin	1 be awake. 2 be conscious of, realize.
mendut	k.o. cake made of sticky rice with grated coconut and brown sugar wrapped in banana leaves.
menebah	strike a flat surface.
menebak	1. guess. 2. chop off, cut off.
menebal	become thick.
menebalkan	1 thicken s.t. 2 reinforce.
menebang	fell.
menebangi	repeatedly chop down.
menebari	scatter in or on s.t.
menebarkan	1 spread around, disperse. 2 spread and throw s.t. out.
menebas	1. cut down (shrubs, vegetation, etc. but not large trees). 2. 1) buy up a harvest's yield before it has been harvested. 2) (java) buy up all of s.t. produced.
menebaskan	1. cut with s.t., use s.t. to cut down. 2. contract to sell o.'s harvest while it is still in the fields.
menebat	create a pond with dam.
menebeng	1. 1) put up temporary screen (mat, sail, etc.). 2) spread out cloth, mats, etc. for display. 2. sponge s.t., freeload, ride or live with (for free).
menebengi	protect or screen s.t.
menebengkan	allow or arrange for s.o. to live for free, mooch, etc.
menebok	firmly strike with fist.
menebuk	1 perforate s.t. 2 bore through s.t.
menebus	1 redeem s.t. by paying cash or exchanging some other object. 2 compensate for some wrong. 3 fulfill.
meneduh	1 be shady. 2 become calm.
meneduhi	provide shade or shelter for.
meneduhkan	1 calm s.o. down. 2 make s.t. sheltered or shaded.
meneer	meneer
menegahkan	forbit, prevent s.t.
menegak	become upright.
menegakkan	1 erect, build. 2 cause s.t. to be upright. 3 maintain.
menegang	tighten, become tight, be tight, tense.
menegangkan	1 tighten, make taut. 2 strain, make tense.
menegarkan	stiffen s.t.
menegaskan	1 explain, clarify. 2 assert, insist.
menegel	cover with floor tiles.
meneguhkan	1 confirm s.t. 2 strengthen s.t.
meneguk	swallow s.t., gulp down.
meneguki	repeatedly swallow or gulp s.t.
menegur	1 address s.o. (in order to open a conversation). 2 admonish, reprimand.
menejer	manager.
menekadkan	make (a decision, o.s.) resolute.
menekak	stick to the palate.
menekan	1 press, push down. 2 suppress, repress, oppress. 3 compress.
menekankan	1 stress, emphasize s.t. 2 press with s.t.
menekat	embroider s.t.
menekel	manage, handle.
meneken	sign s.t.
meneker	light a fire with a flint.
menekuk	fold s.t. stiff.
menekukkan	fold s.t., bend s.t. over.
menekuni	occupy o.s. diligently with s.t.
menekur	1 bend, bow. 2 meditate.
menekuri	1 stare at. 2 bend, bow o.'s hed over s.t.
meneladan	follow the example of.
meneladani	set an example of hisbrilliant sister.
meneladankan	make s.t. an example, provide a model.
menelahkan	predict.
menelan	1 swallow. 2 swallow up. 3. endure patienly (insults, etc.) 4 require, consume.
menelanjangi	1 strip s.o. or s.t. 2 strip s.o. of.
menelap	1 cause injury (by sharp weapons). 2 (phys.) permeate.
menelateni	persevere in s.t.
meneledorkan	neglect s.t.
menelegram	send a telegram.
menelekkan	rest a part of the body s.w.
menelempap	measure with o.'s hand.
menelengi	cause s.t. to slope at an angle.
menelengkan	cause s.t. to be at an angle.
menelepon	phone s.o.
meneleponkan	phone on s.o.'s behalf.
menelikung	bind hand and foot, wrap s.t. up entirely.
meneliti	1 examine carefully. 2 research s.t.
meneluk	curve around, be curved.
menelumpang	overlap
menelungkup	lie face downward.
menelungkupi	lie face downward on s.t.
menelungkupkan	place s.t. face downward.
menelurkan	produce s.t. as if laying an egg (s.t. new, s.t. dropped, etc.).
menelusur	1 unravel s.t. 2 investigate, explore.
menelusuri	1 go along, follow. 2 trace, follow. 3 research, investigate.
menelutut	kneel.
menemani	accompany s.o.
menembaga	become copper-colored.
menembak	1 fire a gun. 2 aim at, intend. 3 (sport) shoot (a basket), make a goal, etc.
menembaki	repeatedly fire on s.t.
menembakkan	1 shoot with s.t. 2 shoot s.t. out.
menembangkan	sing or recite (a tembang).
menembok	1. wall s.t. up. 2. cover batik with wax to resist dye.
menembung	hit with a cudgel.
menembus	1 pierce, stab. 2 penetrate, break through. 3 emerge, come out.
menembusi	penetrate s.t.
menembuskan	pierce with s.t.
menempa	make metal objects, manufacture knives, etc.
menempahkan	1 book ahead of time. 2 make to order.
menempati	occupy.
menempatkan	put s.t. in a certain place.
menempekan	1 make s.t. into this foodstuff. 2 consider s.t. trivial or low grade.
menempel	1 adhere, cling. 2 (coll.) patch. 3 (coll.) be right up next to.
menempelak	reproach s.o.
menempelengi	slap s.o. on the face or side of the head.
menempeli	1 stick to, make s.t. stick to. 2 sponge, freeload on s.t. 3 cover s.t. by sticking materials. 4 (sl.) bribe.
menempelkan	stick s.t. on.
menempias	1 splash up. 2 splash on s.t.
menempiaskan	splash s.t. onto.
menemplek	attached to, hanging on or against.
menemplok	1 lean on. 2 depend.
menempuh	1 attack, assail. 2 go through, endure by passing through. 3 take on, take up.
menempuhkan	make s.o. responsible for s.t.
menempur	attack, assail.
menemui	1 go to meet s.o. 2 come upon, run into. 3 experience s.t. (us. unpleasant).
menemukan	1 find, meet with. 2 find, discover.
menenangkan	calm s.o. down.
menendang	1 kick. 2 (coll.) expel s.o.
menendas	decapitate.
menengadah	look up.
menengadahi	look up at s.t.
menengadahkan	cause s.t. to face upward.
menengah	1 move to the center. 2 middle, intermediate. 3 average. 4 be neutral. 5 intecede, mediate.
menengahi	1 intercede, mediate. 2 intervene.
menengahkan	come between.
menenggala	plow.
menenggang	restrain.
menenggek	to squat.
menenggelamkan	1 cause s.t. to sink. 2 make s.t. disappear.
menengkari	fight over s.t.
menengok	1 view s.t. 2 visit. 3 look. 4 make predictions.
menengoki	repeatedly look at or visit.
menengokkan	turn o.'s head to look.
menentang	1 gaze directly at. 2 facing toward. 3 oppose. 4 defy.
menentangi	repeatedly oppose.
menentangkan	1 bring o.s. face to face with. 2 cause s.o. to face.
menenteng	carry in o.'s hand, while walking.
menentir	1 give s.o. a tutorial or preliminary exam. 2 (sl.) educate.
menentu	certain, stabilized.
menentukan	1 determine, establish. 2 make certain about s.t.
menenungkan	1 tell fortunes. 2 bewitch s.o.
menepak	slap slightly. menepak-air-didulang, terpercik-muka-sendiri. slapping a tray full of water will only get your own face splashed.
menepati	1 head straight for s.t. 2 fulfill. menepati-janji fulfill a promise.
menepatkan	1 aim, direct. 2 set, adjust.
menepi	1 move to o. side. 2 go along the side of (road, etc.).
menepikan	move s.t. to o. side, pull s.t. over.
menepis	1. 1) skim, glid low. 2) skim s.t. 2. ward off s.t.
menepuk	clap, slap.
menepung	1 pound into flour. 2 powdery.
menepungkan	make s.t. into flour.
menera	1 seal s.t. 2 calibrate. 3 print s.t.
menerabas	1 take a shortcut, bypass. 2 (coll.) bypass red tape or other obstacles by bribing.
menerakan	1 calibrate. 2 stamp, seal, imprint s.t.
menerang	dawn, become light.
menerangi	1 light s.t. 2 remove undergrowth.
menerangkan	1 explain, clarify. 2 declare, state. 3 illuminate s.t. 4 indicate.
menerap	1. adjust, apply, arrange. 2. do inlaid work.
menerapkan	apply.
menerawang	1. make holes (in s.t.). 2. muse, be lost in thought, he gazed at the valley.
menerawangi	cause s.o. to be lost in thought, trouble o.
menerbangi	fly over.
menerbangkan	1 cause s.t. to fly, blow s.t. away. 2 flee with s.t.
menerbitkan	1 cause, produce. 2 publish. 3 put in print.
meneriaki	shout at s.o.
meneriakkan	1 yell out s.t. 2 show off.
menerima	1 accept, approve. 2 receive. 3 (coll., java) be passive.
menerimakan	hand s.t. over.
menerjang	lunge, attack.
menerjangi	trample on.
menerjangkan	lunge at with.
menerjuni	1 jump in(to) 2 occupy o.s. with s.t.
menerjunkan	cause s.t. to dive downward.
menerka	guess, surmise.
menerkam	pounce on.
menerkup	fall on s.t.
menerobos	1 break through. 2 cut in a line or queue (at a bank, etc.).
menerompetkan	proclaim loudly.
meneropong	1 look through a telescop. 2 observe carefully, study, scrutinize.
meneropongi	examine carefully, focus carefully on s.t.
menerpa	1 (lit.) jump at (often in anger or passion). 2 attack (of meteorological phenomenon).
meneruskan	1 continue. 2 forward, pass (on).
menetakkan	1 hack at s.t. 2 hack with s.t.
menetal	be compact, compressed.
menetalkan	compact s.t.
menetap	1. 1) settle at, maintain a permanent residence at. 2) stabilize. 2. (lit.) blot up a liquid (ink, water, etc.).
menetapi	1 fulfill. 2 carry out.
menetapkan	1 decide, determine. 2 maintain, establish, secure. 3 determine.
menetas	1 crack or slit s.t. open by force from the interior.
menetaskan	1 cause s.t. to break out. 2 hatch s.t.
menetek	suckle.
meneteki	give suck to, breast-feed.
menetekkan	have s.o. else breast-feed a baby.
menetes	drip.
menetesi	srinkle on s.t.
meneteskan	expel a liquid drop by drop.
menetralisir	neutralize.
menewaskan	1 defeat, overcome. 2 kill, slay.
meng-	see also entries with k-, ng- or beginning with a vowel.
mengaba-abakan	give orders (for drill, etc.).
mengabadikan	1 immortalize, record for posterity. 2 perpetuate.
mengabaikan	1 ignore, disregard. 2 underestimate, minimize. 3 make light of, belinttle.
mengabar	1 brake. 2 impede, hinder. 3 remove. 4 lessen.
mengabari	inform, let s.o. know.
mengabarkan	report s.t.
mengabdi	serve.
mengabdikan	subjugate, make subservient.
mengabenkan	cremate.
mengabolisikan	abolish.
mengabonemenkan	subscribe for s.o.
mengabortus	abort (a fetus).
mengabsahkan	1 endorse, approve. 2 legalize.
mengabstrakkan	shorten.
mengabstraksikan	make abstract.
mengacak-acak	1 mess up, put in disorder. 2 disturb, upset, confuse.
mengacarakan	1 place on the agenda. 2 bring up with (a judge, etc.).
mengacau	1 stir (a drink, paint, etc.). 2 stir up trouble.
mengacaukan	1 mix, stir s.t. up throroughly. 2 make s.t. confusing. 3 stir up trouble.
mengacu	1. 1) point. 2) refer. 2. shape, mold, cut (cookies). 3.. 1) ponder a way to achieve a purpose. 2) strike a threatening pose (with gun, knife).
mengacuhkan	heed, care about, be concerned about.
mengacukan	1. 1) point at with s.t. 2) threaten (with a weapon). 3) refer. 2. advocate, suggest, propose.
mengacung	point upward.
mengacungkan	1 hold up (the hand to greet or answer). 2 point s.t.
mengada-ada	invent, fabricate, concoct (stories).
mengada-adakan	say what is not true or does not exist.
mengadakan	1 organize, arrange. 2 give, hold, deliver (a lecture). 3 create, make. 4 launch. 5 cause, bring about (a catastrophe, etc.). 6 establish (boundaries), bring about, effect (a consolidation).
mengadaptasi	adapt.
mengadili	1 hear, try (a case). 2 administer justice. 3 bring to justice.
mengadu	1. 1) pit. 2) bump, hit (o.'s head). 3) contest. 2. 1) complain about. 2) sue, bring legal action. 3) inform, squeal, tell on, report.
mengadukan	complain about.
mengageni	1 distribute. 2 handle, manage.
mengagung-agungkan	indulge in glorification.
mengagungkan	1 glorify, exalt, elevate. 2 praise.
mengahadkan	unite in marriage.
mengairi	1 irrigate (rice field). 2 dilute with water. 3 give to drink.
mengais	carry on the back.
mengajaibkan	amazing, miraculous.
mengajak	1 invite, ask. 2 urge. 3 challenge, invite.
mengajar	1 teach (a subject). 2 teach s.o. 3 give s.o. a lesson be will not forget. 4 train, coach.
mengajarkan	1 teach s.t. 2 lecture, rebuke.
mengajukan	1 file, submit (a protest). 2 file, submit. 3 send, submit, present. 4 set forward, propose, put a motion. 5 indict, remand. 6 lodge, enter (a complaint).
mengakadkan	enter into an agreement, fix contractually.
mengakali	1 seek a way. 2 deceive, double-cross.
mengakalkan	endeavor, seek a way, work s.t. out.
mengakhiri	end, close.
mengakrabkan	bring close, strengthen (friendships, etc.).
mengaktifkan	activate.
mengaktualisasikan	/mengaktualisir/ bring up to date, actualize.
mengaku	1 confess, admit. 2 guarantee, promise. 3 claim to be. 4 consider as o.'s own. 5 always talk about o.'s., boast about o.'s.
mengakui	1 acknowledge, admit. 2 confess, admit. 3 recognize, acknowledge.
mengakurkan	1 reconcile. 2 check. 3 harmonize (colors, etc.).
mengalami	experience.
mengalap	1 pick (fruit). 2 abduct.
mengalasi	1 cover. 2 lay a base or foundation for.
mengalaskan	1 put s.t. down as a base (cloth, rug, etc.). 2 base (o.'s complaint, accusation).
mengalih	change, replace s.t. with s.t. else.
mengalihbahasakan	translate.
mengalihkan	shift, move s.t.
mengalir	1. 1) flow. 2) pour, stream, flow (of money, people). 3) stream down. 2. catch crocodiles (with a baited line).
mengaliri	flow through.
mengalirkan	1 channel. 2 siphon. 3 shed (tears). 4 aim, point.
mengalun	1 pitch, heave. 2 be in steady, rhythmic movement.
mengalunkan	put s.t. in steady motion.
mengamahi	/mengamanati/ deliver a speech, give advice.
mengamalkan	1 put into practice, apply. 2 do s.t. regularly. 3 carry out with devotion.
mengamanahkan	1 entrust, commit. 2 instruct, order. 3 dedicate, set aside.
mengamankan	1 pacify, render safe. 2 place in protective custody, hold in custody. 3 hand over for safekeeping. 4 reassure. 5 prosecute.
mengamat-amati	1 watch closely, keep track of. 2 inspect. 3 monitor, guard.
mengambil	1 take. 2 get, fetch. 3 subtract. 4 adopt (a child, a policy).
mengambili	keep taking.
mengambilkan	get or fetch for s.o.
mengambul	1 bounce, rebound, ricochet. 2 bob up and down.
mengambulkan	bounce (a ball).
mengampai	1 hang on, over. 2 hang out s.t. to dry (e.g. tobacco). 3 hit, strike.
mengampuni	1 forgive s.o. 2 pardon, commute (a sentence).
mengampunkan	1 forgive s.t. 2 condone.
mengamputasi	amputate.
mengamuk	1 go berserk, run amuck. 2 rage violently.
menganalisa	analyze.
mengancaikan	wreck, damage.
mengancam	threaten.
mengancamkan	1 threaten with s.t. 2 threatening.
mengandaikan	suppose, assume.
mengandalkan	1 rely on. 2 trade on.
mengandung	1.be pregnant with 2.have wtihin it , contains.
menganeksasi	annex, appropriate, take possession of.
menganga	1 be agape be wide open. 2 gape, gawk.
mengangah	1 have fiery coals. 2 see api.
mengangan-angankan	1 recall, ponder, contemplate. 2 imagine, fantasize.
menganggap	1. regard as, consider, deem. 2. (lit.) nod the head to invite another to join in dancing or drinking.
mengangguk	nod (in agreement).
mengangguk-angguk	keep nodding.
menganggukkan	1 nod (the head). 2 agree to.
menganggur	1. 1) be unemployed, be idle. 2) lie idle. 2. 1) prepare cutting for planting. 2) transplant, plant with a slip.
menganggut	1 nod due to drowsiness. 2 move erractically, pitch (of a ship).
mengangkasa	1 be airbone. 2 soar, take off. 3 come to the fore.
mengangkat	1 lift (up), raise. 2 appoint, designate. 3 promote. 4 remove, take away. 5 take up. 6 adopt (a child), adapt (written material). 7 nab, pick up.
mengangkati	remove (many things).
mengangkatkan	1 lift up, raise. 2 roll up (o,'s sleeves).
mengangkut	1 carry, transport. 2 carry away. 3 contain.
mengangkuti	pick up, collect.
mengangon	(java) graze cattle.
mengangsu	(java) 1 draw water. 2 absorb, draw upon. 3 gain knowledge.
mengangsur	1 do gradually. 2 pay in installments. 3 move.
mengangsuri	pay for s.t. installments.
mengangsurkan	1 order s.o. to move. 2 pay s.t. in installments. 3 move forward.
mengangut	1 nap, doze. 2 fritter o.'s time away.
menganiayai	1 maltreat, torture, beat viciously. 2 tyrannize, persecute.
menganjak	transplant, reset (plants).
menganjal	1 bounce, rebound. 2 elastic, springy, resilient.
menganjur	1. 1) stick out, jut out, protrude. 2) move on or toward. 2. withdraw.
menganjuri	1 lead, head (a parade). 2 pioneer, take the initiative.
menganjurkan	1 suggest, propose, recommend. 2 extend, project, thrust s.t. out. 3 hand over, pass.
mengantar	1 deliver, bring s.t. 2 carry, transmit.
mengantarai	1 come or be between. 2 intercede, mediate.
mengantari	bring or send to s.o.
mengantarkan	1 accompany, bring s.o. to a destination. 2 see off. 3 introduce.
mengantep	(java) 1 trust, believe in. 2 be faithful to. 3 let, permit.
menganting	1 dangle, sway. 2 swing.
mengantisipasi	anticipate.
mengantukkan	bump or strike s.t. against.
mengantul	bounce, rebound (of a ball.).
mengantup	sting.
menganugerahi	bestow on s.o.
menganugerahkan	bestow, confer (a degree), present a gift to s.o.
menganuti	1 follow, submit to. 2 practice, profess (a religion).
menganyam	plait.
mengap	gape. mengap-mengap pant, gasp for breath.
mengapa	1 why ? 2 doing what ?
mengapam	make or make s.t. into apam.
mengapel	1appeal, enter an appeal. 2 take roll.
mengapit	1 flank. 2 press between s.t., clamp. 3 hold by pressing between. 4 staple (paper together). 5 enclose on either side.
mengapkir	1 reject (because of poor quality). 2 condemn (a building). 3 prohibit, ban.
mengaplikasikan	apply, put to use, administer.
mengaplos	relieve.
mengaplus	applaud.
mengapresiasi	appreciate, relish, enjoy.
mengapung	1float. 2 float upward, soar.
mengapungi	hover about, float about.
mengapungkan	set or keep afloat (of a canoe, toy boat, etc.).
mengarah	1 aim, direct. 2 aim at. 3 manage, direct, administer. 4 head for.
mengarahkan	1 direct, aim, point. 2 make efforts in a certain direction. 3 give directions or instructions, direct.
mengarak	accompany in a procession.
mengarang	1 string (beads, jewels), arrange (flowers).
mengarangkan	1 arrange, string s.t. 2 write or compose for s.o.
mengarcakan	cast into a statue, make a likeness.
mengarit	cut grass.
mengartikan	1 interpret, construe. 2 bear a meaning for, lead o. to understand.
mengarung	wade across, cross.
mengarungi	1 cross s.t. 2 sail through s.t. 3 ford, wade across. 4 wade through, plod through (o.'s studies, work).
mengasah	1 sharpen. 2 file (teeth). 3 polish, shine, burnish (a gem). 4 grind, whet, hone. 5 plane (a board).
mengatakan	say s.t. , say that...
mengatur	1 put in order, straighten up. 2 regulate, organize. 3 arrange, settle. 4 string, thread.
mengaturkan	1 offer, give (used on solemn occasions or to s.o. of higher authority). 2 say, express to a person of high status.
mengayun	household furnishings.
mengecat	see cat.
mengecer	sell retail.
mengeja	spell.
mengeksitkan	expel, dismiss.
mengelabui	deceive s.o.
mengelap	wipe s.t. with a cloth.
mengelola	1 manage (a business, etc.). 2 carry out, execute (a job, etc.).
mengeluarkan	1 take or put outside. 2 expel, eject, remove, discharge (an employee). 3 issue (an order, a ticket), publish (a book), say what o. has on o.'s mind. 4 export s.t. 5 produce, manufactore. 7 secrete (a fluid), discharge (blood), exhale s.t.
mengeluk	bend, make s.t. supple.
mengelupur	flutter.
mengeluyur	1 loaf around, stroll about without purpose. 2 hang around.
mengembang	1 expand. 2 unfurl (sail, wings, etc.). 3 open (an umbrella, book, etc.) 4 swell.
mengembara	roam, rove wander.
mengembungkan	puff up (o,s cheeks ), inflate , blow up ( a ballon,etc ).
mengempaskan	1 throw, dash, hurl s.t. against. 2 slam (door, etc.).
mengempih	collapse (of lung, vein).
mengempih (s)	collapse (of lung, vein).
mengemuka - kan	1 suggest, propose, put forward. 2 put to the front. 3 confront
mengemukakan	1 suggest, propose, put forward. 2 put to the front. 3 confront s.o.
mengemut	1. 1) throb, beat (of pulse). 2) stagger. 2. 1) suck on (a piece of candy or as sexual act). 2) move up and down (of mouth when eating).
mengenai	1 concerning, about. 2 see kena.
mengenal	1 know, be acquainted with. 2 recognize. 3 distinguish, make out. 4 diagnose (an illness).
mengenangkan	1 remember, recall. 2 commemorate. 3 remind 9o. of s.o.).
mengendalikan	1.hold the reins 2.restrain 3.manage,lead.
mengendarai	1 drive (a car). 2 ride (a horse).
mengendus	1 get wind of, smell, whiff. 2 get wind of, find out, discover.
mengental	coagulate, clot (of blood), curdle (of milk).
mengenyahkan	chase a way , evict .
mengepak	hold a franchise, lease the rights to provide a service.
mengepas	try s.t. on.
mengepel	mop.
mengeping	1split (a plank). 2 slice , cu t into thin pieces.
mengepit	1 carry s.t. under the arm. 2 clasp. 3 pinch.
mengepras	prune, trim, cut back.
mengepung	1 surround, encircle. 2 besiege.
mengerahkan	1 mobilize, conscript (workers, militia, etc.). 2 mobilize to do s.t., assemble (to carry out s.t.).
mengerjai	1 work on s.t. to prepare it. 2 (coll.) have sex with.
mengerjakan	1 do carry out. 2 work ( a field, land, etc.). 3 finish off, eliminate, kill. 4 perform (a task).
mengernyit	frown.
mengeroyok	gang up on, swarm overhelm.
mengerpus	(mil.) place in a cell.
mengerti	1 understand. 2 (java) know.
mengeruk	1) curry, rub down, groom (a horse). 2) chafe s.o. with a coin as a medical treatment.
mengeset	1.1) arrange s.t., set s.t. 2) typeset. 2. trick s.o.
mengesit	type s.t. in a master sheet.
mengetahui	1 know, understand s.t. 2 detect, find out.
mengeteki	tickle under the arm.
mengeteng	buy o. or a little at a time, buy retail.
mengetengahi	1 intercede, mediate. 2 intervene.
mengetengahkan	1 set forth. 2 (leg.) subpoena, , summon.
mengetim	1 boil meat until very tender. 2 steam rice in a certain way.
mengetuk	1 knock on (a door). 2 pound out (a dent, etc.).
mengetuki	1.make a knocking noise on. 2.knock on.
mengga	complete, perfect.
menggabruk	strike with a bang.
menggaji	1 hire, employ. 2 pay a salary or wage.
menggala	1 (lit.) knight. 2 chief indoctrinator.
menggambarkan	1 explain s.t. by drawing it. 2 depict, describe.
menggampangkan	1 facilitate, smooth (the way). 2 take lightly, consider s.t. easy which is hard.
menggapai	pick up, hold, with tweezers.
menggarang	(java) 1 roast s.t. 2 dry s.t.
menggarisbawahi	1 underline, underscore (word, sentence, etc.). 2 emphasize.
menggarong	1 rob, commit a robbery. 2 plunder, loot, pillage.
menggaruk	1 scratch (head, arm, etc.), curry (horse), scape (pan, etc.), rake. 2 round up people (in a raid). 3 rob, clean out.
menggasak	1 rub hard, 2 attack, assault (by hitting or kicking). 3 take by force. 4 pilfer, steal. 5 thrash. 6 devour.
menggaung	dig, excavate.
menggayung	1 strike, slash. 2 cast an evil spell on. 3 stab. 4 do footwork (in silat or other self-defense art).
menggebrak	1 thump, pound on (a table, etc.). 2 crash. 3 hit. 4 instigate, urge, move. 5 shake off.
menggegapkan	ear-shatering, ear-splitting.
menggelemburkan	wrinkle (the skin, etc.).
menggelepar-gelepar	flutter, twitch, flap (as of wings, of dying fowl), flounder, squim (of fish in net).
menggelikan	1) encourage. 2) ridiculous,absurd.
menggelinding	1 roll (of ball, etc.). 2 revolver. 3 (sl.) get .
menggelitik	1 tickle. 2 prod, encourage, incite. 3 beat of o.'s heart.
menggelora	1) rage, seethe (of sea). 2) impassioned (of speech), full of spirit.
menggelumangi	spread on, smear with.
menggeluti	1 embrace. 2 wrestle with. 3 seize, embrace.
menggemakan	wrinkle (the skin, etc.).
menggembirakan	1 cheer up, make happy, gladden. 2 enliven (a party , etc.). 3 rejoice over s.t.
menggemborkan	1) bruit about, noise about. 2) ballyhoo, plug, pour out.
menggendalakan	obstruct, hinder, hamper.
menggeram	1. be furious. 2. sound of growl.
menggerantang	1 snarl at s.o. 2 intimidate (with o.'s speech).
menggerontang	1 make such a noise. 2 threaten with loud noises.
menggertakan	1 intimidate. 2 spur (a horse). 3 gnash o,'s teeth.
menggeruh	1) snore. 2) roar (of animals).
menggerumuti	1 swarm over s.t. (of ants, etc.). 2 crowd (the thoughts).
menggerung	1 make a roarong noise (elephant, engine, etc.). 2 cry loudly.
menggerus	1 polish s.t. with a sheel until it shines. 2 crush, grind. 3 bray (in a mortar).
menggerutu	grumble, complain.
menggetah	1 tap (a tree), collect sap. 2 catch birds with birdlime.
menggetil	pinch, hold between two fingers
menggetok	1 hit, strike. 2 knock on (with a hammer, gravel, knuckles, etc.).
menggigit	1 bite s.t. 2 scathing (critique, etc.).
menggiring	1) herd, drive (livestock). 2) escort a criminal (to prison, court, etc.).
menggodam	strike, pound (of fist, club, etc.).
menggok	make a turn.
menggolak	brew, boi
menggosipkan	gossip about s.t.
menggosok	1 rub. 2 incite, instigate. 3 shine or polish s.t. 4 iron (clothing).
menggoyahkan	1 make s.t. wobble or shake. 2 make s.t.
menggugat	1) accuse, charge. 2) criticize, judge. 3) claim, demand.
menggugurkan	1 cause s.t to fall out prematurely. 2 topple, bring down.
menggula	flatter, butter up.
menggulai	prepare a curry.
menggulaikan	1 cook s.t. as a curry. 2 prepare a curry for others.
menggulingkan	1 roll s.t. 2 topple, overthrow. 3 (sport) defeat.overthrow, deposer.
menggulirkan	make s.t. roll.
menggumalkan	1 wrinkle s.t. 2 rumple or crumple s.t.
menggumamkan	mutter s.t.
menggumpal	1 lump up , clot. 2 cause s.t. to congeal or clot.
menggumpalkan	1 make s.t into a lump 2 make s.t coagulate .
menggunduk	1 pile up. 2 be shaped like a heap.
menggunduli	1 shave s.o. bald. 2 clean s.o. out (financially). 3 make barren, denude (forests, etc.).
menggunting	1 cut with scissor or shears. 2 (coll.) deceive, swindle.
mengguntur	1 thunder. 2 boom out (of a sound).
menggunung	1 pile up, mount up. 2 resemble a mountain.
menggurui	act like a teacher to s.o., be a know-it-all to s.o.
menggusarkan	provoke s.o. to anger.
menggusur	1 haul, drag. 2 condemn (property for public use, etc.), remove (people from their land). (jakarta) flatten, level to the ground (buildings).
mengguyur	1 spray, splash. 2 pour (liquid) in large quantities.
menghabisi	1 end, finish (speech, etc.) 2 finish off, wipe out. 3 spend (time).
menghadiahkan	present s.t., donate.
menghadiri	attend, be present at.
menghafalkan	memorize, learn by heart.
menghalakan	1direct, guide, steer. 2 aim at.
menghalangi	1) block s.o.'s way. 2) hamper.
menghalaukan	1 chase away, drive away. 2 drive, herd.
menghambat	1 hamper, impede. 2 head off s.o. or s.t., obstruct.
menghampiri	approach, come close to.
menghamuni	1 abuse s.o., revile s.o. 2 curse.
menghancurkan	1 smash, shatter (building, glass, hopes, etc.). 2 dissolve (sugar in water, etc.). 3 crush (a stone).
menghangat	become hot.
menghangatkan	1 warm up (food, etc.). heat s.t. peng-hangat warmer.
menghanguskan	1 roast until burnt. 2 burn, singe, scorch.
menghantam	1 strike hard. 2 pound, pummel. 3 attack vigorously. 4 (coll.) go at (o.'s food).
menghantamkan	1 strike s.t. 2 strike with s.t.
menghantui	1 frighten. 2 haunt, obsess.
menghapus	1 completely remove. 2 clean s.t., wipe off (blackboard).
menghapuskan	1 eliminate s.t., wipe out. 2 nullify (a contract), expunge (a record).
mengharamkan	1 forbid, prohibit. 2 abjure, abstain from.
menghardik	1 snap at. 2 scold, dress down, rebuke.
mengharuskan	compel, require.
menghasilkan	1 produce. 2 deliver, produce results.
menghayati	1 experience to the full, comprehend fully. 2 inspire, vivify.
menghendaki	1 wish for s.t. 2 require, demand.
menghentikan	1 stop, halt (car, production, etc.). 2 end, put an end to s.t. 3 fire, dismiss. 4 (av.) feather (a motor).
mengherankan	cause amazement, be astonishing. 2 be suprised at s.t.
menghibahkan	1 give grant, award. 2 donate, bequeath.
menghidupkan	1 revivem bring to life. 2 turn on (radio, tv, light, etc.). 4 rekindle (interest, political party, etc.).
menghikayatkan	narrate stories.
menghilang	disappear.
menghimpit	squeeze, press.
menghina	1 humiliate, insult. 2 affront, offend s.o.
menghirup	1 draw on, inhale (cigarette, etc.). 2 slurp (up), sip at. 3 sniff in. 4 (ling.) implosive.
menghitamkan	1 blacken (hair, teeth). 2 blacken, denigrate, sully (a reputation).
menghitung	1 count, do sums. 2 calculate. 3 count in, reckon.
menghubungi	1 contact, get in touch with. 2 get ahold of.
menghubungkan	1 connect, join. 2 put s.o. in contact with s.o.
menghukum	1 punish s.o. 2 judge, criticize. 3 sentence to.
menghunjam	1 pierce s.t. so it is fixed. 2 penetrate. 3 (av.) dive.
menghunjamkan	1 thrust in, insert (by stabbing). 2 shower on.
menghunus	unsheathe, draw (sword).
menghuru - harakan	excite to violence, bring about confusion.
menghutangkan	lend s.t.
mengi	/mengih/ 1 asthma. 2 pant, have difficulty breathing.
mengiang	1. rainbow. 2. continually whine, hum, or buzz.
mengibaratkan	1 follow s.o's example. 2 compare s.t., say s.t. is like. 4 treat like s.t.
mengibuli	lie to s.o., cheat, deceive.
mengidealkan	idealize.
mengigal	1 strut, show off. 2 display its feathers. 3 dance in a strutting way.
mengikhtiarkan	1 make an effort to. 2 arrange for. 3 make a suggestion.
mengimami	lead prayer service at mosque.
mengimbas	1 blow. 2 (tech.) induce (air flow or electrical current).
mengimbau	appeal.
mengimbaukan	call out or appeal for.
mengimigrasikan	bring to the immigration bureau.
mengimlikasikan	1 implicate. 2 imply.
mengincar	1 aim (gun, pistol, etc.). 2 have o.'s eye on s.o. or s.t., set o.'s sights on s.o.
mengincitkan	shoo, chase s.o. away.
mengindekoskan	have s.o. rent a room s.w.
mengindenkan	order s.t by making a down payment..
mengindikasikan	indicate s.t.
menginduksikan	induce.
mengingat	1 remember, recall, recollect. 2 think of, keep in mind. 3 considering, in the light of.
mengingkari	1 disavow, go back on. 2 deny (a fact).
menginjak	.1 tread or step on. 2 enter a certain age or status.
menginjak - injak	1 disobey, disregard, ignore (a law, regulation, etc.) 2 be disrespectful of, hold a low opinion of.
menginjeksi	inject, give an injection.
menginkasokan	present a check to the issuing bank for payment.
menginpreskan	issue an executive order.
mengintergrasikan	integrate.
menginterlokal	make a long distance call.
mengintruksikan	instruct.
menginvestarikan	inventory, take stock.
mengiprat	1 spurt out, jump. 2 hit.
mengiprati	splash someone or something.
mengiras	resemble.
mengirat	split into thin strips.
mengirimkan	1.send,dispatch s.t 2.leave s.t for safekeeping,entrust s.t .
mengiringkan	1 escort. 2 have s.o. follow.
mengislamkan	1 islamize, convert to islam. 2 circumcise. ke-islam-an islamic.
mengisolasikan	isolate.
mengistirahatkan	give s.o a rest or pause.
mengisukan	1 make an issue of. 2 gossip about s.t.
mengisyaratkan	beckon, signal.
mengizinkan	1 permit, allow. 2 license s.o. or s.t.
mengkadimkan	predict, foretell, prophesy.
mengkafirkan	consider s.o. an infidel.
mengkakok	1 hold. 2 work, do.
mengkal	1 unripe (of fruit). 2 improperly ripened because of defect. 3 annoyed, irritated.
mengkal-pengkol	croked, winding.
mengkali	(jakarta) see barangkali.
mengkandaskan	1beach (a boat etc.). 2 cause s.t. to fail, frustrate.
mengkara	see makara.
mengkarut	1 confuse s.o. 2 lie, tell a falsehood.
mengkasar	see makasar.
mengkasipkan	delay, postpone.
mengkebet	open a book to a certain page.
mengkedut	seize or take by force, snatch.
mengkelan	get s.t. stuck in the throat.
mengkelosok	rub hard, scour.
mengkemam	1 retain in the mouth. 2 mumble.
mengkencongkan	1) twist, bend (s.o.'s words). 2) curl (o.'s lips).
mengkeramatkan	1 consider sacred. 2 respect highly.
mengkeret	1 shrink. 2 angry. 3 afraid, scared. 4. double up with pain.
mengkerkahi	crunch on s.t.
mengkernying	bare the teeth or fangs.
mengkeruh	1 snore. 2 purr (of a cat).
mengkerut	shrink s.t.
mengkerutak	crunch (on a bone).
mengkesat	wipe dry.
mengkesip	suck (on a juicy fruit, etc.).
mengketiaki	put or carry s.t. under the arms.
mengkhatamkan	finish, conclude (the reading of the koran).
mengkhotbahi	preach at, lecture s.o.
mengkhotbahkan	preach s.t. via a sermon.
mengkikis	1 erode. 2 make s.t. disappear bit by bit.
mengkilap	shine.
mengkilapkan	shine, polish (shoes, silver, etc.).
mengkilas	1) trap (animals, birds). 2) tighten (up).
mengkilaskan	releas, let s.t. go quickly.
mengkilat	1shine. 2 flash.
mengkili	hem s.t.
mengkimbang - kimbang	1 circle, hover (of a plane, bird, etc.) 2 move back and forth, go to and fro, be very restless.
mengkimpal	forge metal.
mengking	shake with fright.
mengkipaikan	wag s.t.
mengkiraikan	1 shake out (wet laundry, tablecloth, rug). 2 winnow (rice, etc.). 3 spread (rice) out to dry. 4 flap (its wings, etc.), push open (a door).
mengkirap	1. 1) hit (with its wings, of an angry goose, hen). 2) flap. 3) flutter (of wings, flag). 2. disappear, vanish (of ideals, etc.).
mengkirik	make o.'s flesh creep, shiver.
mengkis	1 challenge. 2 scorn, taunt.
mengkisruhkan	upset, disrupt.
mengklir	be clear, become clear.
mengklirkan	1 finish s.t. 2 clear s.t. up.
mengkocah	mengkocah
mengkodak	take a picture.
mengkopyok	1shake s.t., esp. to blend or mix it up. 2 shake up pieces of paper for lottery.
mengkover	1 cover, include. 2 cover (a story).
mengkremus	chew a.t. crispy into small pieces.
mengkuang	see bangkuang.
mengkuatirkan	1 cause apprehension, alarm. 2 be worried about.
mengkubit	1 pinch s.o. 2 tap s.o. on the arm or shoulder to attract his attention.
mengkudu	see bengkudu.
mengkuit	1 beckon, motion (with fingers, hand, for s.o. to come nearer). 2 tap, prod (with a finger or pencil to attact attention).
mengkulminasi	be at the pinnacle.
mengkungkang	gnaw at s.t.
mengkungkung	1 shackle, restrain. 2 impede movement. 3 dominate.
mengkupas	mengkupas
mengkutip	mengkutip
mengobarkan	1 inspire, fire s.o. up. 2 fan flames, inflame a situation. 3 arouse passions, stir up feelings.
mengobati	treat s.o. or s.t.
mengobatkan	1 treat s.t. medically. 2 treat with s.t.
mengobrak-abrik	1 destroy, ruin. 2 upset, tip over, turn upside down.
mengobral	1 sell out, sell cheaply. 2 spend or dispose of s.t. freely.
mengobrol	chat.
mengobroli	repeatedly talk about, gossip about.
mengoceh	1 bable, jabber. 2 twitter of bird.
mengocok	1 shake, mix s.t. 2 mix, stir (eggs, dough), shuffle (cards). 3 rub hard. 4 incite s.o. to do s.t.
mengoek	quack like a duck.
mengojok	(coll.) make s.o. do s.t. bad.
mengokang	cock a rifle for firing.
mengolah	process, turn s.t. into s.t. better.
mengomel	grumble and complain.
mengompes	1 give s.o. the 3rd degree. 2 coerce, torture.
mengompreng	operate office or gvt. vehicles for personal profit.
mengomprengkan	use an official or company car illegally as a taxi.
mengongkok-ongkok	(m) walk with a stoop.
mengongkoki	mengongkoki
mengoper	1 take s.t. over. 2 hand over, pass s.t. to. 3 transfer.
mengorak	1. uncoil, unfold. 2. (jakarta) 1) shake s.t. violently. 2) bring s.t. to disorder.
mengorek	1 scrape, get s.t. by scraping. 2 dig up secrets.
mengorganisir	organize.
mengorok	(jakarta) 1 snort, drone. 2 snore.
mengosek	1 clean a floor with a brush. 2 rinse or wash food. 3 run water on whetstone while sharpening.
mengot	crooked, curved.
mengotori	contaminate s.t., polute, foul (a river, the environment).
mengoyak	(java) chase after.
mengoyak-oyak	(m) shake s.t. loose.
mengsol	1 askew, aslant. 2 crazy.
mengtangsikan	confine to quarters.
menguakkan	1 make a rent , opening in 2 break open a window , door , safe , barricade ,etc . 3 push apart ( as of people , in ordeer to get through a crowd ) .
menguangi	finance s.t.
menguangkan	1 cash in s.t. 2 sell s.t. (jewelry, etc.) for cash.
menguap	1 evaporate, vaporize. 2 become steam.
menguapi	steam s.t.
menguapkan	1 steam. 2 let evaporate.
menguarkan	proclaim s.t.
menguasai	menguasai
mengubah	1 change, become different. 2 alter, modify.
mengubahi	change or modify several things.
mengubahkan	alter on behalf of s.o.
menguban	be graying.
mengubani	1 pull out gray hairs. 2 cause gray hair (through worry, etc.)
mengubar	1. paint or dye s.t. with such material. 2 unroll s.t. and spread it out.
mengubek	1. stir vigorously by hand. 2. (jakarta, java) 1 turn s.t. around. 2 stir.
menguber-uber	go after, pursue.
mengubini	tile s.t.
mengubit	1 pinch s.o. 2 tap s.o. on the arm or shoulder to attract his attention.
menguburkan	bury, inter, lay to rest.
mengucai	be isolated from o.'s friends.
mengucap	(islam) worship god by pronouncing his names and attributes.
mengucapi	1 say s.t. to s.o. 2 recite spells over s.o., treat s.o. who is ill by reciting prayers and invocations.
mengucapkan	express.
mengucek	1 rub. 2 do the laundry. 3 crush, grind, mash.
mengucek-ngucek	(jakarta, java) rub with o.'s hands.
mengucilkan	1 expel (from family, clan, relationship, political party, etc.), ostracize, excommunicate. 2 squeeze out (toothpaste, glue, etc.).
mengudak	chase after, pursue.
mengudak-udak	stir.
mengudal-adul	rumple hair, string, or other hairlike material.
mengudap	1 taste s.t. 2 snack, eat between meals.
mengudar	1 reel, wind. 2 disentangle.
mengudara	1 go on the air (radio, etc.). 2 go up in the air (balloons, etc.).
mengudarakan	1 air (programs). 2 put s.t. in the air, let s.t. fly.
mengudek	(java, jakarta) stir.
mengudik	1 go upstream. 2 return to o.'s ancestral village.
mengudut	(java) smoke s.t.
mengugem	(java) claim as o.'s own.
mengugut	threaten, intimidate.
menguhuk-uhuk	sob.
menguik	squeal (of pigs).
mengujar	say s.t.
menguji	1 examine. 2 put to the test, try.
mengujung	1 reach an end or a top. 2 become sharp or pointed. 3 intensify.
mengukir	carve s.t., engrave.
mengukirkan	carve into or on s.t.
mengukup	perfume s.t., incense s.t.
mengukur	1 measure, survey. 2 read a meter.
mengukurkan	measure against s.t.
mengulah	prepare.
mengulak	buy goods for resale.
mengulang	1 repeat s.t. 2 study over again.
mengulangi	1 repeat, do s.t. again. 2 visit frequently.
mengulangkan	repeat for s.o.
mengulap-ulapkan	perform such a gesture with (the hand).
mengulas	1. 1) cover, wrap. 2) daub (in painting). 2. 1) review, comment on. 2) explain, analyze.
mengulasi	1 put a cover on s.t. 2 daub over and over.
mengulaskan	1. use s.t. to cover. 2. divide into sections.
menguleg	/mengulek/ pulverize, grind.
mengulem	invite.
mengulet	stretch (after sleeping).
menguli	knead (dough).
mengulik	investigate.
mengulir	put in a screw.
mengulitkan	put s.o. to sleep by singing lullabies.
mengulur	1 pay out. 2 extend. 3 make concessions.
mengulur-ulur	repeatedly extend s.t.
menguluri	hand over to s.o.
mengulurkan	1 pay out (a rope, etc.). 2 pass s.t. out, stick s.t. out. 3 extend, stretch.
mengumak-umik	(java) silently mouth words.
mengumbah	1 wash, do the laundry. 2 rinse.
mengumbai-umbaikan	swing, dangle s.t.
mengumban	1 sling. 2 throw away.
mengumbang	float.
mengumbar	free s.t., let loose.
mengumbat	extract s.t. difficult to remove.
mengumbuk	1 swindle. 2 persuade. 3 appease, talk in a friendly way to s.o.
mengumbul	bubble up, rise rapidly.
mengumpak-umpak	extol a person to the skies.
mengumpamakan	1 compare. 2 take as an example. 3 assume, suppose.
mengumpan	tempt, lure.
mengumpani	1 bait s.t. 2 entice.
mengumpankan	use s.t. as bait.
mengumpat	swear, curse (in reproach).
mengumpati	swear at s.o.
mengumpet	go hide, lie low.
mengumpetkan	hide s.t.
mengumpil	1 lift, raise. 2 row, scull.
mengumpulkan	1 gather , assemble , concentrate (forces ) 2 collect ( stamp,coins,etc) 3 amass,accumulate ( a for tune , an art collection , eetc ) .
mengumumkan	1 announce, notify. 2 publish.
mengunclik	walk without looking left or right.
mengunda-unda	tow o. behind the other.
mengundang	invite, summon.
mengundangkan	legislate, establish by law.
mengundat-undat	(java) dig up old grievances.
mengundi	draw (lots, straws, etc.).
mengunduh	(java) pick (fruit from tree).
mengundung-undungkan	use as a head covering.
mengundur-undurkan	keep postponing.
mengundurkan	mengundurkan
mengung	see menung.
mengungap	gasp for breath.
mengunggis	nibble, gnaw at.
mengunggul-unggulkan	show off.
mengungguli	surpass.
mengunggulkan	mengunggulkan
mengunggunkan	pile (wood, etc.).
mengunggut	pull at, tug.
mengungkai	1 untie, undo, loosen. 2 break open. 3 undo, take off. 4 disclose.
mengungkap	1 express (with words, face or gestures). 2 reveal, uncover.
mengungkapi	dig up.
mengungkapkan	1 give expression to. 2 utter, pronounce. 3 uncover, reveal.
mengungkat-ungkat	bring up old sore points.
mengungkil	pry up.
mengungkit	1 pry up. 2 pry (into other people's business).
mengungkit-ungkit	1 bob up and down. 2 open up old sore points.
mengungsi	flee.
mengungsikan	evacuate s.o.
mengungu	become purple.
menguniversalkan	/menguniversilkan/ make s.t. universal.
mengunjuk	1 extend the hand. 2 indicate, point out.
mengunjukkan	1 raise or extend o.'s hand. 2 present, hand over, pass.
mengunjur	stretch o.s.
mengunjurkan	stretch s.o. or s.t. out.
mengunjut	wrap up in a bundle, make into a bundle.
mengunsuri	be an element of.
menguntai	1 dangle, hang down. 2 string s.t.
menguntal	1. roll s.t. into pellet shape. 2. 1) swallow a large quantity. 2) (vulg.) eat.
menguntal-nguntal	wad up.
menguntali	menguntali
menguntil	dangle, hang down.
mengunting	sound, plumb.
