marshy	ks. rawa. m. area daerah rawa.
mart	kb. pasar. trade m. pasar perdagangan.
martial	ks. yang berhubungan dengan perang. m. law keadaan perang. m. music musik perang. m. spirit semangat perang.
martinet	kb. orang yang keras tatatertibnya.
martini	kb. semacam cocktail.
martyr	kb. syahid, syuhada, martir.
martyrdom	kb. kesyahidan.
marvel	kb. sesuatu yang sungguh-sungguh mengagumkan, mukjizat, keajaiban. -kki. kagum, heran.
marvelous	ks. 1 bagus sekali. m. buy pembelian yang bagus sekali. 2 yang mengagumkan (of a performer). inf.: we had a m. time at the party kami sungguh-sungguh senang dalam pesta itu.
marxism	kb. marxisme.
marxist	kb., ks. marxis, penganut ajaran karl marx.
masc.	[masculine] maskulin, jantan.
mascara	kb. celak.
mascot	kb. jimat, azimat.
masculine	ks. 1 laki-laki, jantan. 2 kelaki-lakian. 3 gram.: maskulin.
masculinity	kb. kejantanan, sifat kelaki-lakian.
maser	kb. maser (alat pengukur elektro-magnet).
mash	kb. semacam bubur (for livestock, for making beer or wiskey). -kkt. melenyehkan (potatoes). mashed potatoes kentang pure/tumbuk.
masher	kb. 1 sl.: hidung belang, mata keranjang. 2 orang/alat untuk menumbuk atau melembutkan.
mask	kb. 1 topeng. death m. topeng mati/ mayat. 2 kedok. 3 sport : masker, penutup atau pelindung muka. -kkt. menembunyikan, menutupi (o's feelings, o's intentions). -masked ks. bertopeng. m. ball pesta topeng, balmaski.
masochism	kb. kegembiraan/kesenangan karena menderita/disiksa.
masochist	kb. seorang yang suka menderita.
mason	kb. 1 tukang batu. 2 m. anggota perkumpulan kebatinan. m. jar semacam stoples yang bertutup rapat.
masonic	ks. yang berhubungan dengan perkumpulan kebatinan.
masonry	kb. (j. -ries) 1 bangunan pertukangan batu. 2 keahlian tukang batu. 3 m. perkumpulan kebatinan orang-orang yang disebut freemason, vrijmetselarij.
masquerade	kb. 1 pesta bertopeng, balmaski. 2 penyamaran. -kki. 1 bermain, berlaku. 2 menyamar, menyamarkan diri (as sebagai).
mass	kb. 1 phys.: massa. 2 banyak sekali (of information). 3 rel.: m. misa. -the masses j. massa (rakyat). -ks. massa. 2 rakyat. 3 besar-besaran. -kkt. mengumpulkan, menyusun (troops). -kki. berkumpul.
mass.	[massachusetts) negara bagian a.s.
massacre	kb. pembunuhan besar-besaran. -kkt. menyembelih, membunuh secara kejam dan secara besar-besaran.
massage	kb. pijat, pijit. -kkt. memijit, mengurut. m. parlor tempat/panti pijat.
masseur	kb. ahli pijat, tukang pijit/urut.
masseuse	kb. ahli pijat perempuan, tukang pijit wanita, pramupijat.
massive	ks. secara besar-besaran, raksasa.
mast	kb. tiang (kapal).
master	kb. 1 tuan rumah. 2 nakhoda (of a ship). 3 pemilik. 4 jagoan (at a skill, sport). 5 pelukis ulung (seperti rembrandt). 6 tuan, ndoro (anak laki-laki yang belum dewasa), orang yang mempunyai kekuasaan. -kkt. menguasai (a subject, o's temper).
masterful	ks. bagus sekali.
masterly	ks. yang mengagumkan, bagus sekali.
mastermind	kb. dalang, otak, perencana. -kkt. mendalangi.
masterpiece	kb. karya besar/agung.
masterwork	kb. karya besar/agung.
mastery	kb. (j. -ries) 1 penguasaan. to have a m. of a subject menguasai sebuah vak/kejuruan. 2 keunggulan (over terhadap).
masthead	kb. 1 puncak-tiang kapal. 2 news.: kepala suratkabar.
masticate	kkt. mengunyah.
mastoid	kb. tulang karang.
masturbate	kki. merancap, main onani.
masturbation	kb. onani, perancapan.
mat	kb. 1 kesetan, pengesat kaki (at door). 2 tatakan (on table). 3 lapik. -kkt. (matted) membikin kusut.
match	kb. 1 korek api, geretan. 2 sport : pertandingan. 3 tandingan. -kkt. 1 mencocokkan (the numbers). 2 menandingi. 3 mengadu (two boxers) -kki. cocok. -matching ks. sesuai. m. colors warna-warna yang sebanding.
matchbook	kb. kertas penutup korek api.
matchbox	kb. kotak korek api.
matchless	ks. tak ada bandingannya/taranya. m. skill kecakapan yang tak ada bandingannya.
matchmaker	kb. pencari jodoh, pinang muda, mucikari, mak comblang, penjaruman.
matchstick	kb. batang korek api.
mate	kb. 1 jodoh. 2 suami. 3 isteri. 4 pasangan (to a sock). nau.: first m. pelayan/kelasi kelas satu. -kkt. mengawinkan. -kki. kawin. -mating kb. perkawinan (of birds). m. season musim berkawin.
material	kb. 1 bahan, material. 2 alat-alat. 3 cloth.: cita, kain. -ks. 1 materiil 2 pokok. 3 utama, penting. 4 jasmaniah. -materially kk. materill, jasmaniah.
materialism	kb. materialisme.
materialist	kb. materialis.
materialistic	ks. materialistis.
materialize	kkt. terwujud.
materiel	kb. perlengkapan, peralatan.
maternal	ks. keibuan, yang berhubungan dengan ibu. m. instinct dorongan hati keibuan. m. grandmother nenek dari pihak ibu.
maternity	kb. keibuan. m. center rumah bersalin. m. clothes pakaian untuk wanita hamil.
math	kb. inf.: ilmu pasti.
math.	1 [mathematical] yang bersifat ilmu pasti. 2 [mathematics] ilmu pasti.
mathematical	ks. yang berhubungan dengan ilmu pasti, matematis. with m. precision dengan ketepatan yang persis sekali. -mathematically kk. menurut ilmu pasti, secara matematis.
mathematician	kb. ahli ilmu pasti.
mathematics	kb. ilmu pasti, matematika.
matinee	kb. pertunjukan siang/sore.
matriarch	kb. ibu pemimpin keluarga, wanita pemimpin suku.
matriarchal	ks. peribuan, matriarkal.
matriarchy	kb. (j. -chies) 1 organisasi masyarakat yang materiarkal. 2 pucuk pimpinan di tangan wanita/ibu.
matrices	lih matrix.
matricide	kb. pembunuhan (terhadap) ibu.
matriculate	kki. mendaftarkan diri (sebagai mahasiswa), diterima sebagai mahasiswa.
matriculation	kb. penerimaan masuk sebagai mahasiswa pada perguruan tinggi.
matrimonial	ks. yang berhubungan dengan perkawinan.
matrimony	kb. (j. -nies) ikatan perkawinan. to join in holy m. menyatukan dalam ikatan perkawinan yang suci.
matrix	kb. (j. matrices) 1 print.: acuan, matres. 2 anat.: kandungan rahim. 3 math.: susunan angka-angka, matriks. 3 batu(an).
matron	kb. ibu yang muda. 2 ibu (asrama). m. of honor wanita bersuami yang menjadi pengiring utama dalam perkawinan.
matronly	ks. keibuan. m. figure raut badan keibuan.
matter	kb. 1 zat. 2 bahan. 3 barang. 4 perkara, hal. 5 persoalan. 6 nanah (in a sore). 7 soal. 8 urusan. 9 kiriman. -matters j. keadaan. -kki. berarti. matter-of-fact ks. tidak menghayal-khayalkan, tidak berbelit-belit.
matting	kb. 1 tikar. 2 anyaman jerami untuk pembungkus.
mattock	kb. beliung, cangkul.
mattress	kb. kasur.
maturation	kb. 1 pemasakan seorang anak. 2 med.: bernanahnya bisul.
mature	ks. 1 dewasa. 2 masak (of fruit,cheese). 3 matang. -kki. menjadi dewasa.
maturity	kb. (j. -ties) kedewasaan. m. date of a loan batas waktu pinjaman.
maudlin	maudlin
maul	kkt. melukai, menganiaya.
mausoleum	kb. makam/kuburan yang besar dan amat indah.
mauve	ks. lembayung muda.
maverick	kb. orang/organisasi yang tidak konvensionil.
max.	[maximum] maksimum.
maxim	kb. peribahasa, pepatah.
maximal	ks. maksimal.
maximum	kb., ks. maksimum. m. amount jumlah yang tertinggi.
may	kkb. (meight) 1 boleh. 2 mungkin. 3 barangkali. 4 semoga, mudah-mudahan.
maybe	kk. barangkali, boleh jadi.
mayday	kb. panggilan internasional dengan radio minta bantuan dari sebuah kapal atau pesawat terbang.
mayhem	kb. aniaya. to commit m. on s.o berbuat aniaya terhadap seseorang.
mayonnaise	kb. kuah (bumbu) selada, saos selada.
mayor	kb. walikota.
mayoralty	kb. (j. -ties) jabatan walikota.
maze	kb. jaringan jalan yang ruwet, simpang siur jalan. m. of caves gua-gua yang bersimpang-siur.
mccoy	kb. inf.: the real m. yang benar/murni/sungguh.
md, m.d.	[doctor of medicine] kb. dokter.
md.	[maryland] negarabagian a.s.
me	kg. 1 saya. he saw me dia melihat saya. 2 aku. dia melihat aku. 3 -ku. give the box to me berikan kotak itu kepadaku.
me.	[maine] negara bagian a.s.
meadow	kb. padang rumput.
meager	ks. 1 amat kecil/kurang. m. allowance uang saku yang amat kecil. 2 tidak lengkap. m. reports berita-berita yang tidak lengkap.
meal	kb. 1 tepung. corn m. tepung jagung. 2 makanan. square m. makanan lengkap.
mealtime	kb. waktu makan.
mealy	ks. seperti tepung.
mean	kb. (titik) pertengahan (antara ujung yang ekstrim), sedang, rata. -kkt. (meant) 1 bermaksud, berniat. 2 berarti. 3 menakdirkan, memaksudkan. 4 memperuntukkan. 5 menujukan. 6 bersungguh - sungguh. -meaning kb. arti.
meander	kki. berliku-liku, berkelok-kelok. -meandering kb. liat-liut (of a river).
meaningful	ks. berarti, penuh dengan arti.
meaningless	ks. tak berarti.
meanness	kb. keburukan, kepicikan, kejahatan.
means	kb., j. 1 harta, kekayaan. 2 alat (-alat), cara.
meant	lih mean kkt., kki.
meantime	kb. in the m. dalam pada itu.
meanwhile	kb. sementara itu, dalam pada itu.
measles	kb. campak, cacar air.
measly	ks. inf.: sangat sedikit/kecil.
measure	kb. ukuran. 2 tindakan, langkah. 3 law. undang-undang. 4 takaran (of liquid). 5 mus.: (irama) ketukan. 6 kadar. -kkt. 1 mengukur. 2 mengadu. -measuredks. teratur. measuring cup cangkir takaran.
measurement	kb. ukuran.
meat	kb. 1 daging. m. grinder penggiling daging. 2 isi. m. and drink makanan dan minuman. m. ball a) bulatan-bulatan daging, bakso. b) sl.: (person) orang yang membosankan.
meaty	ks. berisi.
mecanism	kb. 1 alat (mekanik). 2 mesin. 3 (defense) mekanisme. 4 peralatan (of the body).
mecca	kb. mekah. new york city is a m. for tourists kota new york ramai dikunjungi wisatawan.
mechanic	kb. montir, ahli mesin.
mechanical	ks. 1 yang berhubungan dengan mesin. m. evice alat-alat mesin. 2 seperti mesin. his reading is m. ia membaca seperti mesin, tanpa perasaan. -mechanically kk. dengan mesin.
mechanics	kb. 1 ilmu mekanika, ilmu tentang mesin. 2 seluk-beluk mekanis.
mechanization	kb. mekanisasi.
mechanize	kkt. memekanisasi(kan).
medal	kb. medali, bintang, bronze m. medali perunggu. m. of honor bintang kehormatan.
meddle	kki. mencampuri. to m. in other people's business mencampuri urusan orang lain.
meddlesome	ks. suka mencampuri urusan orang lain.
media	j. 1 lih medium. 2 wasilah.
mediaeval	= medieval.
medial	ks. ditengah-tengah. in m. position ditengah-tengah, bertempat ditengah.
median	kb. angka median/penengah, angka yang berada ditengah-tengah. 2 jalur hijau (of a highway). -ks. rata-rata. m. salary gaji rata-rata.
mediate	kkt., kki. menengahi. to m. a dispute bertindak sebagai penengah dalam sengketa.
mediation	kb. penyelesaian sengketa dengan menengahi.
mediator	kb. (orang) penengah, pelerai.
medic	kb. 1 inf.: dokter. 2 inf.: anggota korps kesehatan angkatan perang.
medical	ks. yang berhubungan dengan pengobatan, medis. m. books buku-buku kedokteran.
medicament	kb. obat.
medicated	ks. dibubuhi/mengandung obat.
medication	kb. 1 pengobatan. 2 obat.
medicinal	ks. yang berhubungan dengan obat. for m. purposes only semata-mata untuk maksud-maksud pengobatan saja.
medicine	kb. 1 ilmu kedokteran. to study m. belajar kedokteran. 2 obat. to take m. minum obat. m. ball bola untuk latihan kesehatan. m. man dukun.
medico	kb. 1 inf.: dokter. 2 inf.: mahasiswa kedokteran.
medieval	ks. pertengahan. m. history sejarah abad pertengahan.
mediocre	ks. sedang-sedang, cukupan.
mediocrity	kb. (j. -ties) keadaan/sifat sedang.
meditate	kkt. merencanakan. -kki. bersemedi.
meditation	kb. semedi, meditasi.
mediterranean	kb. laut(an) tengah. -ks. m. sea laut(an) tengah.
medium	kb. (j. -iums, media). 1 cenayang, medium, dukun yang dapat berhubungan dengan roh. 2 perantaraan. 3 perantara. 4 alat jalur (of communications). -ks. 1 sedang. 2 setengah matang (of boiled aggs, steak). -
medley	kb. urut-urutan, rampai-rampi.
meek	ks. lembut (hati), penurut. -meekly kk. tanpa perlawanan.
meet	kb. sport : pertandingan. -ks. pantas -kkt. (met). 1 berjumpa dengan menjumpai (a person, resistance). 2 menjemput (s.o. at the plane). 3 bertemu dengan. 4 memenuhi. 5 membayar. 6 mengalami. 7 mencukupkan, menutup. 8 menemui. 9 mempertemukan.
megacycle	kb. megacycle.
megalomania	kb. penyakit gila yang mengkhayalkan dirinya seperti seorang yang agung dan mulia.
megaphone	kb. alat pengeras suara, megafon.
melancholic	ks. murung, sedih, pilu, sayu.
melancholy	kb. (j. -lies) kemurungan jiwa. -ks. sayu, sedih.
melee	kb. perkelahian, pergulatan, huru-hara.
mellow	ks. 1 empuk, merdu, lembut (of tone, voice). 2 masak, matang (of wine). m. apple buah apel yang telah ranum. -kkt. melunakkan, meredakan (o's attitude). -kki. 1 menjadi lunak. 2 menjadi matang (of wine).
melodious	ks. merdu, bagai buluh perindu.
melodrama	kb. sandiwara penuh dengan kejadian-kejadian sedih, tetapi berakhir dengan kegembiraan, sandiwara sensasi.
melodramatic	ks. sensasionil.
melody	kb. (j.-dies) lagu, nyanyian.
melon	kb. (buah) semangka. sl.: to cut/split the m. membagi keuntungan.
melt	kkt. (melted, melted atau molten) 1 (dissolve) melarutkan, melebur. 2 mencairkan (butter, lard). 3 menghalau (fog, mist). 4 meluluhkan (o's heart). -molten ks. dicairkan. -melting ks. yang mencair. m. pot 1 tempat bercampur. 2 wajah percampuran.
mem.	1 [member] anggota. 2 [memorandum] nota, memorandum.
member	kb. 1 anggota (of a club). m. of the family anggota keluarga. 2 anggota tubuh (kaki), tangan. 3 suku (of an equation).
membership	kb. 1 keanggotaan (in dalam). 2 para anggota. 3 jumlah anggota.
membrane	kb. selaput.
memento	kb. kenang-kenangan, tandamata.
memo	kb. memo, nota peringatan.
memoir	kb. laporan ilmiah. 2 riwayat hidup singkat. -memoirs j. buku kenang-kenangan, riwayat hidup.
memorabilia	kb. sesuatu yang patut dikenang.
memorable	ks. yang mengesankan, yang patut menjadi kenang-kenangan. m. occasion peristiwa yang patut menjadi kenang-kenangan.
memoranda	lih memorandum.
memorandum	kb. (j. memoranda) 1 nota. 2 surat peringatan. 3 catatan pendek.
memorial	kb. tanda peringatan (seperti patung, tugu, taman dll). m. service upacara peringatan.
memorization	kb. penghafalan.
memorize	kkt. menghafalkan.
memory	kb. (j. -ries) 1 ingatan, daya ingatan. in the m. of any inhabitant pada ingatan setiap penduduk. 2 kenang-kenangan. pleasant memories kenang-kenangan yang menyenangkan.
men	= man.
menace	kb. ancaman.
menagerie	kb. kumpulan binatang liar dikurung didalam kandang.
mend	kb. tambalan (in a coat). -kkt. 1 menambal (clothes). 2 mmperbaiki (road, a breach). 3 membetulkan (an error). 4 menisik(i) (socks).
mendacity	kb. (j. -ties) 1 kebiasaan berdusta. 2 dusta.
menfolk	kb. j. orang-orang/kaum lelaki, kaum pria.
menial	ks. 1 kasar (of work). 2 rendah (in origin).
meningitis	kb. radang selaput (otak atau sumsum tulang belakang).
menopouse	kb. mati haid.
menstrual	ks. yang berkaitan dengan haid. m. period waktu haid, waktu datang bulan, sedang mens.
menstruate	kki. haid, datang bulan, mens, melihat bulan.
menstruation	kb. haid, kain kotor/cemar, datang bulan.
mental	ks. 1 yang berkaitan dengan jiwa. m. health kesehatan jiwa. 2 batin, rohaniah. -mentally kk. rohaniah.
mentality	kb. (j. -ties) daya otak, kapasitas mental, mentalitas.
mention	kb. sebutan. honorable m. sebutan terhormat. -kkt. 1 menyebutkan. 2 mengatakan. not to m. belum lagi.
mentor	kb. penasehat.
menu	kb. daftar makanan, menu.
meow	kb. ngeong. -kki. mengeong. -kseru. meong.
mercantile	ks. yang berhubungan dengan perdagangan. m. law undang-undang perniagaan/niaga
mercenary	kb. (j. -ries) prajurit upahan. m. army tentara upahan tentara sewaan. -ks. mata duitan. for m. reasons dengan alasan mencari uang/keuntungan.
merchandise	kb. barang dagangan.
merchant	kb. saudagar, pedagang. m. fleet/marine armada niaga.
merciful	ks. bermurah hati.
merciless	ks. tak kenal ampun, tanpa kasihan.
mercurochrome	kb. mercurokhrom, obat merah.
mercury	kb. 1 air raksa (dalam termometer). 2 derajat, suhu. the m. dropped last night. suhu turun semalam. 3 m. bintang utarid.
mercy	kb. (j. -cies) 1 kemurahan hati. 2 belaskasihan, rahmat, kerahiman. to have m. on mengasihani, merahimi.
mere	ks. belaka. m. oversight kekhilafan belaka. -merely kk. hanya, belaka. she m. smiled dia tersenyum saja.
merge	kkt. menggabungkan, memfusikan. -kki. bergabung, berfusi. merging traffic pergabungan lalu lintas.
merger	kb. penggabungan, fusi.
meridian	kb. garis bujur.
merit	kb. 1 kebaikan, jasa. to go into the merits of a proposal memperhitungkan kebaikan/segi baik dari sesuatu usul. 2 guna, manfaat (of a plan). -kkt. pantas, patut. to m. s.t. for memang pantas mendapatkan sesuatu karena.
meritorious	ks. 1 berjasa. m. service pengabdian yang berjasa. 2 berfaedah, bermanfaat.
mermaid	kb. puteri laut, bintu'l-bahar.
merriment	kb. bersuka-ria, keriangan.
merry	ks. gembira, sukaria. the more the merrier lebih banyak (orang) lebih suka-ria. merry-go-round kb. korsel, komidi putar.
merrymaking	kb. bersenang-senang, bersukaria, bergembira.
mesh	kb. (mata) lubang (of a screen). m. of a net mata jala. -kkt. menghubungkan (o's activities/plans with). -kki. saling menangkap, bertautan (of gears).
mesmerize	kkt. mempesonakan, memikat.
mess	kb. 1 ruang makan. m. hall kantin, ruang makan. 2 barang-barang yang kotor dan berantakan. -kkt. 1 mengotori. 2 mengacaukan.
message	kb. 1 pesan. may i take a m.? ada pesan yang dapat saya sampaikan ? 2 warta/perintah suci.
messenger	kb. pesuruh, kurir.
messiah	kb. 1 imam mahdi. 2 al-maseh.
messiness	kb. keadaan berantakan.
messrs.	lih mister.
messy	ks. morat-marit (of a room). 2 kotor (of hands, clothes)
met	lih meet.
metabolism	kb. metabolisme.
metal	kb. logam, metal. sheet m. baja lembaran. m. foundry penuangan metal. m. shears gunting logam.
metallurgical	ks. yang berhubungan dengan metalurgi. m. engineering teknik metalurgi.
metallurgy	kb. metalurgi.
metamorphosis	kb. (j. -oses) perubahan bentuk.
metaphor	kb. metafora, kiasan.
metaphysic	kb. metafisika.
metathesis	kb. (j. -eses) metatesis.
mete	kkt. membagikan (out punishment).
meteor	kb. cirit bintang, meteor.
meteoric	ks. sangat cepat (rise).
meteorite	kb. batu bintang.
meteorological	ks. yang berhubungan dengan meteorologi. m. service jawatan meteorologi/cuaca.
meteorology	kb. meteorologi, ilmu cuaca.
meter	kb. 1 meter (ukur). 2 meteran. water m. meteran air. 3 lit.: matra (irama).
meterman	kb. (j. -men) pemeriksa meteran.
method	kb. metode, cara. there's m. in her madness dia punya cara dan pemikiran yang kelihatannya tolol, tapi sebenarnya pintar.
methodical	ks. metodis.
methodist	kb. metodis.
methodological	ks. secara metodologi.
methodology	kb. (j. -gies) metodologi.
meticulous	ks. sangat teliti, cermat sekali.
metre	= meter.
metric	ks. metrik. m. sysrem sistem metrik.
metrical	ks. metris, berirama, yang berhubungan dengan matra.
metrics	kb. ilmu irama lagu, ilmu tentang meter.
metronome	kb. alat yang dipakai untuk menentukan kecepatan irama lagu dalam bermain musik, metronom.
metropolis	kb. (j. -ises) kota besar.
metropolitan	ks. yang berhubungan dengan kota besar. m. new york kota besar new york.
mettalic	ks. seperti logam.
mettle	kb. keberanian, semangat. this task put me on my m. tugas ini menjadikan saya bersemangat.
mew	kki. (me)ngeong.
mex.	[mexico] meksiko.
mexican	kb., ks. orang meksiko.
mezzanine	kb. loteng tengah (di hotel atau gedung).
miaow	= meow.
miasma	kb. racun yang keluar dari tanah/rawa.
mica	kb. mika.
mice	lih mouse.
microbe	kb. kuman.
microcosm	kb. dunia/kehidupan kecil.
microfilm	kb. mikrofilm. -kkt. membuat mikrofilm.
microorganism	kb. jasad renik.
microphone	kb. mikropon, corong.
microscope	kb. mikroskop.
microscopic	ks. sangat kecil sekali.
mid	ks. pertengahan. m. vowel vokal pertengahan. mid-air ks. di udara. in mid-flight dalam penerbangan.
midair	kb. in m. di udara. the discussion was left in m. perundingan itu disudahi tanpa memperoleh hasil.
midday	kb. tengah hari.
middle	kb. 1 pinggang. 2 pertengahan. -ks. setengah. middle-aged ks. (berumur) setengah tua. middle-class ks. kelas menengah. middle-of-the-road ks. moderat.
middleman	kb. (j. -men) makelar, perantara, tengkulak.
middleweight	kb. box : kelas ringan utama.
middling	ks. 1 sedang (dalam ukuran), cukupan. 2 biasa, sedang-sedang.
midget	kb. orang kerdil, cebol.
midnight	kb. tengah malam. to burn the m. oil belajar/bekerja sampai jauh malam.
midriff	kb. 1 sekat rongga badan. 2 bagian muka badan.
midshipman	kb. (j. -men) teruna/mahasiswa pada akademi angkatan laut a.s.
midst	kb. tengah-tengah. in over m. ditengah-tengah kita. to be in the m. of writing sedang tengah menulis.
midstream	kb. tengah-tengah sungai.
midtown	kb. pusat kota.
midway	kb. 1 pertengahan jalan. 2 tempat hiburan atau pertunjukan-pertunjukan di pameran. -kk. di pertengahan. i live in between... saya tinggal di pertengahan jalan antara...
midweekly	ks., kk. tengah mingguan.
midwife	kb. bidan, dukun beranak.
midyear	ks. tengah tahunan.
mien	kb. sikap, air muka, rupa, wajah.
miff	kkt. menjengkelkan hati.
might	kb. kekuatan, tenaga. m. does not make right kuat tak berarti benar.
mighty	ks. kuat. m. king raja kuat. -kk. inf.: 1 sangat. a m. fine girl seorang yang sangat manis. 2 hebat. a m. good salesman penjual yang hebat sekali. -mightily kk. dengan kuat.
migraine	kb. m. headache sakit kepala yang berat pada sebelah kepala, kepialu, migren.
migrant	kb. orang atau burung yang pindah. m. worker pekerja pengembara, pekerja yang berpindah, pekerja pendatang.
migrate	kki. berpindah tempat, berboyong, memboyong.
migration	kb. migrasi, perpindahan tempat.
migratory	ks. berpindah. m. instinct naluri berpindah tempat (pada burung-burung). m. worker pekerja yang (suka) berpindah tempat.
mike	kb. inf.: mikropon, corong.
mil.	[military] militer.
mild	ks. mendingan, sejuk (of climate or weather). 2 ringan (of cigarette). m. beer bir ringan. 3 sedikit. m. headache sakit kepala sedikit. 4 enteng (of box, bag). mild-mannered ks. yang berwatak halus/lembut. -mildly kk. agak, sedikit.
mildew	kb. jamur, lumut. -kki. berjamur, melapuk.
mildness	kb. keringanan, kelembutan, kehalusan.
mile	kb. mil.
mileage	kb. jarak mil.
milestone	kb.1 kejadian yang penting, batu peringatan. 2 tonggak bersejarah.
milieu	kb. lingkungan pergaulan
militancy	kb. nafsu berkelahi/berperang.
militant	kb. orang militan/agresip. m. leadership pimpinan yang militan.
militarist	kb. orang yang percaya dalam organisasi dan kekuatan ketentaraan yang sangat kuat.
military	kb. temtara. -ks. militer, ketentaraan, kemiliteran. m. academy akademi militer. -militarily kk. dari segi kemiliteran.
militate	kki. to m. against menghalang-halang, melawani.
militia	kb. milisi, wamil.
milk	kb. susu. -kkt. 1 memerah, memeras susu (cow). 2 memeras (information from s.o.). -milking kb. pemerahan.
milker	kb. 1 tukang susu. 2 alat pemerah.
milkman	kb. (j. -men) tukang/pengantar susu.
milksop	kb. orang yang tidak bersemangat.
milky	ks. seperti susu. m. way bimasakti.
mill	kb. 1 penggilingan, gilingan. coffee m. gilingan kopi. 2 paberik. sugar m. pabrik gula. 3 pemintalan. cotton m. pemintalan kapas. -kkt. menggiling. -kki. to m. about/around bergerak secara ramai. -milling kb. (perusahaan) penggilingan.
millennium	kb. (j. -nia, -iums) masa seribu tahun.
miller	kb. penggilingan, tukang giling.
millet	kb. semacam padi-padian.
milligram	kb. miligram.
millimeter	kb. milimeter.
millinery	kb. (j. -ries) perusahaan topi wanita.
million	kb. juta. i have a m. things to do pekerjaan saya luar biasa banyaknya. inf.: he's one in a m. dia seorang yang tak ada taranya.
millionaire	kb. jutawan.
millionth	ks. yang kesejuta.
millstone	kb. (batu) gerinda.
milquetoast	kb. seorang lemah, kurang tegas/berani.
mime	kb. 1 badut, pelawak. 2 pembadutan. -kkt. meniru-niru.
mimeograph	kb. mesin stensil. -kki. menstensil, meroneo. mimeographing machine mesin stensil.
mimic	kb. pemain mimik. -kkt. meniru-niru, memimikkan.
mimicry	kb. (j. -ries) cara menirunya.
min.	[minute] menit.
minaret	kb. menara.
mince	kb. daging halus yang dicencang. -kkt. mengiris, memotong-motong (meat).
mincemeat	kb. daging cincang bercampur buah apel, kismis, rempah-rempah dll.
mind	kb. 1 pikiran. 2 akal. 3 ingatan. -kkt. 1 menjaga (a store, a child). 2 mengingat-ingat, memperhatikan (o's words). 3 patuh kepada. 4 menghiraukan (hot weather). -kki. 1 hati-hati. 2 patuh. m. reader orang yang dapat membaca isi hati orang.
mindful	ks. sadar (of akan). 2 berhati-hati.
mine	kb. 1 (coal) tambang. 2 mil.: ranjau, periuk api. 3 sumber (of information). -kg. milikku, kepunyaanku. -kkt. 1 menambang (coal). 2 memasang ranjau. -mining kb. 1 pertambangan. 2 peranjauan (of a harbor). 3 penambangan (of tin).
miner	kb. buruh tambang.
mineral	kb. barang tambang, mineral, bahan galian. m. oil pencahar, obat pencuci perut. m. water air mineral.
mineralogy	kb. mineralogi.
minesweeper	kb. kapal penyapu ranjau.
mineworker	kb. buruh tambang.
mingle	kki. bercampur, bergaul (with dengan).
miniature	kb. miniatur. -ks. kecil. m. camera kamera kecil.
minimal	ks. paling sedikit/rendah.
minimize	kkt. 1 meremehkan (a problem). 2 memperkecil (dispute, trouble).
minimum	kb. minimum. rain has been at a m. hujan mencatat angka paling rendah. -ks. paling rendah, terendah. m. wage upah paling rendah.
minion	kb. kaki tangan, antek.
miniskirt	kb. rok mini.
minister	kb. 1 rel.: pendeta. 2 (foreign service) duta (besar). 3 menteri (of defense). -kki. melayani, meladeni (to s.o's needs).
ministerial	ks. 1 rel.: mengenai kependetaan. 2 mengenai kementrian.
ministry	kb. (j. -ries) 1 kementrian, departemen. 2 rel.: jabatan sebagai pendeta.
mink	kb. 1 semacam cerpelai. 2 bulu binatang cerpelai.
minn.	[minnesota] negarabagian a.s.
minnow	kb. semacam ikan yang amat kecil.
minor	kb. 1 orang yang belum dewasa. 2 acad.: pelajaran tambahan. -ks. 1 kecil (surgery, accident). 2 minor. m. key nada minor. -kki. to m. in mengambil pelajaran tambahan dalam.
minority	kb. (j. -ties) 1 minoritas. 2 golongan kecil. m. report laporan golongan kecil.
mint	kb. 1 permen. mints j. gula-gula permen. 2 arta yasa, percetakan uang logam. -kkt. 1 mencetak (money). 2 membentuk, menciptakan (a phrase).
minus	ks. kurang. a - a kurang. -kd. 1 kurang. 2 kekurangan.
minuscule	ks. amat kecil, kerdil sekali.
minute	kb. menit. ten minutes to eight jam delapan kurang sepuluh menit. -minutes j. notilen, laporan. m. hand jarum panjang.
miracle	kb. 1 keajaiban. 2 kekuatan gaib. m. drug obat manjur, antibiotika.
miraculous	ks. ajaib, yang menakjubkan.
mirage	kb. khayalan belaka, pembayangan udara.
mire	kb. lumpur (yang lembut dan dalam). -kkt. menjadikan terperosok. the truck was mired in mud truk itu terperosok kedalam lumpur.
mirror	kb. cermin. m. image bayangan (terbalik). -kkt. mencerminkan (o's view). the trees mirrored in the water pohon-pohon itu terbayang didalam air itu.
mirth	kb. keriangan, kegembiraan.
misadventure	kb. kesialan, kecelakaan, nasib celaka.
misadvise	kkt. memberi petunjuk yang salah.
misanthrope	kb. orang yang benci kepada orang.
misapply	kkt. (misapplied) menyalahgunakan.
misapprehension	kb. salah pengertian. to be under some m. ada dibawah/didalam sesuatu salah pengertian.
misappropriate	kkt. menyalahgunakan, menggelapkan, menyelewengkan.
misappropriation	kb. penyalahgunaan, penyelewengan, penggelapan.
misbehave	kki. berbuat jahat, berlaku tak pantas.
misbehavior	kb. kelakuan yang buruk/jahat.
miscalculate	kkt., kki. keliru perhitungan, salah hitung.
miscalculation	kb. kesalahan hitung.
miscarriage	kb. 1 keguguran (kandungan). 2 kegagalan (of justice).
miscarry	kki. (miscarried) 1 keguguran. 2 gagal (of plans).
miscast	kkt. salah pilih.
miscegenation	kb. perkawinan antara suku atau bangsa.
miscellaneous	ks. bermacam-macam, berapa macam, serbaaneka.
miscellany	kb. (j. -nies) varia, puspagaram, bungarampai.
mischance	kb. nasib buruk, kesialan.
mischief	kb. 1 kejahatan, kenakalan. 2 kerusakan. to get into m. bertengkar, berkelahi. mischief-maker pengacau, tukang recok.
mischievous	ks. nakal, merecok, jahat.
miscomprehension	kb. salah tampa, kesalahpahaman.
misconception	kb. salah paham.
misconduct	kb. kelakuan tidak senonoh, perbuatan jahat.
misconstrue	kkt. salah mengerti/menanggapi.
miscount	kb. salah hitung. -kki. salah menghitung.
miscue	kb. 1 pukulan yang salah. 2 kesalahan, kekeliruan.
misdeed	kb. kelakuan yang tak senonoh, kelakuan buruk.
misdemeanor	kb. pelanggaran hukum (yang ringan), pidana enteng, tindak-pidana yang tergolong ringan.
misdirect	kkt. mengarahkan ke jurusan yang salah.
miser	kb. orang kikir/pelit.
miserable	ks. 1 tidak senang. 2 yang menyedihkan. 3 miskin, sengsara. -miserably kk. sangat buruk, tidak keruan.
miserly	ks. kikir, pelit.
misery	kb. (j. -ries) kesengsaraan. to put an animal out of its m. membunuh seekor binatang.
misfire	kki. 1 macet (of a gun). 2 gagal.
misfit	kb. orang yang canggung, orang yang tak dapat mencocokkan diri.
misfortune	kb. kemalangan.
misgiving	kb. perasaan was-was/kuatir.
misguided	ks. tersesat, salah jalan.
mishandle	kkt. 1 menyalahgunakan (funds). 2 menganiaya (seseorang).
mishap	kb. kecelakaan.
mishear	kkt., kki. salah mendengar.
misinform	kkt. memberi keterangan yang salah.
misinformation	kb. keterangan yang salah.
misinterpret	kkt. salah menafsirkan.
misinterpretation	kb. salah-tafsir, kesalahan menafsirkan.
misjudge	kkt. 1 salah menilai. 2 salah dalam mengadili.
mislaid	lih mislay.
mislay	kkt. (mislaid) salah meletakkan/menaruhkan.
mislead	kkt. (misled) menyesatkan. -misleading ks. yang menyesatkan.
misled	lih mislead.
mismanage	kkt. salah mengurus.
mismanagement	kb. salah urus.
mismatch	kb. pertandingan yang tidak sebanding. -kkt. tak sebanding/sepadan.
misname	kkt. salah memberi nama.
misnomer	kb. 1 nama yang salah. 2 istilah yang tak cocok.
misogyny	kb. kebencian terhadap wanita.
mispelt	lih misspell.
misplace	kkt. salah menaruhkan. misplaced trust kepercayaan yang salah letak.
mispronounce	mispronounce
mispronunciation	kb. salah ucap(an).
misquote	kkt. salah mengutip.
misread	kkt. (misread/misred/) salah membaca.
misrepresent	kkt. salah dalam menggambarkan. to m. the facts berbuat salah dalam mengemukakan kenyataan-kenyataan, mengemukakan kenyataan-kenyataan yang tidak benar.
misrepresentation	kb. penggambaran/penyajian yang keliru.
misrule	kb. pemerintahan yang salah, salah-atur.
miss	kb. nona. -kkt. 1 tidak menangkap (a ball). 2 merindukan (a loved one). 3 salah menanggapi (the point). 4 tidak mendengar (s.o's name). 5 absen (a class). 6 tak menjumpai. 7 melalaikan. 8 kehilangan. 9 tidak dapat. -missing ks. yang lepas.
miss.	[mississippi] negara bagian a.s.
misshapen	ks. berbentuk yang tidak serasi.
missile	kb. peluru, proyektil, misil. m. site tempat peluncuran peluru. guided m. peluru kendali.
mission	kb. 1 tugas. what's your m. in life ? apa tugasmu dalam hidup ini ? 2 perutusan, utusan (u.n.). 3 misi (church).
missionary	kb. kb. (j. -ries) 1 utusan/pekabar injil. 2 (islam) da'iyah, muallim, penganjur.
missionize	kkt. mendakwahkan.
missouri	kb. inf.: i'm from m. saya skeptis.
misspeak	kkt., kki. (misspoke, misspoken) 1 salah bicara. 2 salah ucap.
misspell	kkt. (misspelled atau misspelt) salah mengeja. -misspelling kb. salah ejaan.
misspent	ks. dibuang-buang, salah dipergunakan.
misspoke(n)	lih misspeak.
misstate	kkt. salah mengutarakan (the case).
misstatement	kb. pernyataan yang salah.
misstep	kb. langkah/perbuatan salah, kesalahan.
mist	kb. halimun. -kki. berkabut, ada kabut.
mistake	kb. kesalahan, kekeliruan. it was my m. saya yang bersalah. -kkt. (mistook, mistaken) salah mengira. i mistook him for his brother saya kira dia abangnya. -mistaken ks. keliru, salah.
mistaken	lih mistake.
mister	kb. (j. messrs.) 1 tuan, saudara. -meassrs j. tuan-tuan.
mistook	lih mistake.
mistranslate	kkt. salah menterjemahkan.
mistranslation	kb. terjemahan yang salah.
mistreat	kkt. menganiaya.
mistreatment	kb. penganiayaan.
mistress	kb. 1 nyonya rumah. 2 kekasih, gundik. 3 nyonya. the dog's m. nyonya pemilik anjing.
mistrial	kb. pengadilan yang salah.
mistrust	kb. kecurigaan, ketidakpercayaan. -kkt. mencurigai, tidak mempercayai.
misty	ks. berkabut. misty-eyed ks. sedih, bermata kuyu/luyu.
misunderstand	kkt. (misunderstood) salah mengerti, keliru menangkap/memaham. -misunderstanding kb. salah paham.
misunderstood	lih misunderstand.
misuse	kb. penyalahgunaan. -kkt. menyalahgunakan.
mite	kb. 1 sedikit sekali. to give o's m. to memberikan serba sedikit kepada. 2 tungau, tengu. -kk. inf.: agak.
mitigate	kkt. meredakan, mengurangi.
mitigation	kb. peringanan, kelonggaran.
mitten	kb. sarung tangan.
mix	kb. adonan, campuran (of cake). -kkt. 1 mencampurkan (chemicals, a salad). 2 membuat adonan (cake). 3 mengawinkan (flower seeds). mix-up kb. kekacauan, kesimpang-siuran. -mixed ks. 1 bercampur. 2 macam-macam. mixed-up ks. bingung.
mixer	kb. 1 alat pencampur listrik. 2 seorang yang pandai bergaul. 3 pesta perkenalan.
mixture	kb. campuran.
mm.	[millimeter] milimeter.
mnemonic	ks. yang membantu ingatan/menghafal.
mo.	[month(s)] bulan.
moan	kb. suara mengerang, rintihan. -kki. mengerang, merintih, mengeluh.
moat	kb. parit (dikelilingi benteng).
mob	rakyat banyak, gerombolan orang banyak. -kkt. (mobbed) mengepung, mengerumuni. m. rule hukum rimba.
mobile	ks. 1 cempala, aktip, giat, gesit, ringan tangan. 2 mobil. americans are very m. orang-orang amerika suka berpindah-pindah tempat.
mobility	kb. (j. -ties) gerakan, mobilitas. m. of society mobilitas masyarakat.
mobilization	kb. moblisasi, pengerahan.
mobilize	kkt. mengerahkan.
moccasin	kb. sepatu sandal (bangsa indian).
mock	ks. tiruan, pura-pura, ejekan. m. trial pengadilan pura-pura. -ks. ecek-ecek. -kkt. mentertawakan, memperolok-olokkan. mock-up kb. maket, contoh bikinan. -mocking ks. menghina, mengejek.
mockery	kb. (j. -ries) olok-olok, penghinaan, ejekan.
modal	ks. yang berhubungan dengan perasaan. gram. m. auxiliary kata-bantu pengandaian.
mode	kb. cara, mode. m. of payment cara pembayaran. subjunctive m. cara andai.
model	kb. 1 cloth.: peragawati. 2 model. 3 contoh, teladan. 4 merek (of car). -kkt. memperagakan (clothes) to m. o.s. after/on meniru, mengikuti jejak. -modeling kb. pekerjaan peragawati, keperagawatian.
moderate	kb. orang moderat, orang yang lunak. -ks. 1 layak, yang sekedarnya (of profit). 2 cukupan. 3 sedang (size, meal). 4 moderat, lunak. -kkt. mengetuai (a meeting). -kki. menjadi mendingan. -moderately kk. sedang, cukupan.
moderation	kb. sikap sedang, sikap tidak berlebih-lebihan. in m. tidak berlebih-lebihan, secara terbatas.
moderator	kb. 1 ketua (of meeting). 2 pelerai, penengah (of dispute).
modern	kb. orang yang modern. -ks. moder(e)n. m. house rumah yang modern.
modernistic	ks. model baru (of house).
modernity	kb. kemodernan, modernisasi, pembaharuan, pemodernan.
modernize	kkt. memodernisasi(kan), memoderenkan.
modest	ks. 1 rendah hati, sederhana (in o's attitude). 2 sedang (of income). 3 sopan. -modestly kk. 1 sederhana. 2 dengan rendah hati.
modesty	kb. (j. -ties) 1 kesederhanaan, kerendahan hati. 2 kesopanan.
modicum	kb. jumlah kecil. with a m. of effort dengan sedikit usaha.
modification	kb. modifikasi, perubahan.
modifier	kb. gram.: kata yang menentukan sifat.
modifies	lih modify.
modify	kkt. (modified) 1memodifikasi, mengubah (plans). 2 membatasi (a noun). 3 mengurangi (o's demands).
modulate	kkt. mengatur, memodulasi.
modulation	kb. modulasi.
module	kb. modul.
mohammedanism	kb. agama islam.
moist	ks. basah.
moisten	kkt. membasahkan (a rag, sponge). her eyes moistened air matanya berlinang.
moisture	kb. embun(an), uap lembab.
moistureproof	ks. tahan lembab.
molar	kb. geraham.
molasses	kb. ceng, sirop gula, tetes.
mold	kb. 1 cetakan (for cookies). 2 jamur (on books). -kkt. 1 membentuk (character). 2 mencetak, membentuk (dough). -molding kb. papan hias tembok.
moldy	ks. 1 apak (of odor). 2 berjamur, bulukan (of food).
mole	kb. 1 tahi lalat. 2 fauna : tikus mondok.
molecular	ks. yang berhubungan dengan molekul. m. weight berat molekul.
molecule	kb. molekul.
molehill	kb. onggokan tanah yang dibuat oleh tikus mondok. to make a mountain out of a m. sekepal menjadi gunung.
molest	kkt. menganiaya, mengganggu.
molestation	kb. penganiayaan, gangguan.
mollifies	lih mollify.
mollify	kkt. (mollified) meredakan, mengamankan.
mollusk	kb. kerang-kerangan.
molotov	kb. sl.: m. cocktail granat bensin.
molt	kki. berganti bulu atau kulit.
molten	lih melt.
moluccas	kb., j. maluku.
mom	kb. inf.: bu, mami.
moment	kb. 1 saat, momen. the right m. saat yang tepat. 2 sebentar. one m. ! wait a m. ! tunggu sebentar ! 3 waktu. at a moment's notice sewaktu-waktu, kapan saja.
momentary	ks. sebentar. to show m. hesitation menunjukkan keragu-raguan sebentar. -momentarily kk. sebentar lagi.
momentous	kb. penting. m. occasion peristiwa yang penting.
momentum	kb. 1 daya gerak, kepesatan. 2 semangat.
monarch	kb. raja.
monarchy	kb. (j. -chies) kerajaan.
monastery	kb. (j. -ries) biara.
monastic	ks. yang berhubungan dengan biara. m. order golongan biarawan/biarawati.
monday	kb. (hari) senin/senen.
monetary	ks. moneter. m. value harga moneter. m. unit kesatuan moneter.
money	kb. 1 uang. 2 untung. m. box tabung(an). m. mad mata duitan. money-maker orang/barang yang mendatangkan banyak uang. money-making ks. yang mendatangkan uang. m. order poswesel.
moneychanger	kb. penukar uang.
moneyed	ks. beruang, berada, kaya.
moneygrubber	kb. buaya uang, mata duitan.
moneylender	kb. cety, lintah darat.
mongoose	kb. semacam musang, luwak.
mongrel	kb. anjing bastar/kampung. 2 orang bastar.
monitor	kb. 1 murid yang membantu menjaga kerapian kelas dan mengambil absensi. 2 penerima/pencatat/ pendengar siaran-siaran radio/tv/ telepon. -kkt. menangkap (broadcasts).
monk	kb. rahib, biarawan.
monkey	kb. kera, monyet. inf.: to make a m. out of s.o. memperolok-olokkan seseorang, menjadikan seseorang sasaran olok-olok. -kki. inf.: mempermain-mainkan. sl.: m. business kenakalan, penipuan, tipu- muslihat. m. wrench kunci inggeris.
monkeyshine	kb. sl.: tipu daya, lelucon.
monochrome	kb. satu warna.
monogamous	ks. yang berhubungan dengan monogami.
monogamy	kb. monogami.
monogram	kb. monogram, lukisan huruf.
monograph	kb. risalah, karang (ilmiah), monografi.
monolingual	ks. satu bahasa.
monolithic	ks. monolitis.
monologue	kb. bicara sendiri.
mononucleosis	kb. penyakit karena klintir darah putih yang abnormal.
monopolistic	ks. yang bersifat monopoli. m. practices praktek-praktek monopoli.
monopolize	kkt. memonopoli (trade, s.o.'s time).
monopoly	kb. (j. -lies) monopoli.
monorail	kb. kereta-api/rel tunggal.
monosyllabic	ks. bersuku satu.
monosyllable	kb. kata bersuku satu.
monotheism	kb. monotheisme.
monotone	kb. nada yang datar/sama.
monotonous	ks. yang membosankan.
monotony	kb. sifat yang membosankan.
monoxide	kb. monoksid.
monsoon	kb. 1 angin musim. 2 musim hujan.
monster	kb. 1 raksasa. m. demonstration demonstrasi raksasa/besar-besaran. 2 binatang ganjil. he's a m. when he gets mad dia menakutkan sekali kalau marah.
monstrosity	kb. (j. -ties) barang ganjil, benda yang aneh sekali bentuknya.
monstrous	ks. 1 besar sekali (of a person or thing). 2 dahsyat.
mont.	[montana] negara bagian a.s.
month	kb. bulan. m. of june dalam bulan juni.
monthly	kb. (j. -lies) (majalah) bulanan. -ks. tiap-tiap bulan. m. magazine majalah bulanan. m. meeting rapat bulanan.
monument	kb. 1 tugu, monumen. 2 karya besar.
monumental	ks. sangat besar. m. task tugas yang amat besar. m. work karya yang penting.
moo	kb. uak, wak. -kki. menguak, melenguh.
mooch	kki. sl.: meminta-minta (off kepada).
mood	kb. 1 keadaan jiwa, suasana hati. he's in a bad m. dia sedang murung hatinya. 2 gram.: modus.
moodiness	kb. kemurungan, kemasgulan hati.
moody	ks. suka murung.
moon	kb. bulan, rembulan. full m. bulan purnama. -kki. mundar-mandir tak tentu arah. m. landing pendaratan di bulan. m. probe roket penyelidik bulan.
moonbeam	kb. cahaya bulan.
moonlight	kb. sinar bulan. m. night malam terang bulan. -kki. inf.: bekerja sambilan, ngobyek.
moonlit	ks. terang bulan.
moonshine	kb. inf.: minuman keras yang dibuat secara gelap.
moor	kkt. menambatkan. -kki. menambat. -mooring kb. tambatan. the moorings snapped tambatan kapal itu putus.
moose	kb. rusa besar.
moot	ks. yang dapat diperdebatkan. m. point soal yang dapat diperbincangkan.
mop	kb. 1 (alat) pengepel. 2 ragbol. -kkt. (mopped) 1 mengepel (the floor). 2 menyapu/menghapus (o's brow). to m. up 1 membersihan (milk, water). 2 mengadakan pembersihan (of troops). mop-up kb. pembersihan (terhadap sisa-sisa).
mope	kki. bermuram (durja).
moral	kb. moral, akhlak. -morals j. akhlak. -ks. moril. -morally kk. secara moril, dari segi kesusilaan.
morale	kb. moril, semangat juang.
morality	kb. (j. -ties) kesusilaan, moralitas.
moralize	kki. memoralisasikan, memperbincangkan soal salah-benar. -moralizing kb. khotbah, pidato.
morass	kb. 1 paya, rawa. 2 (bureaucratic) kekacau-balauan.
moratorium	kb. penundaan, pertangguhan.
morbid	ks. 1 abnormal, tidak wajar (curiosity). 2 tak sehat/waras (personality). 3 yang mengerikan. m. details hal-hal kecil-kecil yang mengerikan.
more	kb. buah lagi. i need two m. saya perlu dua lagi. -ks. 1 lagi. 2 lebi banyak. -kk. lebih. once m. sekali lagi. m. and m. semakin, kian lama... kian. m. or less kurang lebih.
moreover	kk. selain itu, lagi pula, tambahan lagi.
mores	kb., j. adat-istiadat.
morgue	kb. rumah mati.
moribund	ks. hampir mati, hampir menemui ajal, senen-kemis.
morning	kb. pagi. good m. ! selamat pagi ! in the m. a) pada pagi hari. b) besok pagi. m. prayer sembahyang subuh. m. sickness muak di waktu pagi (tanda hamil). m. star bintang timur.
moron	kb. orang pandir/tolol, si bendul.
moronic	ks. pandir.
morose	ks. muram, murung.
morpheus	kb. in the arms of m. sedang enak-enak tidur.
morphine	kb. morfin.
morphology	kb. (j. -gies) morfologi, ilmu bentuk kata.
morse	kb. m. code kode/sandi morse.
morsel	kb. butir, potong.
mortal	kb. makhluk hidup. -ks. 1 yang mematikan. m. blow pukulan yang mematikan. 2 besar sekali. m. terror ancaman yang besar sekali. -mortally kk. yang menuju kematian.
mortality	kb. (j. -ties) 1 kematian, pemanutan, mortalitas. m. rate angka kematian. 2 kemungkinan kematian.
mortar	kb. 1 (gun) mortir. 2 adukan semen. 3 lesung, lumpang. m. and pestle alu dan lumpang, penumbuk dan lesung.
mortarboard	kb. topi mahasiswa.
mortgage	kb. hipotek. -kkt. 1 menghipotekkan (a house). 2 menggadaikan (o's soul)
mortician	kb. pemilik perusahaan pemakaman.
mortification	kb. 1 malu, aib. 2 kebekuan pembuluh/syaraf di tubuh.
mortified	lih mortify.
mortifies	lih mortify.
mortify	kkt. (mortified) 1 membuat malu, memalukan. 2 med.: kena kelemayuh.
mortuary	kb. (j. -ries) rumah/kamar mayat.
mos.	[months] bulan-bulan.
mosaic	kb. mosaik, kepingan batu.
moslem	kb. orang islam, muslim. the m. world dunia islam.
mosque	kb. mesjid.
mosquito	kb. nyamuk. m. net kelambu. m. netting kain jkelambu, kawat kasa.
moss	kb. lumut.
mossy	ks. berlumut.
most	kb. sebagian terbesar. m. of his money sebagian terbesar uangnya. -ks. yang terbanyak. -kk. 1 paling. 2 sangat, amat. -mostly kk. kebanyakan.
motel	kb. motel.
moth	kb. ngengat. m. ball kapur barus. moth-eaten ks. usang,dimakan ngengat (of books, clothes).
mother	kb. 1 ibu. my m. ibuku. 2 induk. this is the m. of that kitten inilah induk anak kucing itu. 3 biang. -kkt. mengasuh (a child). m. country ibu pertiwi, negeri asal. mother-in-law ibu mertua. mother's day hari ibu. m. ship kapal induk.
motherhood	kb. keibuan.
motherland	kb. tanah air, tanah tumpah darah, ibu pertiwi.
motherly	ks. dari/seperti ibu. m. affection for kecintaan ibu terhadap.
mothproof	ks. tahan ngengat.
motif	kb. motif, tema.
motion	kb. 1 gerakan (of a car, ship). 2 law : mosi, usul. -kkt., kki. memberi isyarat (dengan tangan, kepala dsb). m. picture gambar-hidup, bioskop. m. sickness mabuk kalau naik mobil dll.
motionless	ks. tak bergerak.
motivate	kkt. mendorong, menyebabkan. he is simply not motivated dia jelas belum mendapat perangsang.
motivation	kb. (peng)alasan, daya batin, dorongan, motivasi.
motive	kb. alasan, sebab. m. power daya (peng)gerak. -motives j. prayojana.
motley	ks. 1 aneka-warna, bermacam-macam warna. 2 campuran (of a group).
motor	kb. motor, mesin. m. court motel. -kki. naik mobil. motor-driven ks. digerakkan. -motoring kb. bertamasya mengendarai mobil.
motorbike	kb. sepeda motor/kumbang.
motorboat	kb. sekoci/perahu motor.
motorcade	kb. iring-iringan mobil.
motorcar	kb. mobil, oto.
motorcoach	kb. bis.
motorcycle	kb. sepeda motor. -kki. bersepeda- motor.
motorcyclist	kb. pengendara sepeda motor.
motorist	kb. pengendara/pengemudi mobil.
motorization	kb. motorisasi.
motorize	kkt. memperlengkapi dengan mesin atau motor. -motorized ks. bermotor.
motorman	kb. (j. -men) masinis trem listerik atau trem dibawah tanah.
motorship	kb. kapal motor.
mottled	ks. burik, bercorang-coreng.
motto	kb. motto, semboyan.
mould	= mold.
mound	kb. gundukan (tanah), busut, burial m. tumpukan tanah kuburan.
mount	kb. 1 gunung, puncak. 2 kuda tunggangan. -kkt. 1 menaiki, menunggang (a horse). 2 menyusun (a program). 3 menempelkan (stamps). 4 menjaga. -kki. naik. -mounting kb. ganjalan/bantalan.
mountain	kb. gunung. m. chain bukit barisan. m. peak/top puncak gunung. m. range pegunungan.
mountaineer	kb. 1 pendaki gunung. 2 penduduk di gunung.
mountainous	ks. 1 bergunung-gunung. 2 besar sekali (of waves).
mountainside	kb. lereng/sisi gunung.
mourn	kkt. berdukacita atas (the loss of s.o.). -kki. berkabung. to m. over berdukacita/belasungkawa/berkabung atas. -mourning kb. perkabungan.
mourner	kb. orang yang berkabung.
mournful	mournful
mouse	kb. (j. mice) tikus. m. deer kancil, pelanduk.
mousetache	kb. kumis, brengos, misai.
mousetrap	kb. perangkap tikus.
mouth	mouth
mouthful	kb. sesuap. sl.: to say a m. mengatakan sesuatu hal yang penting.
mouthwash	kkb. obat/air kumur.
movable	ks. 1 dapat digerakkan. 2 dapat dipindah-pindahkan.
move	kb. 1 langkah. 2 giliran (in chess). 3 buang air besar. 4 perpindahan (to ohio). -kkt. 1 memindahkan (furniture, chessman). 2 menggerakkan hati, mengubah pendirian. 3 membuang, mengeluarkan. 4 mengusul. -moving kb perpindahan.
movement	kb. 1 gerak-gerik. 2 lenggak-lenggok. 3 berak. 4 pergerakan. 5 jalan (of a watch). 6 irama (of a syimphony). pol.: gerakan.
mover	kb. tukang boyongan, tukang memindahkan barang-barang.
movie	kb. gambar hidup, bioskop. is there a good m. on ? apakah ada pilem yang baik hari ini ? -movies j. gambar hidup. m. camera kamera pilem. m. theater gedung bioskop.
moviegoer	kb. pencandu/penonton bioskop.
mow	kb. tempat menyimpan padi-padian.
mower	kb. mesin potong rumput.
moxie	kb. 1 sl.: keberanian. 2 sl.: ketrampilan.
mp	[military police] polisi militer.
mr., mr	[mister] tuan. mr. chairman. saudara ketua. mr. president bapak presiden, saudara presiden.
mrs.	[mistress] 1 nyonya. 2 ibu.
ms,ms	[manuscript] naskah.
ms.	[ = mrs. atau miss] nyonya atau nona.
mss,mss	[manuscripts] naskah-naskah.
mst	[mountain standard time] waktu tolok gunung.
mt.	[mount] gunung.
mtg.	[meeting] rapat, pertemuan.
much	kb. banyak. there is m. to be done banyak yang harus dikerjakan. -ks. banyak. -kk. jauh. much-admired ks. yang mendapat banyak penghargaan. -muchly kk. sangat banyak.
mucilage	kb. perekat cair, getah.
muck	kb. kotoran.
muckrake	kki. membuka korupsi.
mucous	ks. m. membrane selaput lendir.
mucus	kb. lendir, getah, ingus.
mud	kb. lumpur. to throw m. menjelek-jelekkan, memburukkan. m. puddle kobakan.
mudbank	kb. tebing lumpur.
muddle	kb. kacau(-balau), campuraduk, berantakan. everything is in a m. semua kacau-balau. -kki. to m. through mengatasi.
muddy	ks. 1 berlumpur, becek (of shoes, road). 2 keruh (of water). -kkt. (muddied) mengeruhkan, membecekkan.
mudgard	kb. spatbor.
mudslinger	kb. tukang fitnah.
muff	kb. semacam sarung tangan bulu. -kkt. menyia-nyiakan.
muffin	kb. sejenis kue.
muffler	kb. 1 saringan. 2 selendang.
mug	kb. 1 mangkuk, piala. beer m. buli-buli bir. 2 sl.: muka. -kkt. sl.: (mugged) membegal, menjabal. -mugging kb. penjabalan.
mugger	kb. sl.: pembegal, perampok, buaya.
mugginess	kb. kelembaban.
muggy	ks. panas dan lembab.
mulatto	kb. peranakan negro dengan kulit putih.
mulberry	kb. (j. -ries) bebesaran.
mulch	kb. jerami (yang setengah busuk) dan rumputan (untuk pupuk).
mule	kb. bagal.
mull	kki. inf.: memikirkan, mempertimbangkan. to m. s.t. over mempertimbangkan sesuatu.
multicolored	ks. beraneka-warna.
multifaceted	ks. beraneka segi.
