sheen	kb. kemilau, kilau (of materials).
sheep	kb. biri-biri, domba.
sheepish	ks. malu(-malu).
sheepishness	kb. perasaan malu/tersipu-sipu.
sheepskin	sheepskin
sheer	ks. 1 tipis (of clothing). 2 curam, terjal. 3 belaka.
sheet	kb. 1 seperai, alas tilam (for a bed). 2 lembar, helai. -sheeting kb. kain seperai.
sheikh	kb. syekh.
shelf	kb. (j. shelves) 1 (papan) rak. 2 beting.
shell	kb. 1 kulit (of a nut). 2 (sea-) kerang. 3 rumah (of snail, turtle). 4 selongsong (of cartridge). 5 geranat. 6 tempurung, batok (of coconut). 7 kerangka (of burned-out building). -kkt. 1 menguliti, mengupas kulit (nuts, peas). 2 menembaki, menggeranat.
shellac	kb. lak, laka, lakeri. -kkt. 1 melapisi dengan lak. 2 sl.: mengalahkan. -shellacking kb. sl.: kekalahan.
shellfire	kb. tembakan meriam (yang gencar). to be under s. mendapat tembakan meriam gencar.
shellfish	kb. (ikan) kerang-kerangan.
shelter	kb. 1 (tempat) perlindungan. 2 lindungan, naungan. -kkt. 1 memberi tempat, menginap kepada. 2 berlindung/bersembunyi kepada, menyembunyikan (a fugitive). -sheltered ks. tersembunyi, bersembunyi.
shelve	kkt. 1 menyusun diatas rak-rak. 2 menangguhkan, mengesampingkan (a bill, law). 3 mengesampingkan, menyisihkan. -shelving kb. papan untuk rak.
shelves	lih shelf.
shenanigans	kb., j. inf.: olok-olok, main gila. cut out the s. ! jangan main gila !.
shepherd	kb. 1 gembala. s. dog anjing gembala. 2 pelindung. -kkt. menuntun.
sherbet	kb. serbat.
sheriff	kb. kepala polisi daerah.
sherry	kb. (j. -ries) minuman anggur (manis).
shibboleth	kb. semboyan (partai).
shied	lih shy.
shield	kb. 1 perisai (armor). 2 pelindung. 3 perlindungan. -kkt. melindungi (o's eyes).
shier	lih shy.
shies	lih shy.
shiest	lih shy.
shift	kb. perubahan (in poans). 2 penggeseran (in emphasis). 3 (dress) pakaian yang agak longgar. 4 perubahan (in the wind). 5 regu. 6 perpindahan (in ship's cargo). 7 auto.: persneling.
shiftiness	kb. kelicikan, kelihaian.
shiftless	ks. pemalas, segan bekerja.
shiftlessness	kb. kemalasan.
shifty	ks. licik, penuh tipu daya. shifty-eyed ks. mempunyai mata yang menunjukkan kelicikan.
shill	kb. sl.: penjudi, semacam calo.
shilling	kb. shilling (mata uang inggris).
shilly-shally	kki. kki. (shilly-shallied) ragu-ragu, bimbang.
shimmer	kb. kilau, cahaya gemerlapan. -kki. berkilau-kilauan, berkelip-kelip.
shimmies	lih shimmy.
shimmy	kb. (j. -mies) goncang. -kki. (shimmied) bergetar, bergoncang (of a motor).
shin	kb. garas. -kki. (shinned) to s. up memanjat (a tree).
shinbone	kb. tulang kering.
shindig	kb. sl.: pesta gembira dan riuh.
shine	kb. kilauan (on shoes). -kkt. 1 (shone) menyorotkan (a flashlight). 2 (shined) menggosok(kan), menyemir (shoes). -kki. (shone) 1 bersinar, memancar. 2 bercahaya. 3 berkilat-kilat (of silver). 4 gemilang. -shining ks. terkemuka, istimewa.
shiner	kb. sl.: mata biru/bengkak.
shingle	kb. 1 sirap (on a roof). 2 papan nama. -shingles j. med.: penyakit ruam syaraf, sinanaga. -kkt. mengatapi dengan sirap.
shiny	ks. 1 berkilauan, berkilat-kilat (of a dress, silverware). 2 licin, berkilat (of trousers through long wear).
ship	kb. kapal. -kkt. (shipped) mengirimkan, mengapalkan (goods). -kki. bekerja di kapal. -shipping kb. perkapalan, pelayaran.
shipboard	kb. kapal. on s. di kapal.
shipbuilder	kb. pembuat kapal.
shipbuilding	kb. pembuatan kapal. s. yard galangan bangunan kapal.
shipload	kb. (se)muatan kapal, sekapal. s. of coal batubara sekapal.
shipmate	kb. teman sekapal.
shipment	kb. 1 kiriman (goods). 2 pengiriman. ready for s. siap untuk diangkut/dikirim (dengan kapal dll).
shipper	kb. 1 pengirim. 2 pengangkut. 3 perusahaan ekspedisi.
shipshape	ks.,kk. dalam keadaan rapi/teratur.
shipwreck	kb. kecelakaan kapal, peristiwa kapal karam. -kkt. merusakkan kapal/orang. to be shipwreked menjadi terdampar.
shipyard	kb. galangan kapal.
shirk	kkt. melalaikan, mengelakkan (o's duty, responsibility).
shirker	kb. tukang bolos/mengeluyur, orang yang suka melalaikan kewajiban/pekerjaan.
shirr	kkt. menggoreng (eggs) dalam panci dangkal, dengan mentega, dan terkadang dengan susu dan deraian roti.
shirt	kb. kemeja, hem. sport s. baju olahraga, kemeja sport.
shirtsleeve	kb. lengan kemeja. to be in o's shirtsleeves tak memakai jas. -ks. informil.
shirttail	kb. bagian bawah kemeja.
shirtwaist	kb. blus wanita berlengan dan berkelepai
shishkebab	kb. semacam sate.
shiver	kb. getaran, gigil. -kki. menggigil, gemetar (from karena).
shoal	kb. 1 beting (off shore). 2 kawanan (of fish).
shock	kb. 1 goncangan (earth). 2 kekejutan. 3 kejut, getaran (of electricity). 4 gumpulan, kelompok (of hair). 5 seikat (of cornstalks). -shocking ks. mengejutkan. -shockingly kk. teramat,sangat, dengan sangat mengejutkan.
shocker	kb. inf.: sesuatu yang penuh sensasi, yang menegakkan bulu roma.
shockproof	ks. 1 tahan kejut(an) (of watch). 2 aman/bebas dari kejutan (of electricity)).
shod	lih shoe kkt.
shoddiness	kb. 1 mutu yang rendah (of workmanship). 2 kemesuman, kebobrokan (of the area).
shoddy	ks. 1 buruk, bobrok (of a neighborhood, house). 2 jelek, brengsek (of goods). 3 kasar/hina/ menyedihkan (treatment).
shoe	kb. 1 sepatu. 2 tapal (kuda). 3 sepatu, bantal. -kkt. (shod) memberi tapal besi, memasangi ladam (a horse).
shoebrush	kb. sikat sepatu.
shoehorn	kb. sendok sepatu, pengiah kasut.
shoelace	kb. tali sepatu.
shoemaker	kb. tukang sepatu.
shoeshine	kb. penggosokan sepatu. s. boy penggosok sepatu. s. parlor tempat menggosok sepatu.
shoestring	kb. tali sepatu.
shone	lih shine.
shoo	kseru. husy ! -kki. to s. away mengusir. shoo-in kb. kemenangan yang mudah.
shook	lih shake.
shoot	kb. 1bot.: tunas, taruk, pucuk, kecambah, toge. 2 saluran (for coal). 3 perburuan. -kseru. persetan!buset! -kkt. (shot) 1 menembak (s.o). 2 menembakkan (a gun). 3 mengajukan (questions at s.o). 4 melepaskan, menembakkan(an arrow). 5 mengarungi. 6 membuat
shooter	kb. penembak.
shooting	kb. tembak-menembak, baku tembak. s. of a film pembuatan film. s. gallery tempat latihan menembak.
shop	kb. 1 toko, kedai, warung. 2 (work-) bengkel. 3 perusahaan. -kki. (shopped) berbelanja. -shopping kb. berbelanja.
shopgirl	kb. wanita pelayan toko, pramuniaga.
shopkeeper	kb. pemilik/pengusaha toko.
shoplifter	kb. pencuri toko.
shopper	kb. pembelanja, orang yang berbelanja.
shoptalk	kb. 1 pembicaraan mengenai pekerjaan. 2 pembicaraan mengenai soal-soal kerja.
shopwindow	kb. jendela pajangan/pamer, kaca pemameran.
shopwoman	kb. (j. -women) wanita pelayan toko.
shopworn	ks. lama dijadikan pajangan, usang.
shore	kb. 1 pantai, tepi laut. 2 darat. -kkt. menopang, menggalang. shore-based ks. berpangkalan di darat.
shoreline	kb. garis pantai.
shorn	lih shear.
short	kb. 1 elec.: korsleting. 2 film : pilem pendek. -shorts j. 1 celana pendek/ kolor. 2 celana dalam. -ks. 1 pendek. 2 singkat. 3 tekor. 4 (curt) pendek, kasar. -shortly kk. 1 segera, tak lama lagi. 2 sesaat.
shortage	kb. 1 kekurangan (of food). food s. kekurangan bahan pangan. 2 ketekoran (in o's accounts).
shortcake	kb. sejenis kue. strawberry s. kue arbai.
shortcoming	kb. kekurangan, kelemahan.
shorten	kkt. memendekkan, memperpendek. to s. the time menyingkat waktu. -shortening kb. 1 penyusutan. 2 (fat) sejenis lemak.
shorthand	kb. steno(grafi), tulisan cepat.
shortness	kb. pendeknya, kependekan (of distance). s. of breath sesak
shot	lih shoot.
shotgun	kb. senapan(g) berburu. inf.: s. wedding kawin paksa.
should	lih shall.
shoulder	kb.1 bahu. 2 pundak. 3 tepi, pinggir (on a highway). 4 tengkuk. -kkt. 1 memikul (a load, responsibility). 2 menanggung (a problem). 3 memanggul (arms). shoulder-high ks., kk. setinggi bahu.
shouldn't	[should not] seharusnya tidak. lih shall.
shout	kb. sorak(an) (of joy). 2 teriak(an) for help). -kkt. 1 bersorak-sorak (approval). 2 meneriakkan. -kki. berteriak. -shouting kb. 1 sorakan-sorakan, sorak-sorai. 2 teriakan-teriakan.
shove	kb. dorongan, tolakan, sorongan. -kkt. 1 mendorong, mendesak (s.o.). 2 mendorong, mengingsut, menggeser, mengesot (furniture). 3 menerobos. 4 menyorongkan.
shovel	kb. sekop, sodok. -kkt. menodok. to s. snow menyekop salju. to s. in food menyorong makanan.
shovelful	kb. sesekop penuh.
show	kb. 1 pameran, tontonan. 2 pertunjukan. 3 pilem, bioskop. -kkt. (showed, showed or shown). 1 memperlihatkan (to kepada). 2 menunjukkan. 3 mempertunjukkan (slides). 4 menuntun. 5 mengantar(kan). 6 menaruh. -showing kb. pameran, pertunjukkan (of art).
showcase	kb. 1 lemari kodok/kaca (untuk pameran). 2 tempat dimana terlihat dengan jelas (of democracy).
showdown	kb. pertikaian, bentrokan. to call fire a s. menuntun penyelesaian/keputusan terakhir.
shower	kb. 1 hujan (sebentar). 2 dus, pancuran. 3 pesta. 4 pancaran (of sparks). -kkt. 1 menghujani, menaburi, menebari (gifts). 2 menaburkan, menjatuhkan (leaflets) (on diatas). 3 menghujani (blows). -kki. 1 mandi. 2 hujan.
showery	ks. banyak/penuh hujan. s. weather hujan angin.
showgirl	kb. gadis/pramu panggung.
showman	kb. (j. -men) 1 pemain sandiwara. 2 pemain pertunjukan.
showmanship	kb. kecakapan memainkan pertunjukan.
shown	lih show.
showpiece	kb. barang yang patut di pamerkan/ dilihat.
showplace	kb. tempat yang menarik untuk dilihat.
showroom	kb. ruang pameran, kamar pajangan.
showy	ks. 1 mengesankan, indah (display). 2 yang menyolok (of wealth).
shrank	lih shrink.
shrapnel	kb. pecahan peluru meriam.
shred	kb. carik, irisan, sobekan, cabikan. her dress was torn to shreds pakaiannnya koyak-koyak. -kkt. (shredded) 1 mencarik. 2 memarut, mengiris (coconut). shredded coconut kelapa yang diparut/diiris- iris.
shrew	kb. 1 (woman) perempuan pemberang. 2 semacam tikus.
shrewd	ks. 1 pintar, cerdas. 2 lihay, licin. s. reasoning alasan yang licik. she made a s. guess ia menerka dengan tajam.
shrewdness	kb. ketajaman pikiran/otak, kelihaian, kelicikan.
shriek	kb. 1 pekikan, jeritan (of anguish). 2 ketawa terbahak-bahak (of laughter). -kki. menjerit (from pain, fear). -shrieking kb. jeritan.
shrift	lih short shrift.
shrill	ks. (me)lengking, nyaring (of voice, whistle).
shrimp	kb. udang. he's a little s. a) ia seorang cebol. b) ia seorang yang tak berarti.
shrimpy	ks. 1 berbau udang. 2 kecil sekali, kerdil, cebol.
shrine	kb. 1 tempat (yang) suci, tempat keramat. 2 kuil (bali).
shrink	kkt. (shrank, shrunk) menyusutkan (a shirt). -kki. 1 menyusut. 2 segan-segan, bersembunyi.
shrinkage	kb. 1 penyusutan (of material). 2 berkurangnya (of profits).
shrivel	kkt. melayukan, mengerutkan, mengisutkan. -kki. to s. up menjadi layu.
shroud	kb. (kain) kapan. -kkt. 1 mengapani, membungkus (a body). 2 menyelubungi. 3 menyelimuti.
shrub	kb. semak-semak, belukar.
shrubbery	kb. (j. -ries) semak samun/belukar.
shrug	kb. angkatan (bahu). -kkt. (shrugged) mengangkat (bahu). to s. off menganggap enteng, tidak menghiraukan.
shrunk	lih shrink.
shrunken	ks. 1 yang bekurang. s. income pendapatan yang berkurang. 2 lisut, berkerut (of the face).
shuck	kb. kulit sekam. corn s. kulit buah jagung. -kkt. mengupas (corn). -shucks kseru. buset ! kampret !.
shudder	kb. rasa ngeri/jijik, rasa tak suka. -kki. merasa ngeri.
shuffle	kb. 1 (cards) kocokan. 2 seretan kaki. -kkt. 1 mengocok (cards). 2 menyeret (o's feet). -shuffling ks. berjalan dengan kaki terseret.
shun	kkt. (shunned) 1 menghindari, mengelakkan, menjauhkan diri dari (s.o.). 2 mengelakkan (an idea).
shunt	kkt. melangsir (rolling stock).
shush	kseru. husy ! sst ! -kkt. mendiamkan.
shut	kkt. (shut) 1 menutup (a door). 2 mengunci. -kkt. tertutup. shut-down kb. penutupan (of a factory). sl.: shut-eye kb. tidur. shut-in kb. penghuni yang terkurung oleh karena usia lanjut, lemah atau sakit. shut-off kb. alat penyetop/ penghentian.
shutter	kb. 1 daun penutup jendela (on a window). 2 (camera) alat pangatur cahaya, pemetik potret. -kkt. memasang daun penutup (a window for protection).
shuttle	kb. 1 text.: puntalan, kumparan. 2 transp.: bis, kereta api atau pesawat terbang yang berdinas pulang-pergi. -kki. pulang pergi dengan kereta api, pesawat terbang dsb.
shuttlecock	kb. bola bulu(tangkis), kock.
shy	ks. (shier, shiest) malu, pemalu. s. girl gadis yang pemalu. -shyly kk. kemalu-maluan.
shyness	kb. perasaan malu/segan, keseganan.
shyster	kb. pokrol bambu.
siamese	kb. orang siam. -ks. yang berkaitan dengan siam. s. cat kucing siam. s. twins kembar siam.
sib	kb. 1 saudara. 2 kaum keluarga.
sibilant	kb. bunyi berdesis.
sibling	kb. saudara kandung.
sic	kk. begitu, demikian. -kkt. (sicked) menyuruh menyerang. he sicked his dog on me ia menyuruh anjingnya menyerang saya.
sick	kb. the s. j. orang-orang yang sakit. -ks. 1 sakit. 2 memualkan, memuakkan. -sickly ks. 1 sakit-sakitan, berpenyakitan. 2 redup, suram. 3 hambar, lemah (smile).
sickbed	kb. tempat tidur orang yang sakit. he was confined to his s. ia terbaring sakit di tempat tidur.
sicken	kkt. memualkan, memuakkan. -kki. jatuh sakit. - sickening ks. yang menjijikkan/memualkan. -sickeningly kk. memualkan/memuakkan.
sickle	kb. arit, sabit.
sickness	kb. penyakit . air s. mabuk udara.
sickroom	kb. kamar sakit.
side	kb. 1 pinggang. 2 pihak. 3 sisi. 4 sebelah. 5 lambung (of a ship). 6 pinggir. 7 segi. 8sesayat, seiris (of bacon). -siding kb. 1 rr.: sepur simpang, rel langsir. 2 (wood) papan.
sideboard	kb. bupet.
sideburns	kb., j. godek, cambang.
sidecar	kb. gandengan samping (dari sepeda motor), sespan.
sidelight	kb. keterangan tambahan.
sideline	kb. 1 garis samping lapangan. 2 sambilan. -kkt. menyuruh berhenti bermain.
sidelong	ks. melirik. s. glance lirikan mata.
sidesaddle	kb. duduk miring diatas pelana.
sidesplitting	ks. sangat menggelikan, amat lucu.
sideswipe	kkt. menubruk/melanggar samping (a car).
sidetrack	kb. jalan simpangan/menyimpang. -kkt. 1 membelokkan/mengalihkan kesamping (a train). 2 menggelincirkan.
sidewalk	kb. trotoar, kakilima, jalan pinggir.
sideward(s)	kk. menuju/masuk kesamping.
sideways	kk. menyamping, miring, membujur, kesamping. to walk s. berjalan menyamping. to place a table s. menaruh meja memanjang kesamping.
sidewise	= sideways.
sidle	kki. to s. up to berjalan pelan-pelan menyamping.
siege	kb. 1 pengepungan. 2 serangan yang berlarut-larut.
sieve	kb. 1 ayakan, pengayak (flour). 2 saringan, penyaring (for tea).
sift	kkt. 1 mengayak (flour). 2 menyelidiki, menyaring (the evidence)
sifter	kb. ayak, pengayak.
sig.	1 [signal] sinyal, tanda isyarat. 2 [signature] tandatangan.
sigh	kb. keluh, napas panjang, keluh-kesah. -kki. 1 mengeluh, berkeluh-kesah. 2 mendesah, mendesau (of the wind).
sight	kb. 1 penglihatan. 2 pemandangan. 3 alat pembidik (of a rifle). 4 rupa. -kkt. melihat (land, the enemy). -sighting kb. mengadakan peninjauan/pengamatan.
sightless	kb. buta.
sightsaw	lih sightsee.
sightsee	kki. (sightsaw, sightseen). bertamasya sambil melihat-lihat, melihat-lihat pemandangan. -sightseeing kb. tamasya, berkeliling sambil melihat-lihat.
sightseen	lih sightsee.
sightseer	kb. pelancong tamasya.
sign	kb. 1 tanda. 2 papan tanda. 3 pertanda, gelagat. 4 jejak. 5 isyarat. 6 lampu. -kkt., kki. 1 menandatangani (a letter, document) 2 membubuhkan, menaruhkan (o's initials). -signed ks. tertanda.
signal	kb. 1 tanda, sinyal. 2 isyarat (from outer space). -ks. gemilang. -kkt. 1 memberi isyarat. 2 mengirimkan (congratulations) -kki. memanggil. -signaling kb. pemberian isyarat.
signalize	kkt. 1 menonjolkan, menjadikan terkenal. 2 memberi perhatian (kepada). 3 memberi isyarat kepada.
signatory	kb. (j. -ries) peserta penanda-tangan.
signature	kb. tanda-tangan.
signboard	kb. papan merek/tanda.
signer	kb. penanda-tangan.
signet	kb. cap, segel, stempel. s. ring cincin cap.
significance	kb. arti. the meeting was one of great s. pertemuan penting sekali artinya.
significant	ks. penting, berarti. a s. day in our history hari yang penting dalam sejarah kita.
signification	kb. arti, pengertian, penunjukan.
signified	lih signify.
signifies	lih signify.
signify	kkt. (signified) 1 menandakan. 2 memberitahukan (o's intention). 3 berarti.
signpost	kb. papan arah, papan penunjuk jalan.
silage	kb. makanan ternak yang disimpan dalam gudang yang tertutup rapat-rapat.
silence	kb. kesunyian, keheningan. -kkt. 1 mendiamkan (s.o.). 2 menghilangkan, melenyapkan (o's doubts). 3 membungkamkan (criticism).
silent	ks. 1 diam. 2 bisu. 3 sunyi. 4 dalam hati. -silently kk. dengan diam
silhouette	kb. bayangan hitam, garis keliling bayang-bayang lukisan sesuatu. -kkt. membayangkan dalam garis-garis besar.
silk	kb. sutera. s. blouse blus sutera.
silken	ks. dari sutera.
silkworm	kb. ulat sutera.
silky	ks. seperti sutra. s. appearance rupanya seperti sutera.
sill	kb. bendul, ambang.
sillable	kb. suku-kata.
silliness	kb. kedunguan, ketololan, kepandiran.
silly	ks. 1 pandir, tolol. 2 lucu.
silo	kb. agri.: gudang tertutup tempat menyimpan makanan ternak. 2 mil.: tempat peluncuran peluru (kendali) dibawah tanah (for launching missiles).
silt	kb. slib, mendap, (endapan) lumpur. -kki. to s. up tertimbun lumpur (of harbor, river).
silver	kb. 1 perak. 2 alt-alt (makan) dari perak, sendok-garpu. silver-plated ks. berlapis perak. -silver-tongued ks. pasih bicara, pandai berpidato.
silverfish	kb. gegat.
silversmith	kb. pandai perak.
silverware	kb. 1 barang-barang perak. 2 alat-alat makan, sendok-garpu.
silvery	ks. 1 seperti perak. s. sheen kilau putih seperti perak. 2 merdu (voice).
simian	kb. sejenis monyet.
similar	ks. serupa, mirip. -similarly kk. dengan cara yang sama, demikian pula, sama halnya (dengan).
similarity	kb. (j. -ties) kesamaan.
simile	kb. tamsil(an), kiasan.
simmer	kki. 1 (cooking) mendidih dengan perlahan-lahan. 2 membara.
simper	kki. tersenyum-simpul, tersenyum bodoh.
simple	ks. 1 sederhana, bersahaja. 2 mudah, gampang.3 dungu. 4 biasa. 5 tunggal (substance). -simply kk. 1 dengan sederhana. 2 sama sekali,benar-benar. 3 benar-benar, sungguh-sungguh. 4 hanya.
simpleton	kb. orang yang tolol.
simplicity	kb. (j. -ties) kesederhanaan. the plan is s. itself rencna itu benar-benar sederhana.
simplification	kb. penyederhanaan.
simplified	lih simplify.
simplifies	lih simplify.
simplify	kkt. (simplified) menyederhanakan, mempermudah. simplified spelling ejaan yang disederhanakan.
simply	lih simple.
simulate	kkt. 1 menirukan. 2 pura-pura (frienship for s.o.). 3 mendalihkan.
simulation	kb. pekerjaan tiruan/meniru. s. of the moon landing gambaran tiruan/buatan mengenai pendaratan di bulan.
simulator	kb. benda pengganti yang sebenarnya.
simultaneity	kb. kejadian pada waktu yang bersamaan, keserempakan, keserentakan.
simultaneous	ks. bersama. s. reaction reaksi bersama. -simultaneously kk. secara serempak/serentak.
sin	kb. dosa. to commit a s. berbuat dosa. -kki. (sinned) berdosa (against terhadap). -sinning kb. perbuatan dosa.
since	kk. 1 sejak itu. -kd. semenjak. -ksamb. 1 karena. 2 sejak.
sincere	ks. tulus hati. 2 bersungguh-sungguh. -sincerely kk. sungguh-sungguh.
sincerity	kb. (j -ties) ketulusan( hati), kesungguhan hati, keikhlasan.
sine	kb. sinus.
sinecure	kb. pekerjaan yang amat enteng.
sinew	kb. urat daging, otot.
sinful	ks. penuh dosa. s. deed. perbuatan penuh dosa.
sinfulness	kb. (moral) kebobrokan/kebejatan.
sing	kb. pertemuan menyanyi bersama. -kkt. (sang, sung) menyanyikan (a song). -kki. menyanyi. 2 mendesing. -singing kb. nyanyian.
singe	kb. luka terbakar. -kkt. menghanguskan, menggosongkan. -singed ks. gosong, hangus.
singer	kb. penyanyi, biduan, biduanita, pelagu.
singhalese	kb. 1 orang sailan. 2 bahasa sailan. -ks. dari sailan.
single	kb. singles j. tenn.: pertandingan (tenis) tunggal. -ks. 1 bujang, tak beristeri/bersuami. 2 satu-satu. 3 satu. -singly kk. satu demi satu.
singleness	kb. keesaan. s. of purpose keesaan/satu-satunya tujuan.
singlet	kb. kaus dalam/baju.
singleton	kb. sesuatu yang tunggal.
singsong	kb. nyanyian yang sama lagu dan iramanya, suaranya mendatar. -ks. menjemukan.
singular	kb. bentuk tunggal. -ks. 1 tunggal. 2 luar biasa. 3 aneh, ganjil. -singularly kk. yang luar biasa, yang istimewa.
singularity	kb. (j. -ties) 1 keistimewaan (of o's memory). 2 keanehan, keganjilan.
sinister	ks. 1 yang mengancam (remarks). 2 jahat (gang). 3 seram, menakutkan.
sink	kb. 1 bak cuci. 2 bak cuci piring. 3 geol.: depresi. -kkt. (sank, sunk) 1 menenggelamkan (a ship). 2 memasukkan (piles). 4 menggali (a well). 5 menanamkan. -kki. 1 tenggelam. 2 terbenam (of the sun). 3 merosot, turun. 4 hilang. -sinking kb. tenggelam.
sinker	kb. 1 batu ladung. 2 sl.: donat.
sinner	kb. orang yang berdosa.
sino-	aw. tiongkok. sino-soviet ks. tiongkok-sovyet.
sinology	kb. ilmu dalam kebudayaan cina.
sinuous	ks. berliku-liku, berkelok-kelok (movement, road).
sinus	kb. lubang yang menghubungkan rongga hidung dengan batok kepala.
sinusitis	kb. radang dalam selaput lendir (di lubang rongga hidung).
sip	kb. sesapan, isapan. a s. of juice sesapan/sedikit air buah. -kkt. (sipped) menyesap, minum sedikit-sedikit. to s. o's tea meminum teh sedikit demi sedikit, menyesap teh.
siphon	kb. pipa pindah. -kkt. menyedot (liquid). to s. off a) menyedot (excess profits). b) mengalihkan, mengalirkan (traffic over another route).
sir	kb. (j. sirs, gentlemen) tuan. -kkt. bertuan. don't s. me ! jangan sebut/panggil saya "tuan"/"bapak"
sire	kb. bapak. -kkt. menjadi bapak/ayah.
siren	siren
sirloin	kb. daging pinggang. s. steak bistik daging pinggang.
sirup	kb. = syrup.
sis	kb. inf.: dik.
sisal	kb. (serat) sisal.
sissified	ks. inf.: kewanita-wanitaan, bertingkah-laku seperti wanita.
sissy	kb. (j. -sies) inf.: orang yang kewanita-wanitaan, banci. you're a s.! bnci lu !
sister	kb. 1 saudara perempuan. 2 (older) kakak. 3 (younger) adik. 4 anggota dari suatu perhimpunan mahasiswi. 5 suster (of religious order). s. ship kapal sejenis. sistere-in-law (j. sisters-in-law) ipar perempuan.
sisterhood	kb. persaudaraan/perserikatan wanita. the bonds of s. ikatan persaudaraan wanita.
sisterly	sisterly
sit	kkt. (sat) mendudukkan (seorang anak diatas meja. 2 bertengger (of birds, fowl). sit-down ks. duduk. sit-in kb. aksi duduk di restoran dll. -sitting kb. 1 kunjungan (at the dentist's). 2 jumlah telur yang sedang dierami.
site	kb. tempat (for a home). s. of a battle tempat terjadinya suatu pertempuran.
sitter	kb. (baby-) pengasuh (kanak-kanak).
situate	kkt. meletakkan. the house is situated at... rumah itu terletak di...
situation	kb. 1 keadaan, situasi. to cope with the s. mengatasi keadaan. 2 pekerjaan. 3 letak (of a house).
six	kb. enam. my chevvie is a s. chevroletku bersilinder enam. six-foot ks. enam kaki.
sixfold	ks., kk. enam kali lipat. s. increase kenaikan enam kali lipat.
sixteenth	kb., ks. yang keenambelas.
sixth	kb., ks. yang keenam. to arrive on the s. tiba pada tanggal enam. s. sense intuisi.
sixtieth	kb., ks. yang keenam puluh.
sixty	kb., ks. (j. -ties) enampuluh. he'll be s. next week ia akan berumur enampuluh tahun minggu depan. the sixties tahun enampuluhan.
sizable	ks. besar juga, cukup besar, lumayan. s. profit keuntungan yang cukup besar.
size	kb. 1 ukuran. what s. shirt do you take ? berapa ukuran kemejamu ? 2 (lem) kanji, dempul. -kki. menganji, mendempul. sizing kb. pengelemen, lem, perekat.
sizeable	= sizable.
sizzle	kki. mendesis. sl.: it's sizzling today hari ini panas sekali/terik.
sizzler	kb. inf.: hari yang amat panas.
skate	kb. 1 skat(s), sepatu luncur/es. 2 sl.: orang. -kkt. bermain sepatu luncur (di es). -skating kb. bermain skats, bermain sepatu es. es s. rink lapangan permainan skats, lapangan es.
skater	kb. pelari skats, pemain skat.
skedaddle	kki. inf.: pergi cepat-cepat.
skein	kb. tukal, unting, tika-tika, gelendong.
skeletal	ks. mengenai kerangka. s. structure bangunan kerangka.
skeleton	kb. kerangka. after his illness he was nothing but a s. sudah sakitnya ia tinggal kerangka saja.
skeptic	kb. orang yang suka meragui.
skeptical	ks. skeptis, (bersifat) ragu-ragu.
skepticism	kb. 1 keragu-raguan, kesangsian. 2 ketidakpercayaan.
skerry	kb. (j. -ries) pulau karang/batu kecil.
sketch	kb. 1 skets(a). 2 bagan, goresan. 3 uraian ringkas. biographical s. uraian singkat tentang riwayat hidup. -kkt. membuat sketsa. to s. in the details menguraikan secara terperinci.
sketchbook	kb. buku skets(a) corat-coret.
sketcher	kb. pembuat skets, pelukis corat-coret.
sketchiness	kb. kesederhanaan, sifat sederhana.
sketchy	ks. dalam garis besar, kurang lengkap (description of an accident). 2 sederhana (meal). -sketchily kk. secara sederhana, dalam garis-garis besarnya.
skew	ks. miring, condong, tidak simetris. -kkt. menyatakan tidak dengan sebenarnya, berbuat curang (figures).
skewer	kb. tusuk daging.
skewness	kb. kecondongan, kecurangan, sifat tidak simetris, kepencongan.
ski	kb. sepatu ski. pair of skis sepasang ski. -kki. main ski.
skid	kb. selip, gelincir. inf.: to be on the skids 1 sedang menuju keruntuhan. 2 semakin menurun/mundur. -kkt. (skidded) menyorong (a crate). -kki. tergelincir (on wet pavement).
skier	kb. pemain ski.
skies	lih sky.
skiff	kb. perahu/sampan kecil.
skill	kb. kecakapan, kepandaian, ketrampilan. to show s. in memiliki keahlian didalam.
skilled	ks. 1 cakap, terampil, cekatan (craftsman). 2 terlatih. s. worker buruh terlatih.
skillet	kb. wajan (yang bergagang), kuali.
skillful	ks. mahir, cekatan, cakap. -skillfully kk. dengan mahirnya/cekatan.
skillfulness	kb. kemahiran, ketrampilan.
skim	kkt. (skimmed) 1 menyendoki, menyaring (cream off milk). 2 meluncurkan (a rock a long surface of water). -kki. melancar, meluncur. s. milk susu yang telah diambil kepala susunya.
skimp	kkt. berhemat (dengan), menghemat. don't s. the sugar janganlah berhemat memakai gula. -kki. berhemat. to s. on memberi kurang.
skimpiness	kb. 1 kehematan pemakaian bahan (of a skirt). 2 kecilnya, seeikitnya (of a serving).
skimpy	ks. 1 kecil sekali (of food, money). 2 tidak cukup menutupi badan (of a dress).
skin	kb. kulit (of person or animal). -kkt. (skinned) 1 menguliti, mengupas kulit (animals). 2 mengelupas. 3 sl.: menipu. skin-tight ks. ketat. -skinned ks. sudah dikuliti (of an animal).
skinflint	kb. orang yang bakhil.
skinner	kb. pengupas kulit.
skinny	ks. kurus.
skip	kb. lompatan, loncatan. -kkt. (skipped) 1 melewati, melampaui (a page). 2 inf.: mangkir, bolos (class di kelas). 3 meloncati (a grade kelas). 4 inf.: melarikan diri (town dari kota). 5 meluncurkan (stones). -kki. melompat(-lompat).
skipper	kb. 1 nakhoda. 2 pemimpin (regu dsb). -kkt. mengemudikan (a boat, yacht).
skirmish	kb. 1 pertempuran kecil, tembak-menembak (between soldiers). 2 perkelahian. -kki. bertempur kecil-kecilan.
skirt	kb. rok, roki. -kkt. menyusur, melewati (the shore). to s. danger nyrempet-nyrempet bahaya.
skit	kb. lakon pendek dan lucu.
skittery	ks. gugup (ketakutan).
skittish	ks. gugup, pengejut.
skivvies	kb., j. pakaian dalam (pelaut).
skt.	[sanskrit] sansekerta.
skulduggery	kb. inf.: kejahatan, perbuatan curang, kecurangan.
skulk	kki. bersembunyi, menyelinap, mengendap-endap.
skull	tengkorak. s. and crossbones tengkorak dan tulang bersilang (gambar pada bendera bajak laut).
skullcap	kb. 1 kopiah. 2 anat.: bagian atas tengkorak.
skunk	kb. 1 sigung. 2 inf.: seorang yang kurang ajar, seorang yang berkelakuan jahat. -kkt. sl.: mencukur gundul.
sky	kb. (j. skies) langit. s. blue biru langit/angkasa. sky-high ks. setinggi langit, melangit. the price is s. -high harganya setinggi langit.
skyborne	ks. diluncurkan ke angkasa, di angkasa.
skyjacker	kb. (pem)bajak udara.
skyjacking	kb. penculikan kapal terbang di angkasa.
skylight	kb. kaca atap, jendela loteng.
skyline	kb. kaki langit.
skyrocket	kb. roket, kembang api. -kki. membubung tinggi (of prices).
skyscraper	kb. pencakar langit.
skyward(s)	kk. menuju ke angkasa.
skyway	kb. jalan raya atas.
skywriting	kb. tulisan asap.
slab	kb. 1 (wooden) papan. 2 (stone) lemping. 3 iris (of bread).
slack	kb. kekenduran, kelendutan. to take up the s. in a rope mengencangkan tali. -slacks j. 1 celana panjang untuk wanita. 2 pantalon (men). -kk. kendur.
slacken	kkt. 1 mengurangi (o's efforts). 2 melambatkan, memperlambat (o's pace). -kki.mengendur. -slackening kb. berkurangnya.
slacker	kb. seorang yang mengelakkan pekerjaan. don't be a s. jangan menghindari tugas.
slackness	kb. kelambanan, kelesuan.
slag	kb. terak, ampas bijih.
slain	lih slay.
slake	kkt. 1 memuaskan (thrist). 2 memadamkan (fire). slaked lime kapur mati.
slam	kb. 1 bridge : slem. 2 gerdam (of a door). 3 inf.: celaan, kecaman (against terhadap). -kkt. (slammed) 1 menggerdam, membantingkan, mengempaskan (a door). 2 inf.: menghantam (an opponent).
slambang	ks., kk. inf.: dengan keras. to go s. into a tree menabrak pohon dengan kerasnya.
slander	kb. fitnah, umpat, jujat. to sue for s. menuntut karena memfitnah. -kkt. memfitnah, mengumpat. he felt that he had been slandered ia merasa telah kena fitnah.
slanderer	kb. pemfitnah, pengumpat.
slanderous	ks. jujat, yang memfitnah.
slang	kb. logat/ucapan populer.
slangy	ks. berlogat populer.
slant	kb. 1 kemiringan (of a roof). 2 pandangan (of a person, newspaper). -kkt. 1 menggendengkan, memiringkan (a roof). 2 mengarahkan / mencondongkan (the news). -kki. miring. slant-eyed ks. bermata sipit.
slantwise	kk. miring, condong.
slap	kb. tamparan, tempeleng. -kkt. (lapped) 1 menampar (s.o.). 2 menjatuhkan (a fine on s.o.). 3 membantingkan (food on a table). to s.around memukuli. to s. down menampik. slap-happy ks. puyeng, suka pening, miring otak.
slapbang	ks., kk. secara sermbrono.
slapdash	ks. sembrono. s. garage garasi yang dibangun buru-buru.
slapjack	kb. semacam kue serabi.
slapstick	kb. dagelan, lelucon yang kasar.
slash	kb. 1 luka teriris (on the arm). 2 bantingan, potongan (in prices). -kkt. 1 menyayat, melukai. 2 menggorok (a throat). 3 memotong, membanting (prices). 4 mengiris. 5 mengecam, mengeritik. -kki. to s. at menyerang (dengan pisau, parang).
slashing	ks. pedas, menyayat (hati). s. criticism kecaman yang pedas.
slat	kb. beroti. sl.: to kick s.o. in the slats menendang seseorang pada rusuknya.
slate	kb. batu tulis. 2 papan tulis, loh. 3 daftar (of candidates). -kkt. 1 mencatat. 2 menutupi dengan batu tulis.
slaughter	kb. 1 penyembelihan, pemotongan, pembantaian (animals). 2 pembunuhan besar-besaran (of people). -kkt. menyembelih, memotong, menjagal.
slav	kb. orang slav.
slav.	[slavic, slavonic] yang berhubungan dengan orang atau bahasa slav.
slave	kb. budak. -kki. bekerja keras, membanting tulang (over untuk). s. driver tukang perintah yang keras, pemburu-buru kerja.
slaver	kki. melelehkan air liur.
slavery	kb. perbudakan.
slavic	ks. dari bahasa atau orang slav. s. language bahasa slav.
slavish	ks. seperti budak. s. imitation peniruan yang membudak, peniruan yang tidak mengandung keaslian.
slavonic	ks. slavia.
slaw	kb. kubis mentah yang diiris tipis-tipis berkuah mentega asam.
slay	kkt. (slew, slain) membunuh. sl.: he slays me with his jokes lelucon-leluconnya amat menggelikan.
slayer	kb. pembunuh.
sleazy	ks. tipis dan tidak kuat (cloth).
sled	kb. kereta luncur/seret, eretan. -kki. (sledded) naik kereta luncur.
sledge	kb. pengeretan, eretan. s. hammer palu besar/godam.
sleek	ks. 1 manis, sedap. to have s. lines berbentuk manis. 2 halus, bersolek rapi (of a person). 3 licin, mengkilap (hair).
sleep	kb. tidur. have a good s. selamat tidur. -kkt. (slept) memberi tempat tidur. -kki. tidur. -sleeping ks. yang sedang tidur.
sleeper	kb. 1 orang yang tidur. 2 rr.: kereta/gerbong tidur.
sleepless	ks. tak dapat tidur.
sleeplessness	kb. suhad, arit.
sleepwalker	kb. orang yang berjalan tidur.
sleepy	ks. 1 mengantuk. i'm s. saya mengantuk. 2 sepi (town).
sleet	kb., kki. hujan bercampur es dan salju.
sleeve	kb. lengan baju. to have s.t. up o's s. merahasiakan sesuatu.
sleeveless	ks. tak berlengan.
sleigh	kb. pengeretan, eretan kereta luncur.
sleight	kb. s. of hand sulap, sunglap.
slender	ks. 1 langsing, ramping, lampai (person). 2 kecil, tipis (hope). 3 lembut (voice). 4 menipis (means).
slenderize	kkt. membuat/menjadikan langsing.
slept	lih sleep.
sleuth	kb. detektip, mata-mata.
slew	lih slay.
slice	kb. 1 iris. 2 bagian (of the profits). 3 sport : s(e)lais. -kkt. mengiris (bread, meat). -kki. mengiris. sliced peaches buah persik yang telah diiris.
slicer	kb. alat pengiris (meat, bread).
slick	kb. lapisan (of oil or mud). -ks. 1 licin. 2 curang. 3 cerdik (advertising). 4 cekatan (barber). 5 licin (hair). -kkt. mengatur apik/rapi. slicked-up ks. dipercantik (car).
slicker	kb. 1 cloth.: jas minyak/hujan. 2 inf.: penipu.
slid	lih slide.
slidden	lih slide.
slide	kb. 1 (pilem) slide. 2 kaca microskop. 3 tempat meluncur. -kkt. (slid, slid atau slidden), menyelipkan. 2 menyorongkan, mendorong (a box). 3 memasang (a bolt). -kki. 1 meluncur. 2 tergelincir (on the floor). sliding ks. sorong, luncur, geser.
slight	kb. 1 (neglect) pelalaian. 2 (snub) sikap yang meremehkan. -ks. 1 langsing, ramping, lampai (person). 2 sedikit. 3 enteng, kecil (wound). 4 tipis (of chances). -slighting ks. yang menghina (remarks). -slightingly kk. enteng/rendah.
slightness	kb. kerapuhan.
slim	ks. 1 ramping, langsing, lampai (person, pole). 2 sedikit sekali, sederhana (meal). 3 kecil. 4 lemah, tipis (evidence). 5 tipis (hope, chance). -kki. (slimmed) menjadi kurus. -slimming ks. 1 melangsingkan. 2 merampingkan (of a dress).
slime	kb. lumpur, kotoran, lanyau.
slimness	kb. kelangsingan.
slimy	ks. berlanyau, berlumpur.
sling	kb. ambin, kain gendongan. to carry o's arm in a s. menggendong tangannya dengan kain ambin. -kkt. (slung) menyandang (over pada).
slingshot	kb. katapel, jepretan, pengumban, tali umban.
slink	kki. (slunk atau slinked). to s. a way/off menyelinap (keluar). to s. in menyelinap (masuk).
slinky	ks. ketat (dress)
slip	kb. 1 cloth.: rok dalam. 2 tergelincir (on the ice). 3 (pillow) sarung bantal. 4 nav.: galangan kapal. 5 cangkokan, setek (of plant). 6 yang kecil. -kkt. (slipped) 1 memasukkan (s.t.) (into kedalam). 2 mengenakan, memasang (ring) (on ke). 3 memberikan
slip-on	ks. yang dikenakan lewat kepala. s.-on sweater baju sweater kurung. inf.: slip-up kb. kesalahan, kekeliruan
slipknot	kb. simpul hidup/pulih.
slipover	kb. baju kurung sweater.
slippage	kb. 1 kelicinan, keselipan. 2 kemungkinan/persentase licin atau selip.
slipper	kb. sandal, selop.
slippery	ks. 1 licin (road, sidewalk).2 licik, licin (person).
slipshod	ks. 1 tak terurus, jorok. 2 ceroboh, tidak teliti. to do work bekerja ceroboh. 3 secara serampangan.
slipway	kb. tempat peluncuran kapal.
slit	kb. celah, belah. -kkt. (slit) 1 membelah, membuat celah (cloth). 2 menggorok (a throat). the blow s. his cheek pukulan itu menyobek / merobek pipinya.
slither	kki. melata, merayap (of a snake).
sliver	kb. kerat, iris, potong. a s. of cake sepotong kue. a s. of wood sekerat kayu. s. of glass pecahan kaca.
slob	kb. orang yang sembrono/serampangan.
slobber	kb. air liur. -kki. meleler (on pada), membasahi dengan air liur.
sloe	kb. sejenis buah.
slog	kki. (slogged) inf.: merencah. to s. through the mud merencah lumpur.
slogan	kb. semboyan.
sloop	kb. sekoci.
slop	kb. kotor, air bekas dipakai. -kkt. (slopped) 1 menumpahkan (water on the floor). 2 makan (hogs). -kki. tumpah, melimpah-limpah (of excess water).
slope	kb. 1 lereng(an), landaian. steep s. lereng yang curam. 2 lekuk (of forehead). -kki. melandai, melereng. -sloping ks. miring, condong, (me)landai. he has a s. forehead dia dahinya miring.
sloppiness	kb. 1 kejorokan (of a room, dress). 2 kejelekan (of style). 3 keburukan (of manners). 4 kecerobohan.
sloppy	kb. 1 tidak rapi (of o's work, clothes, room), ngelomprot. 2 buruk, basah (weather). 3 lemah, cengeng. s. sentimentality sifat cengeng.
slosh	kkt. mengaduk-aduk (a drink). -kki. tumpah. a little water sloshed out of the bucket sedikit air tumpah dari ember.
slot	kb. 1 lobang, celah, petak. 2 inf.: tempat. -kkt. (slotted) inf.: menetapkan, menempatkan (a program.
sloth	kb. 1 fauna : kungkang. 2 kemalasan, kelambanan.
slothful	ks. lamban, malas.
slouch	kb. kebungkukan. -kki. membungkuk.
slough	kb. paya, rawa. s. of despoir kancah penderitaan.
sloughterhouse	kb. rumah pemotongan hewan, penjagalan, pembantaian.
slovenlines	kb. 1 kejorokan, kecerobohan (of appearance). 2 keteledoran (of speech).
slovenly	ks. 1 jorok, ceroboh (in appearance). 2 teledor (in speech).
slow	ks. 1 lambat. 2 lamban, ketinggalan. 4 terlambat (of a watch). 5 lemah, redup (of a flame). 6 lamban (of intellect). -slowly kk. 1 pelan-pelan. 2 lambat, lamban. 3 lambat-laun, berangsur-berangsur.
slow-burning	ks. yang lambat terbakar (wood). slow-witted ks. bodoh, tumpul otak, dungu.
slowdown	kb. kemunduran.
slowgoing	ks. lamban, melempem.
slowness	kb. hal lambat, kelambatan.
slowpoke	kb. orang yang lembam/lambat.
sludge	kb. kotoran, endapan, lumpur.
slue-footed	ks. berkaki bengkok.
slug	kb. 1 peluru gotri (in a rifle). 2 potong timah (printing). 3 logam bundar (illegally used in dispensers, parking meters). 4 sl.: seteguk (of wishkey). 5 semacam siput. -kkt. (slugged) inf.: menghantam.
slugfest	kb. pertengkaran, perkelahian, bakuhantam.
sluggard	kb. orang pemalas.
sluggish	ks. 1 lembam, melempem (of a person, water). 2 seret (of a vehicle).
sluice	kb. pintu air.
slum	kb. perkampungan yang miskin dan kotor, perkampungan yang melarat. -slums j. daerah jembel, rumah-rumah gubuk. -kki. (slummed) mengunjungi perkampungan yang miskin.
slumber	kb. tidur. don't distrub his s. jangan ganggu tidurnya. -kki. tidur. slumbering volcano gunung api yang tak aktip.
slummy	ks. miskin, melarat. s. neighborhood daerah melarat.
slump	kb. kemerosotan. to go into a s. merosot. s. in the dollar kemerosotan nilai dolar. -kki. merosot (of the market).
slung	lih sling.
slunk	lih slink.
slur	kb. (peng)hinaan, cercaan. -kki. (slurred) menelan (a word or syllable in speaking).
slurp	kb. bunyi menghirup/menyedot. -kkt. menghirup (soup).
slush	kb. lumpur salju.
slushy	ks. 1 menjadi cair (of snow). 2 lemah (sentimentality).
slut	kb. 1 pelacur, wanita p, pertempuran tuna susila. 2 betina.
sly	kb. on the s. diam-diam, secara rahasia. -ks. lihay, licik, pintar busuk. -slily, slyly kk. dengan lihay/licik.
sm.	[small] kecil.
smack	kb. 1 pukulan (on the shoulder). 2 inf.: kecup, ciuman (on the cheek). 3 nada (of irony in the voice). 4 sedikit (of cheese). -kk. inf.: tepat. -kkt. menampar, memukul. -kki. to s. of bernada.
smackdab	kk. inf.: tepat. to run s. into berlari menubruk.
smacker	kb. sl.: dolar. 2 inf.: ciuman.
small	kb. bagian belakang yang paling sempit (of the back). -ks. 1 kecil. 2 ringan. 3 remeh. 4 picik. 5 sederhana. small-minded ks. berjiwa picik. small-time ks. (kaliber) kecil.
smallholderr	kb. petani (yang mengerjakan/memiliki ladang kecil). smallholder's rubber karet rakyat.
smallness	kb. kesempitan, kepicikan.
smallpox	kb. cacar.
smart	ks. 1 cerdas, pintar, bijak. 2 tampan (of clothes). 3 tepat. -smartly kk. dengan tangkas.
smartness	kb. 1 ketampanan. 2 keelokan.
smarty-pants	kb. sl.: orang yang berlagak serba tahu.
smash	kb. 1 tabrakan, tubrukan (of auto). 2 hancurnya, remuknya (of dishes).3 keruntuhan (on the stock market). 4 inf.: sukses (of a show). 5 (drink) es jeruk. -kkt. 1 membanting hingga hancur. 2 menabrakkan. 3 merusak, menghancurkan. 4 memecahkan. 5 mendobrak
smattering	kb. pengetahuan yang dangkal. he has a s. of several languages dia tahu sedikit-sedikit beberapa bahasa.
smear	kb. 1 corengan (of lipstick). 2 fitnah(an). 3 biol.: pulasan cairan. -kkt. 1 mengoles(i), melumasi (bread with butter, wheel with grease). 2 melumuri, mengotori (s.t. with mud). 3 menodai (s.o's name). -kki. melengket.
smell	kb. 1 bau. 2 (bad) bau busuk. 3 (sence of) indera pencium. -kkt. (smelled atau smelt) mencium. -kki. berbau. smelling salt obat ammonia untuk dicium.
smelly	ks. berbau (busuk).
smelt	kb. sejenis ikan kecil yang dipakai sebagai umpan. -kkt. melebur (ore). -smelting kb. peleburan (of ore). lih smell.
smidgen	kb. inf.: sedikit. i don't have a s. of cake left tak ada sedikitpun kue yang masih tinggal.
smile	kb. senyum(an). to be all smiles tersenyum-senyum. -kkt. to s. assent menunjukkan kesediaan dengan senyuman. -kki. tersenyum.
smirk	kb. senyuman menyeringai. -kki. tersenyum dibuat-buat. his smirking annoyed me senyumannya yang menunjukkan keangkuhan itu menjengkelkan hati saya.
smite	kkt. (smote, smit(ten) ) 1 memukul, menghantam. 2 cinta-mencintai.
smithereens	kb., j. pecahan. to smash a cup to s. membanting cangkir hingga hancur berantakan.
smithy	kb. (j. -thies thies) kb. bengkel pandai besi.
smitten	lih smite.
smock	kb. 1 baju luar (of artists), teachers). 2 baju pelapis.
smog	kb. asbut, kabut campuran asap.
smoke	kb. 1 asap. 2 rokok. -kkt. 1 merokok (a pipe). 2 menghisap. 3 mengasapi (an eel, a ham). -kki. 1 merokok. 2 berasap. smoke-blackened ks. yang menghitam kena asap. smoke-free ks. yang tak dimasuki asap. -smoked ks. yang disalai. -smoking kb. merokok.
smokehouse	kb. rumah asap/salaian.
smoker	kb. 1 perokok. 2 kumpulan bercengkerama sambil minum dan rokok. 3 rr.: gerbong tempat merokok (kereta api).
smokestack	kb. cerobong asap.
smoky	ks. 1 penuh asap (room). 2 berasa asap (of a ham).
smolder	kki. 1 membaca (of fire). 2 bernyala-nyala, tetap meluap (of o's anger). -smoldering ks. yang menyala kecil (fire).
smooch	kki. sl.: berciuman.
smooth	ks. 1 halus (face, silk). 2 licin (plank, tire). 3 lancar, tenang (trip). 4 sopan, ramah. 5 tidak tajam rasanya (of a drink). -kkt. 1 meratakan (a cloth). 2 melicinkan (a board). 3 melancarkan (the way). smooth-running ks. halus jalannya.
smooth-shaven	ks. dicukur licin. smooth-spoken ks. yang fasih lidahnya (speaker). smooth-talking ks. pandai bicara, yang bicaranya lancar. -smoothly kk. dengan lancar. the meeting went s. rapat itu berjalan lancar.
smoothie, smoothy	kb. sl.: seorang yang benar-benar pandai menarik hati orang.
smoothness	kb. 1 kehalusan (of skin, manner). 2 kelicinan (of wood).
smote	lih smite.
smother	kkt. 1 mencekik (s.o). 2 melimpahi (s.o. with love). 3 menahan, menekan (a yawn, o's anger). 4 menutupi, menyembunyikan (evidence). -kki. mati karena dicekik.
smudge	kb. 1 (mark) corengan. 2 api berasap (against insects). -kkt. menggosok (hingga terjadi corengan yang kotor).
smug	ks. puas dengan diri sendiri.
smuggle	kkt. menyelundupkan. -smuggling kb. penyelundupan.
smuggler	kb. penyelundup.
smugness	kb. (rasa) puas diri.
smut	kb. 1 (smudge) corengan. 2 kecabulan, bahasa cabul. 3 (plant disease) jamur hangus.
smutty	ks. cabul, tak senonoh.
snack	kb. makanan kecil. s. bar warung makanan, tempat menjual makanan kecil. -snacks j. penganan. -kki. makan penganan.
snafu	kb. sl.: kacau-balau, semrawut. -kkt. mengacau-balau.
snag	kb. 1 halangan yang tiba-tiba. 2 lobang, sobekan (in hose, trousers). -kkt. (snagged) merobek, menyobek (o's hose, shirt).
snaggle-toothed	ks. bergigi tak rata.
snail	kb. keong, siput. to work at a s.'s pace bekerja lambat sekali.
snake	kb. 1 ular. 2 kawat yang panjang (seperti ular) untuk membersihkan saluran yang tersumbat. -kkt. to s. o's way berjalan membelok-belok (trough s.t.). s. charmer penjinak ular, tukang sihir ular. s. pit lobang untuk ular-ular.
snakebite	kb. gigitan ular.
snap	kb. 1 kancing (on clothing). 2 bunyi yang keras. 3 sl.: sesuatu yang mudah. 4 derik/kertakan jari (of the fingers). 5 (gingger) kue jahe (yang tipis dan kering). 6 gigitan yang mendadak (of a dog). 7 (cold) udara dingin. -snaps j. buncis.
snapping	ks. menggeretak. s. sound bunyi gemeretak. s. turtle penyu penggigit.
snappish	ks. 1 tak sabar. s. person orang pemberang. 2 yang suka menggigit (dog).
snappy	ks. 1 tajam (of a reply). 2 rapi (of clothing). inf.: make it s. ! lekaslah ! bergegas-gegaslah !
snapshot	kb. foto, potret.
snare	kb. jerat, perangkap. a s. and an illusion perangkap dan khayalan belaka. -kkt. menjerat.
snarl	kb. 1 gertak (of an animal). 2 mata kayu (of a tree). -kkt. memacetkan, mengacaukan. -kki. 1 membentak (of a person). 2 menggeram (of a tiger).
snatch	kb. 1 tangkapan secara cepat (of a ball). 2 sebagian-sebagian (of a conversation). -kkt. 1 merenggut, mengambil (from s.o's hand). 2 sl.: menculik, merampas (as hostage sebagai jaminan).
snatcher	kb. penjambret, tukang jambret.
snazzy	ks. sl.: hebat, manis, indah.
sneak	kb. pengecut. -kkt. mencuri. -kki. to s. away pergi dengan diam-diam. to s. in menyelinap masuk. to s. off minggat, pergi dengan diam-diam. to s. out menyelinap, pergi keluar. s. attack serangan secara diam-diam. -sneaking ks. curiga, was-was.
sneaker	kb. sepatu karet.
sneakiness	kb. sifat suka tersembunyi-sembunyi.
sneaky	ks. yang suka berterus-terang.
sneer	kb. senyuman mencurigai. he had a s. on his face pandangannya mencemoohkan. -kki. menyeringai, mengejek. -sneering ks. yang mencemoohkan. -sneeringly kk. secara mengejek/mencemoohkan.
sneeze	kb. bersin. -kki. bensin. inf.: that job is nothing to s. at pekerjaan itu jangan dipandang rendah.
snicker	kb. suara gelak (tertawa). -kki. tertawa terkekeh-kekeh.
snide	ks. bersifat menghina. s. remark ucapan sindiran.
sniff	kb. 1 bau (of perfume) . 2 hirupan (of fresh air). -kkt. 1 mencium bau (food). 2 menghirup (vapor).
sniffle	kb. sniffles j. pilek. -kki. tersedu-sedu, tersedan-sedan.
snigger	kb. ketawa terkikik-kikik. -kki. terkikik-kikik.
snip	kb. guntingan (of hair). -kkt. (snipped) menggunting.
snipe	kb. 1 (burung) berkik. 2 sl.: puntung rokok. -kki. to s. at menembak dengan sembunyi-sembunyi. to s. at government policies mengecam politik pemerintah
sniper	kb. penembak (jitu) tersembunyi.
snippet	kb. guntingan, potongan.
snitch	kkt. sl.: mencuri. sl.: to s. on mengadukan (s.o.).
snitcher	kb. s.: 1 pengadu. 2 tukang jambret.
snivel	kb. 1 ingus. 2 selesma. 3 sedu-sedan (tangis). -kki. menangis tersedu-sedu.
snob	kb. orang yang suka membanggakan diri.
snobbery	kb. (j. -ries) sifat tinggi hati, sifat keangkuhan.
snobbish	ks. tinggi hati, suka meninggikan diri.
snood	kb. jaring rambut.
snoop	kb. pengintai, pengintip (urusan orang lain). -kki. memata-matai. to s. into other people's affairs memata-matai urusan orang lain.
snoopy	ks. suka mengintip-intip urusan orang lain.
snooty	ks. inf.: congkak, sombong.
snooze	kb. tidur sebentar. to take a s. tidur sebentar. -kki. tidur sebentar.
snore	kb. dengkur, orok. -kki. berdengkur, mengorok. -snoring kb. dengkur.
snorer	kb. pendengkur, pengorok.
snorkel	kb. alat pemasukan dan pengeluaran udara untuk sebuah kapal selam yang sedang berlayar dibawah permukaan air, juga untuk orang yang sedang menyelam.
snort	kb. dengus (of a person, horse). 2 sl.: satu gelas minuman keras. -kkt. mendengus-dengus. -kki. mendengus.
snot	kb. vulg.: ingus, air hidung. the little s. orang hina.
snout	kb. moncong. 2 hidung.
snow	kb. 1 salju. 2 bintik-bintik seperti salju (pada layar tv). 3 sl.: heroin. -kkt. sl.: menipu dengan kata-kata, mengibuli. snow-capped ks. diselimuti/bertopi salju. snow-covered ks. yang ditutupi salju. snow-white ks. putih seperti salju.
snowball	kb. gumpalan salju. -kkt. berlemparan bola salju, melemparkan gumpalan salju. -kki. semakin bertambah (dengan cepat).
snowbank	kb. tumpukan salju yang besar.
snowdrift	kb. tumpukan salju yang terjadi karena tiupan angin.
snowfall	kb. salju yang turun.
snowflake	kb. kepingan salju.
snowman	kb. (j. -men) orang-orangan (dari) salju.
snowmobile	kb. mobil traktor yang dipakai di daerah salju.
snowplow	kb. bajak salju.
snowshoe	kb. sepatu salju.
snowstorm	snowstorm
snowsuit	kb. pakaian salju.
snowy	ks. 1 ditutupi/penuh salju. 2 seperti salju.
snub	kb. penghinaan, perlakuan menghina. -ks. pendek lagi mancung (nose). -kkt. (snubbed) menghina, mencerca.
snuff	kb. tembakau sedotan. -kki. mencium-cium, memeriksa dengan mencium. to s. out 1 memadamkan (a candle). 2 menghabisi (a life). s. box kotak tembakau, sedotan.
snuffer	kb. alat pemadam lilin.
snug	ks. 1 rapi (of a room, cabin). 2 senang, nyaman (of a home). 3 sempit (of clothing). -snugly kk. dengan sempit. to fit s. pas dengan sempit.
snuggle	kki. masuk meringkuk (into bed ketempat tidur). to s. up to s.o. merapat (manja) pada seseorang.
so	kk. 1 sekali, amat. 2 begitu. 3 jadi. 4 juga. 5 demikian. 6 demikian, begitu. so-called ks. apa yang dinamakan. so-so ks. biasa saja.
so.	[south(ern) ] (sebelah) selatan.
soak	kkt. 1 merendam (in water). 2 membasahi hingga basah kuyup. 3 inf.: meminta. to s. through meresap menembus. -soaking kb. basah-kuyup. to get a s. direndam. s. wet basah-kuyup.
soap	kb. sabun. -kkt. menyabuni. s. bubble gelembung sabun. s. flakes serpih sabun. s. powder bubuk sabun.
soapbox	kb. 1 kotak sabun. 2 peti sabun yang dipergunakan sebagai mimbar berpidato.
soapsuds	kb., j. busa/buih sabun.
soapy	ks. bersabun.
soar	kki. 1 membumbung tinggi. 2 memuncak. 3 melonjak, membubung. -soaring kb. av.: peluncuran. s. mountain gunung yang menjulang tinggi. s. prices harga-harga yang membubung tinggi.
sob	kb. sedu-sedan, sedu, isak, esak, sedan. -kkt. (sobbed) tersedu-sedu, terisak-isak. s. story cerita pembangkit iba, cerita beriba-iba.
sober	ks. 1 seadanya. 2 waras, bijaksana (decision). 3 tak mabuk. 4 sederhana (color). 5 tenang (expression). -kkt. membuat tenang. sober-minded ks. berpikiran sehat, tenang pembawaannya. -sobering ks. yang menenangkan, yang membawa kewajaran/ketenangan.
soberness	kb. kesederhanaan, ketenangan.
sobriety	kb. (j. -ties) 1 keadaan tak mabuk. 2 ketenangan hati.
sobriquet	kb. nama julukan/ejekan.
soc.	1 [society] a) masyarakat. b) perkumpulan, perhimpunan. 2 [socialist] a) sosialis. b) orang sosialis.
soccer	kb. sepakbola. s. player pemain bola.
sociability	kb. (j. -ties) keramahan, kesukaan bergaul.
sociable	ks. peramah, suka bergaul. why don't you become more s. ? mengapa kau tak bersikap lebih ramah lagi ?
social	kb. pertemuan silaturrakhmi/ ramah-tamah (di gereja). -ks. 1 peramah, senang sekali bergaul. 2 sosial, kemasyarakatan. 3 ramah tamah. s. ladder tangga masyarakat. s. psychology ilmu jiwa sosial. s. sciences ilmu sosial, ilmu pengetahuan kemasyarakatan.
socialism	kb. sosialisme.
socialist	kb. orang sosialis. -ks. sosialis.
socialistic	ks. sosialistis.
socialite	kb. tokoh terkemuka di masyarakat.
socialization	kb. sosialisasi, hidup bermasyarakat. s. of the child hal mendidik / mensosialisasikan anak.
socialize	kkt. mensosialisasikan (transportation). -kki. bergaul.
society	kb. (j. -ties) 1 masyarakat. 2 perkumpulan, perhimpunan, lembaga.
sociological	ks. sosiaologis, kemasyarakatan.
sociologist	kb. sarjana sosiologi, ahli kemasyarakatan.
sociology	kb. sosiologi, ilmu masyarakat.
sock	kb. 1 kaos kaki. 2 inf.: tinju. -kkt. inf.: meninju. sl.: to s. away menyimpan (money).
socket	kb. 1 elec.: stopkontak. 2 rongga, lekuk mata (of eye). 3 fitting. 4 sendi, persendian (of arm).
sod	kb. lempeng rumput. to be under the s. dalam kubur. -kkt. (sodded) merumput.
soda	kb. 1 (air) soda. 2 air belanda. s. ash abu soda. s. cracker kue kering asin. s. fountain kedai (minum) eskrim. sl.: s. jerk penjaga/pelayan kedai eskrim. s. pop limun. s. water air belanda/soda.
sodden	ks. basah-kuyup.
sodium	kb. sodium.
sodomy	kb. smburit. 2 liwat (persetubuhan antara manusia dan hewan).
sofa	kb. dipan. s. bed dipan yang dapat dijadikan tempat tidur.
soft	ks. 1 lembek (of food, ground). 2 lunak (of wood,ground, chair, metal). 3 lemah (from lack of exercise). 4 lembut (of voice, pencil, ground). 5 halus (of skin). 6 empuk (of a chair, sofa, bed). 7 mudah, enteng.
soft-builed	ks. direbus setengah matang (egg). s. drink. minuman tanpa alkohol, minuman ringan, air kwas. soft-hearted ks. lembut hati. soft-spoken ks. bersuara lembut. -softly kk. pelan-pelan.
softball	kb. softbal.
soften	kkt. 1 mengurangi, meringankan (the pain, a blow). 2 melunakkan, melemahkan (the light). 3 melunakkan (o's heart). softening of the brain kelemahan otak.
softener	kb. pelunakan.
softness	kb. 1 kehalusan (of skin). 2 kelembekan (of attitude).
software	kb. bahan berisi catatan untuk keperluan menjalankan komputer.
softwood	kb. kayu halus/lunak.
softy	kb. (j. -ties) sl.: 1 orang yang lembut hati. 2 orang yang lembek.
soggy	ks. basah (of rag, ground). 2 lembab (day). 3 lembek, lembab (of bread).
soil	kb. tanah. fertile s. tanah yang subur. -kkt. mengotori. -kki. menjadi kotor. soiled clothes pakaian-pakaian yang kotor.
sojourn	kb. persinggahan. to enjoy a s. in europe tinggal beberapa waktu di eropa. -kki. berdiam, tinggal.
solace	kb. pelipur lara, penghiburan. -kkt. melipur hati/menghibur.
solar	ks. mengenai surya atau matahari. s. furnace dapur api matahari. s. plexus jaringan syaraf-syaraf simpatis yang terletak di belakang lambung dan di depan aorta. s. system tata surya. s. year tahun matahari.
sold	lih sell.
solder	kb. pateri. -kkt. memateri(kan). -soldering kb. pematerian. s. iron baut pateri.
soldier	kb. prajurit, serdadu. toy s. prajurit mainan. s. of fortune petualangan militer, serdadu bayaran.
sole	kb. 1 (fish) ikan lidah. 2 tapak kaki (of foot). 3 tapak sepatu (of shoe). -ks. 1 tunggal. 2 satu-satunya. -kkt. memasang sol, mensol. -solely kk. semata-mata, melulu.
solecism	kb. kesalahan atau pelangganan tatabahasa.
solemn	ks. 1 khidmat (ceremony, occasion). 2 sungguh-sungguh (promise). 3 serius. -solemnly kk. dengan sungguh-sungguh.
solemnity	kb. (j. -ties) kekhidmatan, kesungguhan.
solemnize	kkt. 1 memperingati dengan upacara. 2 melangsungkan upacara (a wedding).
solicit	kkt. 1 mengumpulkan, mencoba mendapatkan (votes). 2 memohon, meminta (assistance, a favor). 3 mencari (subscriptions). 4 berusaha. -kki. 1 memohon (for contributions). 2 mengajak (for immoral purposes).
solicitation	kb. 1 permohonan, permintaan. 2 pengumpulan.
soliciting	kb. 1 permohonan, permintaan. 2 pengumpulan.
solicitor	kb. 1 pengumpul derma (for contributions to a fund). 2 pencari langganan (for magazine subscriptions). s. general jaksa agung muda, pengacara agung.
solicitous	ks. 1 ingin. 2 khawatir, cemas. 3 tertib.
solicitude	kb. 1 perhatian. 2 kecemasan, kekhawatiran.
solid	kb. benda/zat padat. -ks. 1 padat (ground). 2 kokoh. 3 mendalam.4 keras. 5 penuh. 6 kuat. -solidly kk. secara kuat/padat. to be s. behind s.o. memberikan dukungan yang kuat kepada seseorang.
solidarity	kb. (j. -ties) solidaritas, kesetiakawanan, kekompakan.
solidified	lih solidify.
solidifies	lih solidify.
solidify	kkt. (solidified) menjadikan keras. -kki. mengeras, menjadi keras.
solidity	kb. (j. -ties) kepadatan, kerasnya.
soliloquist	kb. orang yang bercakap seorang diri.
soliloquy	kb. (j. -quies) percakapan seorang diri.
solitaire	kb. permainan kartu seorang diri.
solitary	kb. to be placed in s. dikurung/disel tersendiri. -ks. sunyi terpencil. s. spot tempat yang terpencil.
solitude	kb. kesunyian, kesepian.
solo	kb. 1 nyanyian tunggal. 2 penerbangan tunggal. -ks. solo, tunggal. s. flight penerbangan solo. -kki. terbang sendiri. -kki. terbang sendiri/solo.
soloist	kb. pemain solo/tunggal.
solstice	kb. titikbalik matahari.
solubility	kb. (j. -ties) daya larut.
soluble	ksd. 1 dapat larut (of solids). 2 dapat dipecahkan (of a problem).
solution	kb. 1 cara pemecahan/penyelesaian (to a problem). 2 (liquid) larutan.
solvable	ks. dapat dipecahkan (of a problem).
solve	kkt. memecahkan (a problem). to s. a riddle mencari jawab teka-teki.
solvency	kb. (j. -cies) kesanggupan melunaskan hutangnya.
solvent	ks. 1 sanggup membayar hutangnya. 2 pelarut. liquid s. cairan pelarut. 3 bahan pelarut (gasoline).
somber	ks. suram, muram.
some	ks. 1 sementara. 2 beberapa. 3 suatu, satu.4 sedikit. 5 salah seorang, seseorang. 6 lama. 7 inf.: hebat. -kk. 1 kira-kira. 2 agak.
somebody	kb., kg. (j. -dies) 1 seseorang. 2 ada (orang) yang. 3 orang yang penting.
someday	kk. kapan-kapan, pada suatu waktu.
somehow	kk. 1 bagaimanapun juga. 2 entah bagaimana.
someone	kg. = sdomebody.
somersault	kb. jungkir-balik. to turn a s. berjungkir balik. -kki. berjungkir balik.
something	kb. sesuatu. s. must be done sesuatu harus dilakukan. s. has gone wrong ada sesuatu yang salah. -kk. s. like kira-kira (seperti).
sometime	ks. bekas. my s. teacher bekas guru saya. -kk. 1 kapan-kapan. 2 suatu waktu. 3 entah kapan.
sometimes	kk. sekali-sekali, terkadang, kadang-kadang, kadang kala.
somewhat	kb. he's s. of a coward ia agak pengecut. -kk. agak, sedikit. s. overweight agak terlalu gemuk.
somewhere	kb. sesuatu tempat. -kk. 1 pada suatu tempat. 2 entah dimana.
somnambulist	kb. orang yang suka berjalan dalam keadaan tidur.
somnolent	ks. mengantuk.
son	kb. 1 anak lelaki/laki-laki. 2 putera. son-in law menantu laki-laki. s. of god, s. of man putera tuhan/manusia.
sonant	kb. phone.: bunyi bersuara.
sonar	kb. sonar.
sonata	kb. sonata.
song	kb. lagu, nyanyian. to burst into s. terus bernyanyi.
songbird	kb. burung penyanyi.
songbook	kb. buku nyanyian/lagu.
songfest	kb. pesta nyanyi, nyanyi bersukaria.
songster	kb. 1 penyanyi, biduan, biduanita. 2 burung penyanyi.
songwriter	kb. pengubah lagu.
sonic	ks. sonik. s. boom dentuman sonik.
sonnet	kb. soneta.
sonny	kb. (j. -nies) buyung, ujang, nak.
sonority	kb. (j. -ties) kemerduan.
sonorous	ks. nyaring lagi merdu, penuh lagi nyaring.
soon	kk. segera. he will return s. ia segera akan kembali. as s. as segera setelah, selekas-lekasnya sesudah.
soot	kb. jelaga, sulang.
soothe	kkt. mengentengkan (pain). 2 menenangkan (nerves). -soothing ks. menyejukkan.
soothsayer	kb. tukang ramal/tenung.
sooty	ks. penuh jelaga, hitam.
sop	[standard operating procedure] tatacara lazim.
sophist	kb. orang yang tersesat pandangan - pandangannya.
sophisticaded	ks. 1 yang berpengalaman dalam hal-hal duniawi (of a person). 2 pintar dan njlimet. 3 mengelabui.
