customer	kb. 1 langganan, nasabah. he's a good c. ia seorang langganan baik. 2 inf.: orang. he 's a rough c. ia seorang yang sulit untuk dihadapi.
cut	kb. 1 luka. 2 potongan. 3 galian, lubang. 4 bagian. 5 membolos. 6 inf.; ucapan, tindakan yang menyinggung perasaan. 7 pukulan memotong. -kki. 1 tajam. 2 menusuk/melukai hati. 3 memotong. 4 berhenti, stop. 5 menyayat. 6 sl.: meninggalkan, pergi.
cutaneous	ks. yang berhubungan dengan kulit. c. nerve urat saraf pada kulit.
cutaway	kb. jas berpotongan lancip kebelakang dipakai pada pertemuan-pertemuan resmi.
cutback	kb. pengurangan, penyusutan. c. in production pengurangan produksi.
cute	ks. inf.: 1 mungil, manis. c. baby bayi yang mungil. 2 elok. she has a c. figure badannya elok sekali.
cuticle	kb. kulit ari/luar/selaput/adam.
cutie	kb. inf.: gadis cantik. she's a real c. dia cantik benar.
cutlery	kb. 1 alat-alat pemotong seperti pisau, gunting dsb. 2 alat-alat makan seperti sendok,garpu, pisau.
cutlet	kb. sayatan, potongan. veal c. sayatan daging anak sapi, goreng daging anak lembu.
cutoff	kb. 1 jalan memintas. 2 kelep untuk mematikan aliran air, arus listrik atau minyak mesin, (stop) keran.
cutout	kb. 1 gambar guntingan. 2 auto.: ket-ot (pada mesin mobil), alat pemutus arus.
cutter	kb. 1 tukang potong. 2 mesin potong. 3 pemotong. meat c. pisau pemotong daging. 4 nav.: kapal layar.
cutthroat	kb. pembunuh. -ks. tajam. c. competition persaingan yang tajam.
cuttlefish	kb. sotong.
cwt.	(hundredweight) timbangan berat berdasar ratusan seperti 100 pon.
cyanamide	kb. sianamida.
cyanide	kb. sianida.
cybernetics	kb. sibernetika.
cycle	cycle
cyclic(al)	ks. yang berhubungan dengan masa peredaran atau putaran.
cyclist	kb. pengendara sepeda.
cyclone	kb. tofan, topan, taufan.
cyclotron	kb. siklotren, mesin pemecah atom.
cylindrical	ks. berbentuk silinder.
cymbal	kb. canang, gembreng.
cynic	kb. seorang yang suka memperolok-olokkan pekerjaan orang lain, pengejek.
cynical	ks. sinis, suka memperolok-olokkan, bersifat mengejek. he' a very c. person ia seorang yang sangat suka memperolok-olokkan..
cynicism	kb. sinisme, perolok-olok.
cynosure	kb. pusat perhatian. she was the c. of all present ia adalah pusat perhatian dari semua yang hadir.
cypher	= cipher.
cypress	kb. semacam pohon cemara.
cyst	kb. 1 kista. 2 risa.
cytology	kb. bagian dari biologi yang mempelajari pembelahan sel-sel, fungsi sel-sel dsb.
czar	kb. kaisar, raja. c. of the business world raja/gembong dunia perniagaan.
czech	kb. bahasa ceko. a c. seorang ceko. the c. language bahasa ceko.
czechoslovak	ks. yang berhubungan dengan negara cekoslowakia.
d	1 huruf keempat dari abjad inggris. 2 angka terendah yang masih memungkinkan naik kelas, kira-kira 5. 3 beethoven's symphony in d simponi beethoven dalam d. 4 angka romawi untuk 500.
d. litt.	[doctor litterarum (doctor of letters)] doktor (h.c.) dalam ilmu sastra.
d. mus.	[doctor of music] doktor dalam ilmu musik.
d. sc.	[doctor of science] doktor dalam ilmu eksakta.
d.c.	(direct current) arus searah.
d.c.l.	(doctor of civil law) doktor ilmu hukum perdata.
d.d.	(doctor of divinity) doktor ilmu theologia.
d.d.s.	(doctor of dental surgery) doktor ilmu kedokteran gigi.
d.p.w.	[department of public work] departemen pekerjaan umum.
d.s.c.	[distinguished service cross] lencana penghargaan jasa-jasa ketentaraan.
d.s.t.	[daylight saving time] sistim waktu standar, berdasarkan terang cahaya. lih daylight.
d.t's.	[delirium tremens] kb. inf.: keadaan mengigau, mabuk.
d.v.m.	[doctor of veterinary medicine] dokter hewan.
da, d.a.	(district attorney) jaksa wilayah.
da.	(danish) berasal dari denmark, orang denmark.
dab	kb. 1 colek. a d. of butter secolek mentega. 2 coket, colet. a d. of applesauce sekocet, colet. secoket saus apel. -kkt. (dabbed) mengoles. to d. iodine on a cut mengoleskan yodium pada luka.
dabble	kkt. mencebur-ceburkan. -kki. mencoba-coba, berbuat sesuatu secara iseng.
dabbler	kb. amatir, penggemar secara sambil lalu.
dachshund	kb. semacam anjing yang pendek kakinya.
dacron	kb. dakron.
dactyloscopy	kb. sidik jari.
dad	kb. inf.: 1 ayah. 2 pak.
daddy	kb. (j. -dies) inf.: ayah. i love my d. saya sayang kepada ayah saya. d.-long legs ayak-ayak.
daffodil	kb. semacam bunga narsis/bakung, yang berbunga kuning atau putih dan berdaun ramping.
daft	ks. gila.
dagger	kb. 1 pisau belati. 2 tanda salib/ palang/silang juga dipakai didepan nama-nama mereka yang telah meninggal/anumerta.
dahlia	kb. bunga dahlia.
daily	kb. (j. -lies) harian. -ks. 1 tiap hari. 2 harian. 3 sehari-hari. -kk. tiap hari.
daintiness	kb. kehalusan, kelezatan, kecantikan.
dainty	ks. 1 cantik, pandai bersolek. she's a d. individual ia seorang yang cantik. 2 suka berpilih-pilih. a d. eater seorang pemilih dalam soal makanan.
dairy	kb. (j. -ries) perusahaan susu. d. cattle ternak sapi penghasil susu. -dairying kb. perusahaan susu pekerjaan menghasilkan susu, mentega dan keju.
dais	kb. mimbar, podium.
daisy	kb. (j. -sies) semacam bunga aster.
dally	kki. (dalled) bermain-main, bermalas-malas, menghabiskan waktu, membuang-buang waktu.
dam	kb. bendung(an), dam. -kki. (dammed) membendung. to d. (up) a river membendung sungai.
damage	kb. 1 kerusakan. 2 kerugian. -kkt. 1 merusakkan. 2 mendapat cedera. - damaged ks. rusak. -damaging ks. yang merusak.
damask	kb. damas, kimcha. d. tablecloth kain-meja damas.
dame	kb. wanita (yang agak tua). (di inggris dipakai sebagai gelar) sl.: what a d.! alangkah cantiknya.!
dammit	kseru. celaka, sompret.
damn	kb., ks. i don't give a d. saya tak peduli sama sekali. -kkt. menggagalkan. -the damned kb., j. orang terkutuk. kk sangat, terlalu. -damning ks. mencelakakan, memberatkan.
damp	kb. gas, kabut (kelembaban), uap. -ks. lembah, basah.
dampen	kkt. 1 membasahi, melembabkan. 2 mengurangi, memperkecil.
damper	kb. alat pengatur api kompor. the death of the leader put a d. on all social activities kematian pemimpin itu mengurangi semua kegiatan sosial.
dampness	kb. kelembaban, keadaan lembab.
damsel	kb. gadis, anak dara.
damson	kb. buah, semacam prem.
dan.	(danish) yang bertautan dengan denmark.
dance	kb. 1 tari(an) 2 dansa. -kkt., kki. berdansa. -dancing kb. berdansa
dancer	kb. penari.
dandelion	kb. semacam rumput yang bunganya kuning.
dander	kb. kemarahan, amarah. mention of certain people gets his d. up menyebut nama orang-orang tertentu membangkitkan amarahnya.
dandruff	kb. sindap, ketombe, kelemumur.
dandy	kb. (j. -dies) pesolek. -ks. sl.: bagus, sangat baik. that's a d. car itu mobil yang bagus sekali. d. idea gagasan yang baik sekali.
dane	kb., ks. orang denmark.
danger	kb. bahaya. the hospital reports that she is out of d. rumah sakit memberitahukan bahwa ia sudah terhindar dari bahaya.
dangerous	ks. berbahaya, membahayakan.
dangle	kkt. membayang-bayangkan. -kki. menguntai, berjuntai, teruntai.
danish	kb. inf.: semacam kue masakan denmark. i'll have a d. and coffee minta kue denmark dan kopi. -ks. berasal dari denmark. d. pastry semacam kue masakan denmark.
dank	ks. lembab, basah. d. cave gua yang lembab.
dapper	ks. rapi, necis. d dresser orang yang senantiasa berpakaian rapi.
dare	kb. tantangan. -kkt. berani. -daring kb. keberanian, kenekatan. ks. berani. he's a d. warrior ia seorang prajurit pemberani.
daredevil	kb. pemberani. -ks. berani mati. d activities tindakan-tindakan berani mati.
dark	kb. kegelapan. after d. waktu malam. -ks. 1 gelap. 2 tua. 3 suram. dark-skinned ks. berkulit hitam.
darken	kkt. menggelapkan, mengelamkan (a room). -kki. mulai gelap. the sky darkenned langit mulai gelap.
darkness	kb. kegelapan, kemuraman.
darkroom	kb. phot.: kamar gelap.
darling	kb. 1 sayang. 2 anak kesayangan. -ks. yang menawan hati.
darn	kb. 1 tambalan, jerumatan, tisikan. 2 inf.: kutukan. -kk. sekali, sangat. -kkt. menjerumat, menisik(i) (sock). -darning kb. pekerjaan menjerumat/menisik/menambal.
dart	kb. anak panah. -kki. lari cepat dengan tiba-tiba.
dash	kb. 1 sedikit. 2 tanda garis/pisah/alangan (-). 3 garis. 4 lari cepat.. -kkt. 1 menghancurkan, meremukkan (o's hopes). 2 melemparkan. -kki. berlari. 2 menuliskan. -dashing ks. 1 ganteng, tampan, gagah. 2 bersemangat, berseri-seri. 3 bergaya, penuh aksi.
dashboard	kb. papan (pedoman) instrumen, dasbor.
dastardly	ks. bersifat pengecut. d. deed perbuatan yang bersifat pengecut.
data	kb. (j. dari datum). data, fakta, bahan-bahan keterangan.
date	kb. 1 tanggal. 2 janji, perjanjian. 3 kencan, teman gadis, pacar. 4 fruit ; kurma. -kkt. membubuhi tanggal. -kki. 1 berkencan, berpacaran. -dated ks. tidak berlaku. -dating kb.1 perkencanan, berkencan, berpacaran . 2 penentuan tanggal.
datebook	kb. buku catatan perjanjian.
dative	kb., ks. datif. d. case kasus datif.
datum	lih data.
daub	kb. pulas. a d. of paste sepulas lem. -kkt. memulas(kan). to d. some point on the chair memulaskan cat sedikit pada kursi.
daughter	kb. anak perempuan, putri. a d. of eve keturunan siti hawa. daughter-in-law kb. (j. daughters-in-law) menantu perempuan.
daughterly	ks. seperti anak perempuan. d. affection rasa kasih/cinta seorang anak perempuan.
daunt	daunt
dauntless	ks. berani, tidak takut. a d. fighter seorang pejuang yang berani.
davenport	kb. dipan panjang yang ada sandarannya.
davit	kb. dewi-dewi.
davy jones	kb. davy jones's locker tempat berkubur didalam laut.
dawdle	kki. berlengah-lengah,membuang-buang waktu, onyak-anyik, menggeluyur. to d. on the way home from school berlengah-lengah waktu pulang dari sekolah.
dawdler	kb.pengeluyur, tukang melamun, orang yang suka mengeluyur.
dawn	kb. 1 subuh, fajar. 2 permulaan. -kki. menyingsing.
day	kb. 1 hari. 2 kemenangan. all d. sepanjang hari. by the d. secara harian. d. after d. dari hari ke hari, saban hari. d. after tomorrow lusa.
daybreak	kb. fajar (sidik), dinihari.
daycoach	kb. gerbong kereta api penumpang.
daydream	kb. lamunan, angan-angan. -kki. melamun, ngelamun.
daylight	kb. siang (hari), waktu siang. in d. pada waktu siang. d. saving time waktu yang menunjukkan satu jam lebih cepat daripada biasa. -daylights j. sl.: isi badan.
daylong	ks. sepanjang hari. d parade pawai yang berlangsung sepanjang hari.
daytime	kb. siang hari. d show on tv pertunjukan siang hari di tv.
daze	kb. keadaan linglung, pusing, tak sadar. -kkt. 1 melinglungkan. 2 membingungkan.
dazzle	kkt. 1 mempesonakan. 2 menyilaukan. -dazzling ks. 1 mempesonakan. 2 menyilaukan mata, melinglungkan.
ddt, d.d.t.	kb. dedete, obat semprot nyamuk.
deacon	kb. samas, diaken, pembantu gerejawan yang mengerjakan kewajiban-kewajiban di gereja.
deactivate	kkt. menonaktifkan.
dead	kb. yang sudah mati. -ks. 1 mati. 2 meninggal. 3 padam. 4 putus. 5 (sepi dan) membosankan, menjemukan. -kk. sama sekali, betul-betul, sungguh-sungguh. dead-set ks. berkeras hati, bertekad benar.
deaden	kkt. 1 mengurangi, menghilangkan, mematikan. 2 meredamkan (the noise).
deadhead	kb. inf.: pemegang karcis cuma-cuma.
deadline	kb. 1 saat terakhir untuk memasukkan berita. to meet a d. memenuhi batas waktu. 2 baris kunci.
deadlock	kb. jalan buntu, mogok.
deadly	ks. yang membawa maut, yang mematikan. d. weapon senjata maut.
deadpan	kb. sl.: roman muka yang tak bergerak/berubah.
deadwood	kb. 1 pohon atau dahan-dahan yang mati. 2 orang yang tak berguna.
deaf	ks. tuli, pekak. deaf-mute kb. tuli dan bisu. a d. -mute person seorang tunarungu, seorang yang tuli lagi bisu.
deafen	kkt. menulikan. -deafening ks. menulikan, memekakkan.
deal	kb. inf.: perjanjian, transaksi. 2 inf.: perlakuan. -kkt. (dealt) 1 membagi (cards). 2 memberi. -kki. 1 berurusan, mengadakan usaha dagang. 2 menguraikan. -dealings kb., j. hubungan, transaksi, urusan.
dealer	kb. 1 pedagang. car d. pedagang mobil. 2 pembagi. card d. pembagi kartu.
dealership	kb. hak penjualan. the chevrolet d. hak penjualan mobil-mobil chevrolet.
dealt	lih deal.
dean	kb. 1 dekan, ketua. d. of the faculty dekan fakultas. 2 pengetua (of diplomatic corps korp diplomatik).
deanship	kb. jabatan dekan.
dear	kb. kekasih, sayang. -ks. 1 yang terhormat. 2 berharga. 3 mahal. -kk. to hold d. menyimpan dengan mesra. -dearly kk. 1 sangat disayangi. 2 sangat merugikan.
dearth	kb. kekurangan. d. of firewood kekurangan kayu bakar.
death	kb. 1 kematian. 2 ajal, maut. at death's door sedang sekarat, hampir mati. to do to d. membunuh. deathly kk. seperti mayat. d. pale pucat pasi.
deathbed	kb. akhir hidup, waktu meninggal dunia. on his d. he forgave his son pada waktu ia akan meninggal ia mengampuni putranya. d. wish keinginan yang penghabisan.
deathblow	kb. hal yang mengakhiri sesuatu, pukulan maut.
deb	= debutante.
debacle	kb. kegagalan, bencana.
debar	kkt. (debarred) menghalangi, merintangi. poor health often debars young people from engaging in sports kesehatan yang kurang baik seringkali menghalangi para pemuda ikut berolahraga.
debark	kki. turun dari kapal, mendarat. we d. at southampton kami turun dari kapal di southampton.
debarkation	kb. penurunan dari kapal, pendaratan.
debarment	kb. penghindaran, rintangan, larangan, penyingkiran.
debase	kkt. 1 merendahkan derajat. don't d. yourself by doing such a thing janganlah merendahkan derajatmu sendiri dengan melakukan perbuatan demikian. 2 menurunkan nilai. to d. money menurunkan nilai uang.
debasement	kb. penurunan harga/nilai.
debatable	ks. dapat dibantah, belum pasti. d problem persoalan yang dapat dibantah.
debate	kb. 1 perdebatan, pembahasan. 2 diskusi, perbincangan. -kkt. memperdebatkan. -kki. berdebat - debatan. -debating kb. perdebatan.
debater	kb. pendebat, tukang debat.
debauch	kb. pesta makan minum yang berlebih-lebihan. -kkt. merusakkan kesusilaan, mengkorupsikan. -debouched ks. bermoral bejat.
debauchery	kb. (j. -ries) pesta-pora yang berlebih -lebihan, penyelewengan dari kewajiban atau susila.
debenture	kb. surat hutang.
debilitate	kkt. melemahkan, mengurangi tenaga. hot weather is debilitating to older people cuaca panas mudah melemahkan badan orang-orang tua.
debit	kb. debet,beban, hutang. to the d. of menjadi tanggungan. -kkt. membebankan, mencatat sebagai utang.
debonair	ks. ramah, riang, gembira, sopan.
debrief	kkt. mengadakan wawancara dengan seseorang yang kembali dari sesuatu tugas. -debriefing kb. tanya-jawab, wawancara.
debris	kb. (re)runtuhan, puing.
debt	kb. 1 (h)utang. d. of honor utang budi. to be in d. berutang. to be out of d. tidak berhutang/berkewajiban membayar.
debtor	kb. 1 orang yang berutang. 2 orang yang berdosa... as we forgive our debtors sambil kami ampuni orang-orang yang berdosa kepada kami.
debunk	kkt. 1 menghilangkan prasangka terhadap seseorang. 2 menolak kepalsuan-kepalsuan seseorang.
debut	1 pertunjukan yang pertama. 2 debut, pemunculan pertama dimuka umum.
debutante	kb. wanita yang baru membuat debutnya.
dec.	(december) desember.
decade	kb. dasawarsa, masa sepuluh tahun.
decadence	kb. keadaan mundur, kemerosotan, kemunduran, dekadensi.
decadent	ks. merosot. a d. period masa dekadensi/kemerosotan.
decaffeinate	kkt. mengeluarkan "caffeine". decaffeinated coffee kopi yang sudah dilarutkan "caffeine"-nya, kopi tanpa caffeine.
decant	kkt. menuangkan.
decanter	kb. karaf anggur.
decapitate	kkt. memenggal leher.
decapitation	kb. pemenggalan leher.
decathlon	kb. dasalomba.
decay	kb. 1 kebusukan, kerusakan. 2 kehilangan. 3 kekurangan. -kkt. membusukkan. -kki. 1 (menjadi) busuk. 2 runtuh. -decayed ks. 1 yang hancur. 2 yang busuk.
decease	kb. kematian. -kki. meninggal dunia. -deceased kb. almarhum.
decedent	kb. law : orang yang meninggal.
deceit	kb. penipuan, kebohongan, ketidakjujuran.
deceitful	ks. yang bohong, yang palsu, yang dusta, yang memperdayakan.
deceitfulness	kb. kecurangan, ketidak jujuran, kebohongan.
deceive	kkt. menipu, mencurangi. -kki. memperdayakan, membohongi. his appearance is deceiving sikapnya memperdayakan.
deceiver	kb. penipu, pembohong, pendusta.
decelerate	kkt., kki. mengurangi kecepatan. the plane decelerated after it landed on the runway kapal terbang itu mengurangi kecepatannya sesudah ia mendarat di landasan.
deceleration	kb. perlambatan.
december	kb. (bulan) desember. in d. pada bulan desember. on the 8th of d. pada tanggal 8 desember.
decency	kb. (j. -cies) 1 kesopanan, kelakuan yang baik. 2 kesusilaan.
decennial	kb. dasawarsa. 2 masa setiap atau untuk sepuluh tahun.
decent	ks. 1 sopan. 2 patut. 3 layak. 4 lumayan. 5 pantas. 6 baik.
decentralization	kb. desentralisasi.
decentralize	kkt. mengadakan desentralisasi, mendesentralisasikan.
deception	kb. penipuan, muslihat, kecurangan. he's a master at d. ia ahli dalam penipuan. ia seorang penipu yang ulung.
deceptive	ks. yang memperdayakan. -deceptively kk. seolah-olah, seakan, akan. d. easy seakan-akan gampang.
decibel	kb. desibel.
decide	kkt. menentukan, memutuskan. -kki. 1 memutuskan. 2 menentukan. 3 mengambil keputusan. -decided ks. 1 nyata. 2 pasti. 3 jelas. decidedly kk. terang, pasti, jelas.
deciduous	ks. yang berganti daun, yang rontok. d. tree pohon yang berganti daun.
decimal	kb. desimal, persepuluhan. d. fraction pecahan desimal. d. system desimal. d. point tanda/koma desimal.
decimate	kkt. membinasakan sebagian besar, menipiskan, mengurangi. a famine can d. a population kelaparan dapat menipiskan penduduk.
decimation	kb. pengurangan, pembunuhan, penipisan.
decipher	kkt. menguraikan (codes). to d. a language membaca dan mengartikan suatu bahasa.
decipherment	kb. penguraian.
decision	kb. 1 keputusan. 2 ketegasan. -kkt. inf.: box.: mengalahkan angka. the boxer was decisioned petinju itu dinyatakan kalah angka.
decisive	ks. 1 menentukan. 2 tegas. -decisively kk. secara meyakinkan.
deck	kb. 1 geladak (of ship). 2 bungkus (of cards). -kkt. to d. out berdandan, berpakaian lengkap.
declaim	kkt. mendeklamasikan (poetry). -kki. to d. against mengecam, melontarkan celaan terhadap.
declamation	kb. deklamasi.
declaration	kb. 1 pernyataan. d. of independence pernyataan kemerdekaan. 2 keterangan. customs d. daftar isian, laporan kepada pabean.
declarative	ks. yang menerangkan, menyatakan. d. sentence kalimat yang menyatakan.
declare	kkt. 1 mengumumkan (war, a divident). 2 melaporkan. 3 menyatakan (war). 4 menganggap. 5 menerangkan.
declassification	kb. deklasifikasi.
declassifies	lih declassify.
declassify	kkt. (declassified) memindahkan bahan-bahan dari daftar rahasia.
declension	kb. gram.: pentasrifan.
declination	kb. 1 deklinasi, jadwal (of the sun). 2 penolakan. d. of a fellowship penolakan dana siswa.
decline	kb. 1 kemunduran. 2 turun. -kkt. 1 menolak (an invitation). 2 gram.: mentasrif (a noun). -kki. 1 merosot. -declining ks. mundu, berkurang.
declivity	kb. (j. -ties) lereng yang menurun.
decoction	kb. jamu-jamuan yang direbus.
decode	kkt. membaca sandi. -de-coding kb. menguraikan isi sandi/kode.
decoder	kb. 1 ahli sandi. 2 (machine) alat membaca sandi balik.
decolletage	kb. potongan baju wanita yang lehernya sangat rendah.
decollete	ks. potongan leher yang rendah sekali. d. dress baju yang potongan lehernya sangat rendah.
decolonization	kb. dekolonisasi.
decommission	kkt. menonaktifkan (a ship).
decompose	kkt., kki. menjadi busuk, membusuk. the body was decomposed from exposure badan itu membusuk karena tidak dilindungi. -decomposed ks. busuk. d. body badan yang sudah busuk.
decomposition	kb. kebusukan, pembusukan.
decompress	kkt. menghilangkan/mengurangi tekanan udara.
decompression	kb. pengurangan atau penghilangan tekanan udara. d chamber ruang yang tekanan udaranya dikurangi.
deconcentration	kb. dekonsentrasi.
decongestant	kb. obat atau barang yang menghilangkan rasa sesak atau kemampatan (hidung). nasal d. obat yang menghilangkan kemampatan pada hidung.
decontaminate	kkt. membebaskan dari zat-zat radioaktip, kuman-kuman, gas racun dsb. , mendesinfeksikan.
decontamination	kb. 1 pembebasan dari bahaya. penyakit menular. 2 pembebasan dari benda-benda yang mengandung zat radioaktif.
decor	kb. dekor, hiasan.
decorate	kkt. 1 menghiasi (a christmas tree, a house). 2 memberi tanda jasa. to d. a soldier for heroism memberi tanda jasa kepada prajurit untuk kepahlawanannya.
decoration	kb. 1 hiasan. 2 dekorasi. 3 mil.: tanda jasa, bintang kehormatan/jasa.
decorative	ks. yang menghiasi, yang bersifat menghias, dekoratif.
decorator	kb. penghias. interior d. penghias rumah.
decorous	ks. pantas, terhormat, sopan. d. behavior tingkah laku yang pantas.
decorum	kb. kepantasan, adat yang pantas dalam pergaulan.
decoy	kb. 1 umpan. 2 pemikat, perangkap. d. duck itik pemikat. 3 bujukan. -kkt. memikat, membujuk.
decrease	kb.kb. 1 potongan (in price, in salary). 2 pengurangan (in speed). -kkt.mengurangi (price).
decree	kb. 1 dekrit, surat keputusan/ketetapan. 2 titah (of a ruler). -kkt. 1 memutuskan. 2 bersabda, menitahkan.
decrepit	ks. jompo, tua sekali.
decry	kkt. (decried) mengutuk, mencela, menentang. to d. the drinking of alcoholic beverages mengutuk peminuman minuman keras.
dedicate	kkt. 1 mempersembahkan. 2 membaktikan. 3 meresmikan pemakaian/pembukaan. to a d. a building meresmikan pemakaian sebuah gedung.
dedication	kb. 1 pengabdian. 2 persembahan. 3 pembaktian. 4 peresmian pemakaian/pembukaan.
dedicatory	ks. sebagai peringatan. d. volume buku peringatan.
deduce	kkt. menarik kesimpulan. from this one con d. a great deal dari hal ini seseorang banyak dapat menarik kesimpulan.
deduct	kkt. mengurangi, mengambil, memotong. d. this amount from my salary kurangilah jumlah ini dari gaji saya.
deductible	ks. dapat/sudah dikurangi.
deduction	kb. 1 deduksi, pengambilan kesimpulan. 2 potongan.
deductive	ks. deduktif.
deed	kb. 1 perbuatan. 2 akte (notaris). -kkt. memindahkan/memberikan dengan naskah resmi.
deem	kkt. menganggap, mempertimbangkan.
deep	kb. bagian yang dalam. -ks. 1 dalam 2 mendalam. 3 tinggi. -kk. jauh. deep-sea ks. mengenai bagian laut yang dalam sekali. deep-set ks. cekung. -deeply. kk. (men)dalam.
deepen	kkt. memperdalam. to d. a well memperdalam sumur. -kki. mendalam. the mystery deepened kegaiban mendalam.
deepwater	ks. mengenai air yang dalam. d. channel terusan air yang dalam.
deer	kb. rusa, kidang, kijang.
deerskin	kb. kulit rusa.
def.	(definite) pasti, tentu.
deface	kkt. mencacati, merusakkan, menodai, mengotori (a monument).
defacement	kb. pencacatan, perusakan, penodaan.
defaecate	= defecate.
defamation	kb. fitnah(an), penistaan. he was sued for d. of character dia dituntut karena memfitnah.
defamatory	ks. yang bersifat memfitnah. d. statements ucapan-ucapan yang bersifat memfitnah.
defame	kkt. memffitnah, mencemarkan nama baik. to d. opponent mencemarkan nama baik seorang lawan.
default	kb. kegagalan, kelalaian. in d. of karena gagal, tsak dapat/sanggup.-kki. lalai.
defeat	kb. 1 kekalahan. 2 penaklukan. -kkt. 1 mengalahkan, menggulingkan (the enemy). 2 menggagalkan(a motion). 3 sport : menundukkan.
defeatism	kb. sikap menyerah/kalah.
defeatist	kb. seorang yang bersifat mengalah. he suffers from a d. attitude ia mengandung sifat-sifat mengalah.
defecate	kki. membuang air besar.
defecation	kb. pembuangan air besar, berak.
defect	kb. 1 kerusakan. 2 cacat. -kki. menyeberang.
defection	kb. penyebrangan, peninggalan.
defective	ks. 1 tidak sempurna, cacat. 2 rusak. d. parts bagian-bagian yang rusak. 3 kurang baik. d. hearing pendengaran yang kurang baik.
defector	kb. penyebrang, orang yang meninggalkan partainya, pasukannya dsb.
defence	= defense.
defend	kkt. membela, mempertahankan. -defending champion juara bertahan.
defendant	kb. terdakwa, tergugat. d. in the lawsuit terdakwa dalam perkara pengadilan itu.
defender	pembela.
defense	kb. 1 pertahanan. 2 pembelaan. 3 penjagaan. 4 law : pembela.
defenselles	ks. tak berdaya. a d. person seorang yang tak berdaya.
defensive	kb. sikap bertahan. to place/put on the d. mempersiapkan untuk membela diri. -ks. sifat pembelaan. to take a d. attitude bersifat bertahan.
defensiveness	kb. keadaan membela diri.
defer	kkt. (deferred) menunda, menangguhkan. -kki. tunduk. -deferred ks. yang ditunda/ditangguhkan. d. payment pembayaran yang ditangguhkan.
deference	kb. rasa hormat. the d. due an older rasa hormat yang selayaknya kepada orang yang lebih tua. in/out of d. to untuk menghormati. in d. to his age untuk menghormati umurnya.
deferential	ks. yang menghormati/menghargai/memuji-muji. his d. attitude is irriating sikapnya yang menghormat menjengkelkan.
deferment	kb. penundaan, pertangguhan.
defiance	kb. tentangan, tantangan. to leave home in d. of o's parents meninggalkan rumah bertentangan dengan orangtuanya.
defiant	ks. bersifat menentang/menantang. d. attitude sikap menantang. -defiantly kk. secara menantang dengan tidak mengindahkan / mematuhi.
deficiency	kb. (j. -cies) kekurangan. vitamin d. kekurangan vitamin.
deficient	ks. 1 kurang, tidak sempurna. d. in carbohydrates kekurangan hidrat arang. 2 kurang baik. d. in mathematics kurang baik dalam ilmu pasti.
deficit	kb. defisit, tekor, kekurangan. to suffer a severe d. mengalami defisit yang hebat. d. financing keuangan yang tekor.
defile	kkt. 1 mengotorkan. 2 merusakkan. 3 mencemarkan.
definable	ks. dapat ditegaskan/diuraikan.
define	kkt. 1 memberi definisi. 2 menegaskan, menetapkan.
definite	ks. 1 pasti. 2 tertentu. 3 nyata. -definitely kk. pasti. i'll be there tomorrow saya pasti akan disana besok.
definition	kb. 1 definisi, ketentuan. 2 ketentuan. 3 ketajaman. by d. menurut definisi.
definitive	ks. pasti, menentukan. the results are not d. hasil-hasil itu tidak pasti.
deflate	kkt. 1 mengempiskan (a tire). 2 menurunkan.
deflation	kb. 1 deflasi, penurunan. d. of the currency penurunan nilai mata uang. 2 pengempisan (of a balloon).
deflationary	ks. bersifat deflasi. d. measures tindakan-tindakan bersifat deflasi.
deflect	kkt. 1 membelokkan. the wind deflected the arrow's path angin membelokkan jalan panah itu. 2 menangkis, mengelakkan. to d. a blow menangkis pukulan.
deflection	kb. 1 pembelokan. 2 pengelakan. 3 defleksi.
deflector	ks. deflektor.
deflexion	= deflection.
deflower	kkt. 1 merusakkan, menghancurkan. 2 merogol (anak dara).
defoliate	kkt. menggundulkan. the tree was wholly defoliated pohon itu telah gundul seluruhnya.
deforest	kkt. menebang/menghilangkan hutan.
deforestation	kb. deboisasi, penebangan hutan.
deform	kkt. merusak bentuk. to d. the feet by wearing tight shoes merusak bentuk kaki dengan memakai sepatu yang sempit. -deformed ks. cacat bentuknya, bercacat.
deformation	kb. perubahan bentuk. d. of the feet pencacatan bentuk kaki.
deformity	kb. (j. -ties) kelainan bentuk, bentuk yang cacat. d. of the foot kelainan bentuk kaki, keadaan cacat pada kaki.
defraud	kkt. 1 menggelapkan uang. to d. a firm menggelapkan uang sebuah firma. 2 menipu.
defray	kkt. membiayai (costs/expenses).
defrock	kkt. memecat pendeta oleh karena cara-caranya yang tidak ortodoks.
defrost	kkt. mematikan lemari es untuk menghilangkan es yang membeku, membersihkan endapan-endapan air yang membeku pada lemari es, menghilangkan bekuan es.
deft	ks. tangkas, terampil, cekatan. d. fingers jari-jari yang tangkas.
defunct	the d. kb. (orang) yang sudah mati/meninggal. -ks. mati, ditutup. d,firm sebuah firma yang ditutup. d. newspaper koran yang mati.
defy	kkt. (defied) 1 menentang (orders). 2 menantang, tahan menghadapi (rust). to d. description tak terlukiskan, tak dapat diuraikan.
deg.	(degree) derajat.
degenerate	ks. (seorang) yang merosot akhlaknya. -kki. memburuk, turun derajat. the meeting degenerated into a free-for-all rapat memburuk menjadi perkelahian umum.
degeneration	kb. kemerosotan, proses kemunduran.
degenerative	ks. bersifat merosot/kemunduran. to undergo the d. changes common to old age mengalami perubahan-perubahan kemerosotan yang biasa terjadi pada umur tua.
degradation	kb. 1 keburukan. the d.of a prison sentence keburukan hukuman penjara. 2 penurunan. d. in officer's rank penurunan pangkat, degradasi.
degrade	kkt. 1 menurunkan. 2 merendahkan. -degrading ks. menghinakan, menurunkan martabat.
degree	kb. 1 derajat. 2 gelar. 3 kadar, tingkat. to a d. sedikit banyak. by degrees sedikit demi sedikit, lambat laun.
dehumidifier	kb. alat menghilangkan lembab, alat pengering udara.
dehumidify	kkt. (dehumidified) menghilangkan lembab.
dehydrate	kkt. menjadi kering, mendehidrasi, menghilangkan air dari (sesuatu) -dehydrased ks. kering sekali.
dehydration	kb. dehidrasi, pengeringan.
deice	kkt. menghilangkan lapisan es. to d. the wings of a plane menyingkirkan lapisan es dari sayap-sayap kapal terbang.
deicer	kb. alat untuk menghilangkan es, alat penyapu es.
deification	kb. pendewaan.
deify	kkt. (deified) mendewakan, memuja sebagai dewa.
deign	kki. berkenan. she finally deigned to give me a date akhirnya ia berkenan berkencan dengan saya.
deity	kb. (j. -ties) 1 dewata, dewa. the d. of the sea dewa laut. 2 kedewaan, ketuhanan. to believe in the d. of christ percaya kepada sifat ketuhanan kristus.
deject	kkt. mematahkan hati. trouble does not d. him kesusahan tidak mematahkan hatinya. -dejected ks. kesal, sedih, patah hati. he felt d. after... i merasa kesal setelah...
dejection	kb. kekesalan, kepatahan hati.
del.	(delaware) negara bagian as.
delay	kb. kelambatan. 2 penundaan. -kkt. menunda (the trial). -delayed ks. yang (ter)lambat. -delaying ks. yang menunda.
delectable	ks. lezat. d. meal makanan yang lezat.
delegate	kb. utusan. -kkt. 1 mengutus, menyerahi. 2 menyerahkan. to d. o's authority menyerahkan kekuasaan.
delegation	kb. 1 perutusan, delegasi. government d. perutusan pemerintah. 2 penyerahan. d. of authority penyerahan kekuasaan.
delete	kkt. menghilangkan, mencoret, menghapuskan. d. this statement from the record hilangkanlah pernyataan ini dari laporan.
deleteratious	ks. merusak, mengganggu. smoking may have a d. effect on o's healt merokok bisa mengakibatkan rusaknya kesehatan seseorang.
deletion	kb. penghilangan, pencoretan, penghapusan. d. of certain sentences penghapusan kalimat-kalimat tertentu.
deliberate	ks. 1 (dengan) sengaja, yang disengaja. 2 tenang dan berhati-hati, tidak tergesa-gesa. -kki. berunding. -deliberately kk. 1 dengan sengaja. 2 berhati-hati.
deliberation	kb. pertimbangan (yang mendalam). after much d. he made up his mind setelah mempertimbangkannya masak-masak ia mengambil suatu keputusan.
delicacy	kb.(j. -cies) 1 makanan yang lezat. 2 kehalusan. the d. of her skin kehalusan kulitnya. 3 keadaan yang genting.
delicate	ks. 1 lembut. a d. old lady seorang wanita tua yang lembut. 2 sulit. d. question pertanyaan yang sulit. 3 lekas tersinggung. she is very d. about such matters ia merasa lekas tersinggung mengenai hal-hal yang demikian itu.
delicatessen	kb. 1 toko makanan. 2 barang-baran makanan.
delicious	ks. lezat, enak.
delight	kb. 1 kesenangan. 2 kesukaan. -kkt. sangat menyenangkan, menggembirakan hati. -kki. senang. -delighted ks. sangat gembira / senang.
delightful	ks. yang sangat menyenangkan, yang menggembirakan, yang penuh kegemaran. -delightfully kk. dengan sangat menyenangkan., dalam penuh kegembiraan.
delimit	kkt. membatasi. to d. precisely the boundaries between the two countries menentukan dengan tepat batas-batas antara kedua negara itu.
delineate	kkt. menggambar(kan), melukiskan.the route taken by the explores was clearly delineated on the map jalan yang ditempuh para penjelajah itu dilukiskan dengan jelas pada peta.
delinquency	kb. (j. -cies) kejahatan, pelanggaran. juvenile d. kenakalan anak-anak.
delinquent	kb. 1 (of a child) penjahat. 2 penunggak. -ks. 1 lalai membayar. he's d. in his taxes ia lalai membayar pajak. 2 nakal, jahat.
delirious	ks. 1 tergila-gila, lupa daratan. to be d. with exitement over the outcome of the election tergila-gila gembira karena hasil pemilihan. 2 mengigau. she was d. from fever dia mengigau karena demam.
delirium	kb. 1 kegila-gilaan. 2 igauan. d. tremens keadaan mabuk/mengigau, keadaan pikiran yang tidak waras.
deliver	kkt. 1 menyampaikan. 2 mengantarkan.3 mengucapkan, memberi. 4 memberi. 5 melepaskan. 6 menyerahkan. -kki. menghasilkan, memberi hasil. to be delivered of melahirkan.
deliverance	kb. pembebasan, pelepasan.
delivery	kb. (j. -ries) 1 pengantaran, pengiriman. 2 cara berpidato. 3 cara melemparkan bola. 4 kelahiran. 5 pemasrahan. 6 pembebasan, pelepasan. 7 pengiriman.
deliveryman	kb. (j. -men) pengantar.
dell	kb. lembah kecil.
delouse	kkt. menyelisik, menghilangkan kutu-kutu.
delta	kb. delta, beting, gosong yang panjang.
delude	kkt. memperdayakan, menipu. to d. o's with false hopes menipu diri sendiri dengan harapan-harapan hampa.
deluge	kb. banjir besar, air bah, hujan keras. -kkt. membanjiri. heavy rain deluged the cellars hujan lebat membanjiri ruang-ruang dibawah rumah.
delusion	kb. khayalan, angan-angan. delusions of grandeur khayalan kemegahan.
deluxe, de luxe	ks. mewah, sangat bagus. d accommodations akomodasi/tempat penginapan yang mewah.
delve	kki. 1 menyelidiki. the police delved into his past polisi menyelidiki masa hidupnya yang lalu. 2 mempelajari. to d. into books on that subject mempelajari dari buku-buku mengenai soal itu.
demagog(ue)	kb. penghasut/pemimpin/penggerak rakyat yang pandai berpidato.
demagoguery	kb. penghasutan rakyat.
demand	kb. 1 permintaan. 2 tuntutan. -kkt. meminta. 2 menuntut. 3 memerlukan. -kki. menuntut, menagih. -demanding ks. 1 banyak permintaannya. 2 banyak persyaratannya.
demarcation	kb. demarkasi, pembatasan, batas pemisah.
demean	kkt. to do o.s. merendahkan diri. he demeaned himself by taking a job as a waiter ia merendahkan martabatnya dengan menerima pekerjaan sebagai pelayan.
demeanor	kb. cara bertindak, sikap, kelakuan. she has a modest d. sikapnya bersahaja.
demented	ks. gila. d. individual orang yang gila.
demerit	kb. 1 cela, kekurangan. 2 angka buruk. to receive a d. for tardiness memperoleh angka buruk karena kelambanan.
demigod	kb. setengah dewa.
demilitarization	kb. de-militerisasi.
demilitarize	kkt. mendemiliterisasi(kan). demiliterized zone daerah yang dikosongkan dari pasukan militer.
demise	kb. kematian. d. of the late john doe kematian almarhum john doe.
demobilization	kb. demobilisasi.
demobilize	kkt. mendemobilisasikan.
democracy	kb. (j. -cies) demokrasi.
democrat	kb demokrat.
democratic	ks. 1 demokratis, sebagai sesamanya. 2 demokrat. d. party partai demokrat.
democratization	kb. pendemokrasian, demokratisasi.
democratize	kkt. mendemokratisasikan.
demographer	kb. ahli demokrafi.
demographic	ks. demografis.
demography	kb. demografi.
demolish	kkt. 1 membongkar (a building). 2 melumpuhkan, menghancurkan. to d. an opponent's argument melumpuhkan bantahan lawannya.
demolition	kb. pembongkaran, penghancuran, perusakan. d. of a building pembongkaran gedung. d. bomb bom perusak gedung-gedung dsb.
demon	kb. 1 setan, iblis, jin. 2 orang yang keranjingan tentang sesuatu.
demoniac	kb. orang yang kesurupan. -ks. kejam, bengis. her d. attitude sikapnya yang kejam.
demonic	ks. kejam, jahat.
demonstrable	ks. dapat dibuktikan/dipertunjukkan. d. proposition usul yang dapat dibukukan. -demonstrably kk. terang, dengan cara yang dapat dibuktikan. he is d. wrong ia terang sekali salah.
demonstrate	kkt. mempertunjukkan, mempertontonkan. -kki. berdemonstrasi.
demonstration	kb. demonstrasi. to hold a d. mengadakan demonstrasi.
demonstrative	ks. yang lincah dan bebas gerak-geriknya. (of the person). d. pronoun kataganti penunjuk.
demonstrator	kb. 1 demonstran. 2 contoh, pameran. d. car mobil yang dipakai sebagai contoh.
demoralization	kb. demoralisasi, kemerosotan akhlak.
demoralize	kkt. 1 menghilangkan semangat. 2 mengacaukan.
demote	kkt. menurunkan. the sergeant was demoted to corporal sersan itu diturunkan pangkatnya menjadi kopral.
demotion	kb. penurunan pangkat.
demur	kki. (demmurred) berkeberatan. i d. at working on saturdays saya berkeberatan untuk bekerja pada hari sabtu.
demure	kb. 1 sok/berlagak sopan. 2 bersungguh hati. a d. young girl seorang gadis yang bersungguh hati.
demurrage	kb. 1 keliwatan waktu berlabuh. 2 biaya kelebihan waktu berlabuh.
demurrer	kb. 1 penangkisan. 2 keberatan, pengecualian, eksepsi.
den	kb. 1 liang, gua. 2 sarang. 3 ruang kecil yang dipakai untuk membaca, bekerja dsb.
denationalization	kb. denasionalisasi.
denationalize	kkt. mendenasionalisasikan.
denature	kkt. mengubah sifat sesuatu benda. denatured alcohol alkohol yang dipakai untuk segala macam keperluan kecuali untuk diminum.
dendrology	kb. dendrologi, ilmu pohon-pohonan.
dengue	kb. penyakit demam disertai linu pada sendi-sendi dan otot-otot.
denial	kb. penolakan, sangkalan, penyangkalan.
denied	lih deny.
denies	lih deny.
denigrate	kkt. mencemarkan/memperburukkan nama orang lain.
denim	kb. semacam kain kepar/dril.
denizen	kb. penghuni, warga. d. of the deep penghuni laut.
denomination	kb. satuan. 2 kaum/umat/sekta/golongan agama. 3 lembaran uang kertas.
denominational	ks. yang dimiliki/dikuasai oleh salah satu kaum/golongan agama tertentu d. school sekolah golongan agama tertentu.
denominator	kb. angka sebutan (dalam bilangan pecahan). common d. angka sebutan senama, sebutan persamaan.
denotation	kb. denotasi, tanda, penunjuk.
denote	kkt. merupakan, menunjukkan.
denouement	kb. kesudahan/kesimpulan/akhir suatu sandiwara cerita, peleraian.
denounce	kkt. 1 mencela. 2 melaporkan. 3 mengadukan.
dense	ks. 1 tebal. d. smoke asap tebal. 2 padat. d. crowd orang banyak yang padat. 3 bodoh. -densely kk. padat, sesak, penuh. a d. populated area daerah yang padat penduduknya.
density	kb. (j. -ties) 1 kepadatan. population d. kepadatan penduduk. 2 berat jenis. d. of water berat jenis air, kekentalan air.
dent	kb. peot, peok, peyek. -kkt. melekuk. -dented ks. peok, peot, penyok, kepik.
dental	ks. 1 yang berhubungan dengan gigi. d. care pemeliharaan gigi. 2 dental. d. sound bunyi dental.
dentifrice	kb. tapal/pasta gigi.
dentin(e)	kb. gigi bagian dalam dibawah kepala gigi.
dentist	kb. dokter gigi.
dentistry	kb.(ilmu) kedokteran gigi.
dentition	kb. pertumbuhan gigi, pergigian.
denture	kb. geligi palsu/buatan.
denudation	kb. penggundulan.
denude	kkt. menggundulkan.
denunciation	kb. pengaduan. d. of a friend to the police pengaduan seorang teman kepada polisi.
deny	kkt. (denied) 1 menyangkal, mengingkari. 2 meniadakan.
deodorant	kb. obat untuk menghilangkan/membasmi bau busuk.
deodorize	kkt. menghilangkan bau busuk.
dep.	(department) biro. 2 (deputy) wakil, pembantu.
depart	kkt. meninggal. -kki. 1 berangkat. 2 menyimpang. 3 meninggal dunia. -departed kb. mendiang, almarhum.
department	kb. 1 departemen. 2 bagian.
departmental	ks. yang berhubungan dengan bagian. that's a d. matter itu urusan kantor bagian.
departure	kb. 1 keberangkatan. 2 permulaan kebiasaan.
depend	kki. 1 mempercayai, percaya akan, mengandalkan. 2 bergantung.
dependability	kb. hal dapat dipercayai, dapat dipertanggungkan/diandalkan.
dependable	ks. dapat dipercayai/diandalkan.
dependence	kb. 1 ketergantungan. 2 kepercayaan. 3 bantuan.
dependency	kb. (j. -ties) tanah jajahan.
dependent	kb. tanggungan. -ks. bergantung. she is too d. upon her parents ia terlalu bergantung pada orang tuanya.
depict	kkt. melukiskan, menggambarkan. to d. the beauty of area melukiskan keindahan daerah itu.
depiction	kb. (pe)lukisan, (peng)gambaran. d. of the scene was beautifully done pelukisan pemandangan itu indah.
depilatory	kb. (j. -ries) obat menghilangkan rambut.
deplane	kki. turun dari pesawat terbang. to d. in rome turun dari kapal terbang roma.
deplenish	kkt. mengosongkan, menghabiskan. to d. o's savings mengosongkan tabungannya, menghabiskan uang simpanannya.
deplete	kkt. menghabiskan, mengosongkan. my savings account was depleted by large medical expenses uang simpananku/tabunganku habis karena pengeluaran besar unutk pengobatan.
depletion	kb. kehabisan, penipisan. d. of oil reserves kehabisan persediaan minyak.
deplorable	ks. 1 tercela. his attitude is d. sikapnya tercela. 2 menyedihkan. the situation is d. keadaan menyedihkan.
deplore	kkt. menyesalkan. we d. the assassiation kami menyesalkan pembunuhan itu.
deploy	kkt. menyebar(kan). to d. the marines menyebarkan prajurit-prajurit kko .
deponent	ks. deponen.
depopulate	kkt. mengurangi/mengosongkan/ menghapuskan penduduk.
deport	kkt. mengembalikan.
deportation	kb. deportasi, pengasingan, pembuangan, pengiriman kembali ke negeri asal.
deportment	kb. tingkah laku, kelakuan, sikap.
depose	kkt. 1 memecat, memperhentikan. 2 menerangkan dibawah sumpah, memberikan kesaksian.
deposit	kb. 1 deposito, setoran, simpanan uang pangkal. 2 uang tanggungan. 3 lapisan. 4 endapan. 5 simpanan, tumpukan. -kkt. 1 mendepositokan. 2 menumpuk, menaruh, menempatkan.
deposition	kb. 1 pernyataan. d. of a sworn witness pernyataan seorang saksi dibawah sumpah. 2 penurunan dari tahta. 3 endapan. d. of mud endapan lumpur.
depositor	kb. penyetor, penyimpan, penabung.
depository	kb. (j. -ries) tempat penyimpanan.
depot	kb. 1 depo(t), gudang. munitions d. gudang mesiu. 2 stasiun. bus d. setasiun bis.
deprave	kkt. merusak akhlak, memburukkan. drinking may d. a person minuman keras dapat merusak moral seseorang. -depraved ks. yang sudah rusak/bejad akhlaknya. a d. criminal seorang penjahat yang sudah bejad akhlaknya.
depravity	kb. (j.-ties) kerusakan/keburukan/bejad moral.
deprecate	kkt. mencela, mengutuk. -deprecating ks. yang mencela. d. remarks ucapan-ucapan yang bersifat mencela.
deprecation	kb. celaan, kutukan, bantahan.
deprecatory	ks. = deprecating.
depreciate	kki. menurun/jatuh harganya. the property rapidly depreciated in value harta milik itu dengan cepat menurun nilainya.
depreciation	kb. turunnya nilai. annual d. penurunan harga tahunan.
depredation	kb. pembinasaan, perbuatan memusnahkan.
depress	kkt. 1 menekan. 2 menyedihkan. -depressed ks. murung, muram, sedih. -depressing ks. 1 muram. 2 yang memuramkan, yang menghilangkan semangat.
depression	kb. 1 econ.: jaman meleset, depresi. 2 kemuraman, kehilangan. 3 bagian yang rendah atau dangkal. 4 penurunan.
deprivation	kb. 1 pencabutan (of rights). 2 kehilangan, perampasan. (of food, money, etc.). 3 kerugian.
deprive	kkt. 1 mencabut. 2 menghilangkan.
dept.	(department) biro, departemen, jawatan.
depth	kb. dalam (ukuran) the d. of a well dalamnya sumur. 2 kedalaman. 3 lebar. 4 tengah-tengah.
deputation	kb. (peng)utusan, deputasi, perutusan. a d. of office workers perutusan pekerja-pekerja kantor.
depute	kkt. 1 menugaskan. 2 menguasakan.
deputize	kkt. mewakilkan kepada.
deputy	kb. (j. -ties) 1 wakil. d. sheriff wakil kepala polisi daerah/kabupaten. 2 utusan.
derail	kkt. menggelincirkan. -kki. keluar rel. the rain derailed at... kereta api itu keluar rel di...
derailment	kb. hal keluar dari rel.
derange	kkt. 1 menyebabkan gila. 2 mengacaukan. -deranged ks. gila. d. man orang gila.
derangement	kb. 1 penyakit gila/jiwa. 2 kekacauan.
derelict	kb. 1 (person) orang terlantar/gelandangan. 2 nav.: kapal yang ditinggalkan. -ks. 1 yang ditinggalkan. d. vessel kapal yang ditinggalkan. 2 lalai. d. in o's duty lalai dalam tugasnya.
dereliction	kb. kelalaian. d. of duty kelalaian melakukan tugas.
deride	kkt. mengejek, mencemoohkan. his friends d. him for his shyness teman-temannya mengejeknya karena ia pemalu.
derision	kb. ejekan, cemoohan.
derisive	ks. yang bersifat mengejek. d laughter tertawa yang mengejek.
derivation	kb. asal(mula). what's the d. of this word ? apakah asal (mulanya) kata ini ?
derivative	kb. kata jadian. -ks. dikarang dari yang asli.
derive	kkt. 1 mendapat, memperoleh. 2 mengambil. 3 berasal.
dermatitis	kb. kb. radang/infeksi kulit.
dermatologist	kb. ahli ilmu penyakit kulit.
dermatology	kb. dermatologi, ilmu penyakit kulit.
derogatory	ks. yang menghina. to speak in d. terms of berbicara dengan kata-kata yang menghina mengenai.
derrick	kb. (mesin) kerekan, mesin kerek/derek. oil d. alat/menara pembor(an) minyak.
desalinization	kb. pekerjaan menghilangkan zat garam/rasa asin dari air laut.
descend	kkt. turun (gunung, tangga). -kki. 1 turun. 2 merendahkan diri. 3 bernenek-moyang. -descending ks. yang menurun. on a d. scale pada skala yang menurun.
descendant	kb. 1 keturunan. 2 anak cucu.
descent	kb. 1 turun(nya). 2 keturunan. 3 serangan.
describe	kkt. 1 melukiskan, menggambarkan. 2 membuat, menggambarkan.
description	kb. gambaran, deskripsi, lukisan. beyond d. tak terlukiskan. to answer to the d. sesuai dengan yang dilukiskan.
descriptive	ks. deskriptif. d. linguistics ilmu bahasa deskriptif. d. geometry ilmu ukur melukis.
desecrate	kkt. menajiskan, menodai (gereja, katedral).
desectration	kb. penajisan, penodaan, pengotoran.
desegregate	kkt. menghilangkan perbedaan atau pemisahan.
desegregation	kb. desegregasi, penghapusan perbedaan.
desert	kb. padang/gurun pasir. -kkt. meninggalkan. -kki. membelot, meninggalkan tugas militer, melarikan dari tugas militer. -deserted ks. 1 yang ditinggalkan. 2 sepi, sunyi.
deserter	kb. desertir, pembelot.
desertion	kb. 1 mil.: desersi, pembelotan.2 perbuatan meninggalkan.
deserve	kkt. 1 berhak mendapat. 2 pantas, patut menerima.-deserved ks. well-d. honor penghargaan yang selayaknya (diperoleh).-deservedly kk. sdh sepatutnya.-deserving ks.1 yg pantas di tolong.2 yg berjasa.
desiccation	kb. pengawetan melalui proses pengeringan.
desideratum	kb. (j.-ta). s.s.t. yg diinginkan, kebutuhan yg terasa.
design	kb. potongan. 2 bentuk.3 model.4 pola.5 kontruksi.6 mode. 7 tujuan, maksud.-kkt. merencanakan.-designing kb. membuat pola-pola. ks. berkomplot, bersekongkol.
designate	ks. calon.-kkt. 1 menunjuk.2 menandakan.
designation	kb.1 penunjukan.2 tanda pangkat.3 penandaan.
designer	kb. pelukis, perencana, perancang, pembuat model.
desirability	kb. sifat diingini/disenangi/disukai,sifat yg menyebabkan orang menginginkannya/senang/suka memilikinya.
desirable	ks.1 diinginkan. (of the person) 2 diperlukan sekali.
desire	kb. 1 hasrat. 2 keinginan. 3 berahi. -kkt. 1 menginginkan, meminta. 2 mengingini. 3 berahi terhadap.
desirous	ks. ingin. i am d. of better facilities saya ingin memperoleh fasilitas-fasilitas yang lebih baik.
desist	kki. berhenti. the army demanded that the mob d. from its attack on... tentara menuntut agar perusuh-perusuh itu menghentikan serangan terhadap...
desk	kb. 1 mejatulis. 2 alas meja. 3 bagian. 4 kas.
deskbound	ks. bekerja dibelakang meja. in this job i am d. dalam jabatan ini saya bekerja dibelakang mejatulis.
desolate	ks. 1 terpencil. 2 sepi, sunyi. 3 sedih, muram. 4 tandus, gersang. -kkt. 1 merusakkan, menghancurkan. 2 menyedihkan, menyusahkan.
desolation	kb. 1 ketandusan (of a region). 2 kesedihan (of a person). 3 perusakan, penghancuran.
despair	kb. keputus-asaan, kepatahan hati, kehilangan harapan. -kki. hilang harapan. -despairing ks. yang berputus asa.
despatch	= dispatch.
desperado	kb. penjahat yang nekat, bajingan, bandit.
desperate	ks. 1 yang sangat menyedihkan. 2 nekat. 3 putus asa. to do s.t. d. melakukan yang tidak-tidak. -desperately kk. mati-matian.
desperation	kb. kenekatan, keputus asaan, kehilangan harapan. in d. he committed suicide dalam keadaan putus-asa ia membunuh diri.
despicable	ks. tercela, hina, keji. d. act perbuatan yang tercela.
despise	kkt. memandang rendah terhadap, menganggap hina. he despises fools ia memandang rendah orang-orang yang tolol.
despite	kb. meskipun, walaupun. d. the rain meskipun hujan.
despondency	kb. kemurungan, kesedihan, kepatahan semangat.
despondent	ks. sangat sedih, remuk hati. to be d. over remuk hati karena.
despot	kb. 1 raja lalim. 2 orang yang lalim.
despotic	ks. lalim.
despotism	kb. kelaliman.
dessert	kb. makanan pencuci mulut, kue-kue.
destination	kb. (tempat) tujuan .maksud.
destine	kki. 1 mempersiapkan, memperuntukkan. 2 mentakdirkan, memperuntukkan.
destiny	kb. (j. -nies) nasib, takdir, untung.
destitute	ks. miskin, papa, melarat. to be utterly d. hidup melarat sekali, menjadi miskin sekali.
destitution	kb. kemiskinan, kemelaratan, kepapaan.
destroy	kkt. memusnahkan, merusakkan, menghancurkan. 2 membinasakan, membunuh (an animal). to d. o.s. membunuh diri.
destroyer	kb. 1 perusak. d. of plants perusak tanaman. 2 nav.: kapal pemburu/ perusak.
destructible	ks. yang dapat dirusak.
destruction	kb. 1 pekerjaan merusak/menghancurkan / membinasakan. women were his d. wanita-wanita menjadikan kehancurannya. 2 pe(ng) rusakan, pembongkaran (of a building).
destructive	ks. 1 bersifat merusak. d. criticism kecaman yang bersifat merusak. d. child anak yang bersifat/suka merusak. 2 merusak. d. flood air bah yang merusak.
desultory	ks. tidak berketentuan. a d. conversation percakapan yang tidak berketentuan. d. study cara yang tidak berketentuan.
detach	kkt. 1 menyobek. 2 mil.: menugaskan di suatu tempat. 3 melepaskan. to d. cars memisahkan/melepaskan gerobak - gerobak barang. -detached ks. 1 obyektif, tidak memihak. 2 terpisah. 3 terlepas, mengelopak.
detachable	ks. yang dapat dilepaskan/ditanggalkan (of a cover, collar).
detachment	kb. 1 mil.: detasemen. 2 sikap yang tak terpengaruh. 3 hal melepaskan.
detail	kb. seluk beluk, perincian. 2 bagian kecil-kecil. 3 kelompok. -kkt. 1 memperbantukan. 2 melukiskan panjang lebar, memperinci. -detailed ks. terperinci, yang panjang lebar.
detain	kkt. 1 menahan, menawan. to d. s.o. for questioning menahan seseorang untuk pemeriksaan. 2 menghambat, menahan. i hope i haven't detained you too long saya harap saya tidak terlalu lama menahanmu.
detainee	kb. orang tahanan.
detect	kkt. 1 menemukan. 2 mencium. 3 mendapatkan 4 merasakan (sarcasm).
detection	kb. 1 penemuan. d. of crime penemuan kejahatan. 2 tercium. d. of gas tercium bau gas.
detective	kb. detektip, reserse, mata-mata polisi. d. story cerita detektip.
detector	kb. orang /alat yang dapat menemukan sesuatu, detektor. lie d. alat yang dapat menemukan seseorang berbohong. mine d. alat pencari ranjau.
detention	kb. penahanan, penawanan.
deter	kkt. (deterred) menghalangi. snow won't d. him from his trip. salju tak akan menghalanginya mengadakan perjalanan.
detergent	kb. bahan pembersih, sabun, sabuk, deterjen.
deteriorate	kki. memburuk. the situation has deteriorated keadaan telah memburuk.
deterioration	kb. keburukan, kemunduran, kemerosotan. d. in diplomatic relations keadaan yang memburuk dalam hubungan diplomatik.
determinant	kb. faktor/hal yang menentukan. what is the prime d. in this care? apakah faktor utama yang menentukan dalam perkara ini ?
determinate	ks. sudah(ter)tentu, tetap positif. the d, order urutan yang sudah tentu.
determination	kb. 1 kebulatan tekad, ketetapan hati. d. to further o.s. ketetapan hati untuk maju. 2 penentuan.
determine	kkt. 1 menentukan. 2 menetapkan. 3 memutuskan. -kki. memutuskan. -determined ks. tekun.
deterrence	kb. penolakan, penangkisan, pencegahan. lih deterrent.
deterrent	kb. 1 alat penghindaran/penangkis/ pencegah. the h-bomb as a d. bom hidrogen sebagai alat pencegah. 2 penghindaran, pencegahan, pengelakan.
detest	kkt. 1 benci. i d. sloppy language saya benci akan bahasa yang serampangan. 2 jijik. i simply d. her saya betul-betul merasa jijik terhadap dia.
detestable	ks. menjijikkan. a d. deed perbuatan yang menjijikkan.
detestation	kb. kebencian.
dethrone	kkt. menurunkan dari tahta.
detonate	kkt. meledakkan, meletuskan. -kki. meledak, meletus. -detonating ks. yang meledakkan. d. cap tutup/tudung detonasi, (pe)ledakkan penahan peledakkan.
detonation	kb. detonasi, (pe)ledakkan, (pe)letusan.
detonator	kb. detonator, alat/bahan peledak.
detour	kb. jalan memutar, pemutaran. -kki. mengambil jalan memutar.
detract	kki. to d, from 1 mengurangi. to d. from the beauty mengurangi keindahan. 2 menurunkan, memotong dari harganya.
detractor	kb. pengumpan, pencela, pemfitnah, tukang fitnah.
detriment	kb. kerusakan, kerugian. to the d. of his health sehingga merusak kesehatannya.
detrimental	ks. yang merusak/mengganggu. lack of exercise can be d. to o's health kurang latihan badan dapat mengganggu kesehatan seseorang.
deuce	kb. 1 dua (main kartu). 2 tenn.: jus, 4 0 sama. 3 kurang ajar, gerangan. who in the d. took my paper ? kurang ajar ; siapa yang mengambil koranku ?
devaluate	kkt. mendevaluasikan.
devaluation	kb. devaluasi.
devastate	kkt. merusak(kan), menghancurkan. -devastating ks. 1 yang menghancurkan. 2 sangat kena, sangat efektif. -devastatingly kk. meluluhkan, menghancurkan, amat.
devastation	kb. pe(ng)rusakan, penghancuran.
develop	kkt. 1 memperkembangkan (industry) 2 menghasilkan. 3 mencuci. 4 memperkuat. -kki. 1 menjadi. 2 selesai. 3 terjadi. 4 timbul. -developing ks. sedang berkembang.
developer	kb. 1 pembangun, ahli pembangunan. d. of low-cost housing (seorang) pembangun perumahan murah. 2 alat pencuci. d. of film alat pencuci filem.
development	kb. 1 perkembangan. the latest d. perkembangan terakhir. 2 pembangunan. housing d. pembangunan perumahan. 3 pertumbuhan (of a child).
developmental	ks. yang berhububgan dengan perkembangan, pembangunan. d. economics ekonomi pembangunan.
deviant	kb. orang yang menyimpang. he's a d. from the norm ia seorang yang menyimpang dari patokan-patokan / ketentuan/ketentuan.
deviate	kb., ks. (seorang) yang menyimpang. -kki. 1 berselisih. the compass deviates slightly pedoman itu berselisih sedikit. 2 menyimpang. to d. from cours menyimpang dari haluan.
deviation	kb. 1 deviasi, ikhtilaf. 2 penyimpangan. d. from the standart penyimpangan dati patokan. 3 selisih, simpangan. standard d. selisih pokok, simpangan baku.
deviationism	kb. penyelewengan/penyimpangan dari garis-garis politik partai.
deviationist	kb. penyeleweng, orang yang menyimpang dari garis-garis politik partai.
device	kb. 1 alat, perlengkapan. 2 muslihat.
devil	kb. 1 syaitan, iblis. 2 orang yang penuh tipu daya. 3 orang yang malang. -kkt. membumbui (telur). devil-may-care ks. masa bodoh, acuh tak acuh. -deviled ks. yang dibumbui.
devilfish	kb. semacam ikan gurita.
devilish	ks. 1 jahat, jahanam. a d. temper tabiat jahat. 2 besar sekali. i got into d. trouble saya terjerumus dalam kesukaran yang besar sekali.
devilment	kb. 1 perbuatan yang jahat. 2 kenekatan. i wonder what d. he's up to now ? saya ingin tahu kenekatan apa yang hendak dilakukannya sekarang.
devious	ks. berliku-liku. d. trick/ways tipu daya yang berliku-liku. d. route jalan yang berliku-liku.
devise	kkt. menemukan, memikirkan, merencanakan. to d. a way merencanakan suatu cara.
devoid	ks. (samasekali) tanpa, ketiadaan. he was utterly d. of humor ia sama sekali tak memiliki rasa humor.
devote	kkt. 1 mencurahkan. 2 bertekun. 3 menyediakan. to be devoted to sayang akan adiknya yang perempuan.
devotee	kb. penggemar (yang taat kepada sesuatu).
devotion	kb. 1 kesetiaan. 2 ketaatan. d. to duty ketaatan pada kewajiban. 3 kesayangan. -devotions j. kebaktian keagamaan.
devotional	ks. yang bersifat kebaktian. d. service ibadah kebaktian.
devour	kkt. 1 mengganyang. 2 menelan. 3 melahap (o's food). 4 membaca.
devout	ks. 1 yang beriman, saleh. a d. man pria yang beriman. 2 taat. -devoutly kk. dengan tulus-ikhlas, dengan segala ketulusan hati.
devulve	kki. berpindah. the responsibility devolved upon him tanggung jawab berpindah kepadanya.
dew	kb. embun.
dewdrop	kb. tetesan/titik embun.
dexterity	kb. ketangkasan, kecekatan, ketrampilan.
dexterous	ks. trampil, tangkas, cekatan.
dextrose	kb. dekstrosa.
diabetes	kb. penyakit gula, penyakit kencing manis.
diabetic	kb. penderita penyakit kencing manis. -ks. yang berhubungan dengan penyakit kencing manis.
diabolical	ks. kejam. d. torture penyiksaan yang kejam. d. grin seringai yang menyeramkan, menyeringai seperti setan.
diachronic	ks. berdasarkan/menurut sejarah. d. linguistics ilmu bahasa menurut sejarah.
diacritic	kb. tanda pengenal, diakritik.
diacritical	ks. bersifat mengenal. d. mark tanda pengenal.
diadem	kb. mahkota.
diaeresis	kb. tanda titik dua diatas huruf suara, menandakan supaya huruf itu dibunyikan juga.
diagnose	kkt. menentukan diagnosa, mengenal (an illness).
diagnosis	kb. diagnosa, ilmu pengenal penyakit.
diagnostic	ks. yang berdasarkan/bertautan dengan diagnosa. d. test percobaan untuk memudahkan pembuatan diagnosa.`
diagonal	kb. diagonal. -ks. 1 diagonal. 2 sudut-menyudut. -diagonally kk. secara diagonal.
diagram	kb. diagram, buram, sketsa, bagan. -kkt. (diagrammed) 1 menggambar bagan/rencana. 2 memperlihatkan susunan daripada.
dial	kb. 1 lempeng jam, muka arloji. 2 cakra angka (on dashboard). 3 cakra angka, piringan, tombol penjetel (radio, telephone, tv). -kkt. 1 memutar angka (telephone) 2 memasang.
dialect	kb. dialek, logat. provincial d. bahasa daerah. d. atlas peta logat-logat bahasa.
dialectal	ks. yang berhubungan dengan dialek.
dialectic(s)	kb. dialektika.
dialectical	ks. berdasarkan dialektika. d. materialism materialisme (berdasarkan dialektika).
dialectician	kb. ahli dialektika.
dialectology	kb. dialektologi.
dialog	= dialogue.
dialogue	kb. dialog, percakapan dwicakap.
diameter	kb. garis tengah.
diametrical	ks. diametral, yang samasekali bertentangan mengenai. -diametrically kk. samasekali bertentangan dengan pendapat kami.
diamond	kb. 1 intan, berlian. 2 ret, wajik. 3 lapangan. baseball d. lapangan baseball.
diaper	kb. popok.
diaphragm	kb. 1 anat.: sekat, rongga badan antara dada dan perut, diafrakma. 2 (iud) spiral.
diarrh(o)ea	kb. mencret, murus.
diary	kb. (j. -ries) buku harian.
diatetics	kb, ilmu yang mempelajari macam dan banyaknya makanan yang diperlukan oleh badan (cabang ilmu gizi).
diatribe	kb. pidato atau tulisan berisi kecaman-kecaman yang tajam.
dibs	kb., j. pilihan pertama. sl.: d. on the candy pilihan pertama ialah gula-gula itu.
dice	kb., j. dadu. to shoot d. bermain dadu. lih die. sl.: no d. tak berhasil -kkt. memotong-motong. to d. potatoes memotong-motong kentang dalam potongan-potongan persegi empat.
dichotomy	kb. (j. -mies) pembagian dalam dua bagian, pembelahan dua, bercabang dalam dua bagian.
dick	kb. sl.: mata-mata, reserse, detektip.
dickens	kseru. jahanam ? what the d. is going on here ? dubilah/sompret / busyet ! ada apa sih disini ?
dicker	kki. bertawar-tawaran. to d. with the vendors bertawar-tawaran dengan tukang-tukang jualan. -dickering kb. tawar-menawar, bertawar-tawaran. political d. tawar-menawar politik.
dict.	(dictionary) kamus.
dictaphone	kb. alat pengimla, alat mendikte surat-surat, mesin imla.
dictate	dictate
dictation	kb. 1 pengimlaan, pendiktean. 2 apa yang didiktekan. 3 perintah.
dictator	kb. diktator.
dictatorial	ks. 1 adikara. 2 angkuh, diktatoris. d. manner sifat angkuh.
dictatorship	kb. diktatur.
diction	kb. gaya menulis atau berbicara. 2 artikulasi.
dictionary	kb. (j. -ries) kamus, kitab logat. d. making perkamusan.
dictum	kb. (j. -a, -ums). keputusan, ucapan.
did	lih do.
didacric	ks. yang bersifat mendidik. d. novel roman yang bersifat mendidik.
didn't	(did not) lih did.
die	kb. (j. dice) mata dadu. -kki. 1 mati. 2 mati, meninggal dunia. to d. hard sukar lenyap, kuat bertahan. to d. down 1 menghilang. 2 reda. - the dying kb. yang akan mati. ks. 1 hampir mati. 2 hampir hilang.
dieresis	= diaresis.
diesel	kb. lokomotif disel. -ks. disel. d. oil minyak disel/solar. d.-powered truck truk yang bertenaga disel.
diet	kb. 1 diet. to follow a strict d. mengikuti diet yang keras. 2 makanan, diet. low-fat d. makanan yang sedikit lemaknya.
dietary	ks. yang berhubungan dengan makanan. d. rules peraturan-peraturan diet, peraturan-peraturan susunan makanan.
dietetic	ks. yang berhubungan dengan diet atau susunan makanan. d. foods makanan diet.
dietician	= dietitian.
dietitian	kb. ahli/penata diet.
differ	kki. berbeda. opinions d. pendapat-pendapat berbeda.
difference	kb. 1 perbedaan. 2 pertentangan, perselisihan. 3 pertikaian. 4 selisihnya. 5 sisa.
different	ks. tidak sama. to be d. from berbeda dari, berlainan. -differently kk. berlainan, berbeda.
differential	ks. 1 yang berbeda. d. rates harga-harga yang berbeda. 2 diferensial. d. calculus hitungan diferensial.
differentiate	kkt. membedakan. -kki. mengadakan perbedaan. to d. between two types mengadakan perbedaan antara dua macam.
differentiation	kb. perbedaan, diferensiasi.
difficult	ks. 1 sukar, sulit. 2 payah. (of a problem).
difficulty	kb. (j. ties) 1 kesukaran. financial difficulties kesukaran-kesukaran keuangan. 2 kesulitan.
diffidence	kb. 1 sifat malu-malu. 2 kehilangan kepercayaan kepada diri sendiri, ketakberanian.
diffident	ks. malu-malu.
diffuse	ks. 1 bersifat panjang, memakai (terlalu) banyak kata-kata. 2 yang tersebar. -kkt. menyebarkan.
diffusion	kb. 1 difusi. d. of light difusi cahaya. 2 penyebaran. d. of knowledge penyebaran pengetahuan.
diffusive	ks. 1 bersifat, menyebar. 2 yang memakai kata-kata yang berlebih - lebihan.
dig	kb. 1 (peng)galian. 2 sikutan, kotosan. 3 sindiran. -kkt. (dug) 1 menggali (a hole). 2 menusuk-nusuk, menjotos. 3 sl.: mengerti. 4 sl.: menghargai. 5 sl.: menyukai. -kki. menggali. -digging kb. 1 penggalian. 2 tempat penggalian.
digest	kb. 1 intisari. 2 perpendekan, persingkatan. -kkt. 1 mencernakan (food). 2 menyelami isi (a book). -kki. dicernakan. ths food is difficult to d. makanan ini sukar dicernakan.
digestible	ks. dapat dicernakan.
digestion	kb. pencernaan. arguments spoil my d. saya muak mendengarkan argumen-argumen.
digestive	ks. yang bertautan dengan pencernaan. d. system susunan pencernaan. d. tablet tablet yang mempercepat pencernaan.
digger	kb. 1 (person) seorang penggali. 2 alat penggali.
digit	kb. 1 jari tangan/kaki. 2 bijian, angka dari satu s/d sembilan. 3 jari sebagai ukuran panjang kira-kira 3/4 inci.
digital	ks. yang berhubungan dengan jari. d. computer mesin hitung yang mempergunakan angka-angka untuk sistim-sistim perhitungan tertentu.
digitalis	kb. daun-daunan dipakai sebagai obat memperkuat jantung.
dignify	kkt. (dignified) menghargai, menaikkan derajat. -dignified) ks. yang bermartabat. a d. old gentleman seorang kakek yang bermartabat.
dignitary	kb. (j. -ries) orang yang berkedudukan tinggi, orang yang terkemuka.
dignity	kb. (j. -ties) 1 martabat. 2 gengsi. he does everything with d. segala sesuatu dilakukannya dengan gengsi.
digraph	kb. huruf rangkap, dwihuruf.
digress	kki. menyimpang, melantur. to d. from the subject menyimpang dari pokok pembicaraan.
