kiblah	/kiblat/ 1 direction of mecca. 2 direction (of the wind). 3 orientation.
kiblik	(coll.) republic.
kibul	(jakarta) bottom, buttocks, rear.
kicak	see kicau 1.
kicang-kecoh	swindle, deceit of various kinds.
kicap	1. see kicau 1. 2. see kecap1.
kicap-kicup	repeated blinking of the eyes.
kicau	1. ber-kicau 1) chirp, twitter, warble. 2) chatter. 2. ter-kicau swindled.
kicerat	(jakarta) meng-kicerat spurt out.
kici	(naut.) ketch, brig.
kicu	1. 1) deceit. 2 ) deceiver. 2. see kicau1.
kicuh	see kicu 1.
kicut	squeak (of a floor, etc.).
kidal	left-handed. si-kidal southpaw.
kidam	time immemorial, infinite preexistence.
kidang	see kijang.
kidar	/kider/ see kitar 1.
kidmat	see khidmat.
kidul	(java) south.
kidung	ballad. kidung-gereja hymn. kidung-rohani a spiritual hymn.
kihanat	astrology, augury.
kijai	k.o. large timber tree.
kijang	1 k.o. small antelope. 2 brand name for k.o. jeep.
kijing	1. k.o. edible mussel. 2. (java) gravestone.
kiju	see keju.
kik	/ka i ka/ [ kredit investasi kecil] small business loans.
kikih	/kikik/ giggle.
kikil	1 foot of an animal (for eating). 2 foot of a person (jocking or contemptuous).
kikir	1. file, rasp. kikir-an filings. 2. stingy, tightfisted.
kikis	scraped.
kikisan	(geol.) alluvium, what has piled up from erosion.
kikuk	clumsy, awkward.
kilaf	see khilaf.
kilah	1. trick, deception, ruse, pretext. 2. k.o. snaillike mollusk.
kilai	spool or reel of thread (for spinning).
kilan	1. span (of the hand). 2. ter-kilan be offended.
kilang	1 press, mill, factory for processing or refining natural products. kilang-an millstone or other instrument for refining or processing.
kilang-kelok	winding, tortuous (road, path).
kilap	1. shine, gloss, shee, luster. 2. see khilaf.
kilar	k.o. edible snail.
kilas	1. 1) noose made of rattan. 2) rattan rings used for climbing trees or poles. 2. kilas-balik flashback.
kilat	1 flash of lightning. 2 shine, gleam, sheen. 3 done in a flash (in set expressions).
kilau	luster, reflected shine, glare.
kiler	(sl.) university lecture who gives killer exams.
kili	seam.
kili-kili	nose ring of rope or rattan for an ox or water buffalo.
kilik	meng-kilik-kilik 1 tickle. 2 amuse. 3 incite s.o.
kilir	1. whet (o.'s knife, etc.). 2. be sprained.
kilo	1 kilogram. 2 kilometer.
kilogram	kilogram.
kilometer	1 kilometer. 2 speedometer.
kilowat	kilowatt.
kim	k.o. gambling game similar to bingo where the numbers are given out in rhymed verses.
kima	the giant clam.
kimah,kimat	price, value, worth.
kimbang	ter-kimbang hestitating, wavering.
kimblo	see kimlo.
kimia	chemistry. kimia-analistis analistical chemistry. kimia-anorganik inorganic chemistry. kimia-fisika physical chemistry. kimia-hayat biochemistry.
kimiawi	chemical.
kimis	chemical, synthetic.
kimka,kimkha	damask.
kimlo	k.o. soup with vegetables and meat.
kimono	kimono, dressing gown.
kimpal	solid, welded.
kimpul	1. k.o. taro. 2. purse, wallet.
kimpus	ter-kimpus hollow, concave, sunken (of eyes, cheeks).
kina	quinine.
kinang	a chew of betel.
kinantang	1 be all white (of cock, horse, etc.). 2 very special.
kinca	syrup of palm sugar.
kincah	meng-kincah 1 rinse, wash (laundry, etc.). 2 dress, game or fowl. 3 cleanse the genitals.
kincan	meng-kincan mix, stir s.t.
kincang	fraud, deceit.
kinces	(jakarta) 1 deflated, burst (of boils). 2 blind.
kincir	spool, reel. kincir-air waterwheel. kincir-angin 1 windmill. 2 propeller.
kincit	minor case of diarrhea.
kincup	small, narrow, restricted (of an opening).
kineskop	tv screen.
kinetis	kinetic.
king	(crd.) king.
kingkit	k.o. tiny sour citrus fruit.
kini	now, nowadays.
kinine	quinine.
kinja	jump with joy.
kinjeng	dragonfly.
kintaka	archive.archival matters.
kintakawan	archivist.
kintal	1. see kuintal. /kintel/ bullfrog.
kintil	trail s.o.
kintut	(jakarta) youngest child.
kinurang	(math.) subtrahend.
kinyam	see kenyam.
kinyang	quartz, rock crystal.
kinyis-kinyis	still fresh.
kio	(china) palanquin.
kiong	see keong.
kios	kiosk. kios-buku bookstall.
kip	percussion cap.
kipa	one-legged.
kipai	wag.
kipang	1. cake made of fried rice or peanuts or sesame seeds with palm sugar. 2. see kepang 1.
kipar	see kepar.
kipas	1 fan. 2 propeller (of plane, etc.).
kipat	shake, shale off.
kiper	goalie, goalkeeper.
kiprah	1. (java) gait, pace, progress. 2. part of java dance which displays making up and dressing.
kiprat	1. 1) spurt out, jump. 2) hit. 2. splash s.o. or s.t.
kipsiau	(china) teakettle.
kipu	craftsman.
kir	1 examination, test. 2 motor vehicle inspection. 3 get o.s. examinated, get s.t. inspected.
kira	guess, reckon, suppose.
kira-kira	1 approximately, about, around. 2 estimate. 3 perhaps, do you thing. 4 probably. 5 reasonable, within reason.
kirab	1. carnival. 2. (java) a ritual procession moving in a circle (e.g. bridal couples, heirlooms, etc.).
kirai	1. 1) shake out (wet laundry, tablecloth, rug). 2) winnow (rice, etc.). 3) spread (rice) out to dry. 4) flap (its wings, etc.), push open (a door). 2. long strip. 3. k.o. palm tree. kirai-an open spice.
kirana	(java) 1 ray. 2 beautiful.
kirap	1. 1) hit (with its wings, of an angry goose, hen). 2) flap. 3) flutter (of wings, flag). 2. disappear, vanish (of ideals, etc.).
kiras	k.o. timber tree.
kirau	not quite ripe (of fruit).
kirbat	bag to hold water, wine etc.
kiri	1 left. 2 (naut.) port. 3 command to driver to pull over to let passenger out. 4 leftist. 5 awkward 9behavior). 6 left-handed. 7 unfortunate, unfavorable.
kirik	1. mengk-kirik shuder (from fear). 2. pup.
kirim	kirim-salam/tabik send greetings or regards.
kiriman	1 shipment, consigment, s.t. sent. 2 missive, missile. 3 item left for safekeeping. 4 rain or some other natural phenomena which comes out of season.
kirmizi	(lit.) scarlet, crimson.
kirtya	(lit.) society, organization.
kiruh	see keruh 1.
kirut-mirut	wrinkles.
kis	box, chest.
kisa	1 small purse. 2 small purse net for coastal fishing.
kisah	1 story. 2 narrative. kisah-bersambung serialized story. kisah-perjalanan travelogue. ber-kisah tell a story. peng-kisah narrator.
kisai	meng-kisai sift (rice). kisai-an sifter, sieve.
kisar	rotation (of the earth on its axis).
kisaran	1 revolution, turn. 2 milling (of wheat, etc.). 3 vortex.
kisas	retribution.
kisat	see kesat.
kisi	1 grill, lattice, trellis.
kisik	whisper. kisar-an gossip.
kismat	/kismet/ 1 fate, destiny. 2 an interjection expressing resignation, what can o. do ?
kismis	raisin.
kisruh	1 chaotic, anarchic. 2 confused, disorganized.
kissah	see kisah.
kista	cyst.
kisut	1 wrinkled, dried up (of skin, etc.). 2 creased (of clothes, etc.).
kiswah	(islam) veil that covers the kabah.
kit	(coll.) square, paid up.
kita	1 we (including person addressed), our, us. 2 (coll.) i (somewhat more humble than aku/gua).
kitab	1. (lit.) 1) book. 2) holy book. 2. partition in a cow's stomach.
kitabi	possessing the scriptures (of the christians and jews).
kitang	/kitang-kitang/ k.o. small sea ish with venomous dorsal spines.
kitar	memper-kan, meng-kan shove or push s.o. aside.
kitaran	orbit.
kitik	meng-kitik-kitik tickle s.o.
kiting	a bit, a little.
kitiran	1 propeller, windmill.
kiu	billiard cue.
kiuk	dominoes.
kiut	see kicut.
kiwir-kiwir	float in the wind.
kizib	(lit.) lie, falsehood.
kjri	[konsulat jenderal republik indonesia] indonesian consulate general.
kk	[kepala keluarga] head of family, households.
kkn	[kuliahkerja nyata] obligatory (rural) social action internship for advanced university students.
kko	[korp komando ] marine corps.
kl-	see also entries with kl-.
kl.	1. [kelas] class. 2. [kurang lebih] more or less, approximately.
klabet	see kelabat.
klabmalam	nightclub.
klaim	claim.
klak-klak	sound of clicking, clickety-clack (e.g. of shoes).
klakep	see cep 1.
klakson	(auto.) horn.
klan	clan.
klar	see kelar 1.
klaras	(java) dry banana leaf.
klarifikasi	clarification.
klarinet	clarinet.
klas	see kelas 1.
klasemen	classification.
klash	/kles/ military clash.
klasi	see kelasi 1.
klasifikasi	classification.
klasik	/klasika/ classic.
klasikal	classical.
klat	rough draft.
klausa	(ling.) clause.
klausul	/klausula/ (leg.) clause, article (law).
klaver	(crd.) clubs.
klavier,klavir	piano.
klawar	see klaver.
klecam-klecem	(java) smile.
kledi	k.o. mouth organ from kalimantan.
klelep	see kelelap.
klem	1. clamp. klem-besi iron strap. meng-klem 1) clamp together, rivet. 2) stencil s.t. 2. see klaim.
klemak-klemek	slow and sluggish.
klembak	1. k.o. cigarette in which tobacco is mixed with gum benzene incense. 2. see kelembak 1,2.
klen	see klan.
kleneng	k.o. small bell.
klenengan	concert of gamelan music.
klenger	see lengar.
klenik	secret mystical or magical practices of a questionable nature. klenik-klenik-an charlatanism.
klentang	sound of a bell.
klenteng	1 china temple. 2 pagoda.
klep	valve.
klepek	(lit.) student of the stovia.
klepon	k.o. steamed rice cake filled with palm sugar.
kleptomani	kleptomania.
klerek	see kelerak.
kleren-hanger	(coll.) clothes hanger.
klerikal	clerical.
klerk	clerk.
klerus	clergy.
kles	see klash.
klesot	(java) meng-klesot move squatting close to the ground in a submissive attitude.
klesotan	sitting on the floor.
kletek	(java) meng-kletek(i) peel s.t.
klewang	single-edge sabre, sword with broad, curved blade.
kliar-klior	aimless, without direction or goal.
klien	client, customer.
klik	1 click (of camera, etc.). 2. clique.
klimaks	climax.
klimatologi	climatology.
klimis	smooth, shiny, oily (of hair).
klimpungan	be disoriented, confused.
kling	sound of small bells.
klinik	clinic.
kliningan	see keleneng.
klinis	clinical.
klintir	1 clot. 2 small group.
klio	spicy dish of meat stewed with coconut milk.
klip	clip.
kliping	clipping (as from a newspaper).
klips	clips.
klir	be clear, become clear.
klirak-klirik	ogle.
kliring	bank clearance, be cleared.
klise	1 negative of photo. 2 print, picture slide of type shown in movie house. 3 photograpic illustration. 4 cut, engraving. 5 cliche.
klisma	1 catch cold. 2 irritation. klisma-makanan stomach upset caused by food.
kliwer,kliwir	kliwer-kliwer hanger (for clothes). ber-kliwir-an hang loosely.
kliwon	(java) the 5th day of the five-day week.
klm	[kapal layar motor] motorized sailing boat.
klobot	(java) dried corn husk used as cigarette wrapper.
klobotisme	tendency toward extensive verbiage without content.
klojotan	(java) shake, tremble (from injury or illness).
klok	bell-shaped (of skirts).
klolodan	/kloloten/ choke from getting s.t. stuck in throat.
klompen	1. [kelompok pendengar] fans of a certain radio program. 2. (biol.) clone.
klontang-klantung	hang or go about idly or without purpose.
klonyo	see kelonyo.
klop	see kelop.
klorin	chlorine.
klos	see kelos.
kloset	water closet, toilet bowl.
klosot	see klesot.
klotok	small motorized boat ranging in size from a dugout to a small commercial boat.
klub	1 club. 2 clubhouse.
kluing	(java) millipede.
kluntang-kluntung	hang around, roam about aimlessly.
klutuk	see jambu.
kluwek	see keluak.
kluwih	(java) k.o. breadfruit with many seeds.
kluyar-kluyur	hang around, roam about with no purpose.
kluyur	see keluyur.
km	[kapal motor] ms (motorship).
km.	1. [kilometer] kilometer. 2. [kamar] room.
kmb	[konperensi meja bundar] round table conference.
kmd	[koran masuk desa] a gvt. police by which newspapers are given wider distribution in rural areas.
kmd.	[komandan] commandant.
knalpot	(auto.) muffler.
knil	[koninklijk nederlandsch-indisch leger] dutch colonial army and its members.
knip	[komite nasional indonesia pusat] the central indonesian national committee.
knop	see kenop 1.
ko	ko-dan non the o.'s who collaborated (with the dutch) and the o.'s who did not.
koa	(china) k.o. card game.
koaci	see kwaci.
koak	sound of a crow, water buffalo, etc. koak-hitam k.o. bird.
koalisi	coalition.
koar	ber-koar 1 scream, shout, yell. 2 talk big, be arrogant.
kobah	large drum.
kobak	1. a three-cornered tear (in a shirt, etc.). 2. see kubak.
kobakan	1) small hole in the ground into which coins are tossed in game. 2) puddle, wallow.
kobal,kobalt	cobalt.
kobar	flaming, in flames (forest, etc.).
kobaran	the raging.
kober	(java) have the opportunity or chance. / kobe`r / christian graveyard of colonial times.
kobis	see kubis.
kobnsultasi	1 consultation. 2 consult.
koboi	1 cowboy. 2 acting big.
kobok	1. 1) group (of people). 2) (pol.) party. 2. finger bowl.
kocah-kacih	busy doing this and that, niggling, fussing around.
kocai	k.o. leek.
kocak	1. 1) hilarious, amusing. 2) smart, classy, dashing. 3) proud, arrogant. 2. shaking (of a liquid).
kocar-kacir	see kucar-kacir.
koceh	ng-(k)oceh talk nonsense.
kocek	pocket in clothes.
koci	see puru.
kocik	see kocek.
koclok	see kocok.
kocoh	haste. hurriedly, in a hurry.
kocok	meng-(k)ocok 1 shake, mix s.t. 2 mix, stir (egg, dough), shuffle (cards). 3 rub hard. 4 incite s.o. to do s.t.
kocolan	fry of the gabus fish used for bait.
kocong	1 hood (placed over a corpse or s.o. about to be hanget). 2 wrap-around cover with the loose ends bundled up and tied together (e.g. a white cloth wrapped around a corpse in islam rites).
kocor	see kucur 1.
kodaeral	[komando daerah angkatan laut] regional naval command.
kodak	camera. meng-kodak take a picture.
kodam	1. [komando daerah militer] regional military command. 2. [komando daerah angkatan udara] air force regional command.
kodar	see kadar 1.
kodau	[komando daerah udara] regional airforce command.
kode	code. kode-etik code of ethics. kode-pos zip code.
koden	1 in lots of 20. 2 of low quality, of the kind sold in lots of 20. 3 common, ordinary by the score.
koderat	see kodrat.
kodi	a score (the normal quantity of wholesale purchase of clothes or clothing).
kodifikasi	codification.
kodim	[komando distrik militer] district military command.
kodok	frog.
kodrat	1 (islam) god's omnipotence. 2 power (of nature). 3 nature or character.
kodrati	see adi.
kodya	[kota madya] municipality.
koe	see kowe.
koefision	coefficient.
koek	quacking sound.
koeksistensi	coexistence.
kogel-laher	ballbearing.
kognossemen	see konosemen.
koh	see engkoh.
kohabitasi	cohabitation.
kohanudas	[komando pertahanan udara nasional] national air defense command.
koheren	coheren.
koherensi	coherence
kohesi	cohesion.
kohir	tax assessment list.
kohol	k.o. eye salve.
kohong	fetid, stinking (of rotten eggs, etc.).
koin	(coll.) coin.
koinsidensi	coincidence.
koit	(vulg.) die, dead.
koitus	coitus.
koja	1. water jar with a neck. 2. see khoja.
kojoh	flooded (of ricefields).
kojol	ter-kojol-kojol laugh convulsively.
kojor	(vulg.) drop dead.
kok	1. 1) why ?, how come ? 2) a partical at the end of a phrase denying a presumption or statement of the interlocutor. 2. /kok/ shuttlecock.
koka	k.o. monkey.
kokain	cocaine.
kokam	[kontal kambing] k.o. fried cake.
kokang	cock a rifle for firing.
kokas	coke.
kokbrut	1 (sl.) have sexual intercourse. 2 (sl., jakarta) damn you !.
koki	(coll.) cook, chef.
kokila	see kukila.
koko	term of address or reference for o.'s elder brother.
kokoh	see kukuh.
kokok	crowing. kokok-beluk owl.
kokol	1. k.o. fern, bracken. 2. hunched over, doubled up (sitting or lying down). ber-(kokol-kokol) shivering (with fever).
kokon	cocoon.
kokop	see kukup.
kokosan	k.o. very sour lansium fruit.
kokot	1. clamp, bent hook. 2. gnarled (of hands, feet through arthritis, scar tissue, etc.).
kokpit	(av.) cockpit.
koktil	cocktail.
kol	1. cabbage. kol-kembang cauliflower. 2. k.o. minibus, name given to passenger vans in general. 3. colt pistol. 4. 1) calculated, estimated. 2) collated. 5. brush (of a generator). 6 (bri.) call.
kol.	[kolonel] 1 colonel. 2 (navy) captain.
kolaborator	collaborator.
kolaburasi	collaboration, esp. with the enemy.
kolah	see kulah 1.
kolak	1. sweet compote made of starchy fruits (cassava, bananas, etc.) stewed in coconut milk and sugar. 2. see kulak 2.
kolam	1 pond, pool. kolam-air water reservoir. kolam-(be)renang swimming pool. kolam-kaca aquarium. 2 tank.
kolang-kaling	1. the fruit of the sugar palm. 2. to and fro, back and forth, up and down.
kolar	see koral.
kole-kole	(ambon) dug-out canoe.
kolega	colleague.
kolegial	colleaguelike.
kolegialitas	collegiality.
koleh-koleh	1 tapioca starch. 2 k.o. pastry made from wheat dough rolled into balls.
kolek	kolek-kolek small dinghy.
koleksi	1 collection. 2 church collection.
kolekte	church collection.
kolektif	collective.
kolektivisme	collectivism.
kolektor	/kolektur/ collector of the land tax.
kolemben	columbine
koleng	ber-koleng 1 float, bob up and down. 2 go hither.
kolera	cholera.
kolese	1 lecture. 2 college.
kolesom	ginseng.
kolesterol	cholesterol.
koli	piece, bag, bale.
kolibri	humingbird.
kolik	1 bacterial infection. 2 colic.
kolintang	k.o. minahasa musical instrument similar to the marimba.
koloid,koloida	colloid.
kolok	see kuluk.
kolokan	/kolo'an/ mollycoddled, spoiled so that o. easily cries.
kolokasi	collocation.
kolokial	colloquial.
kolokium	colloquium.
kololit	k.o. liquid shoe polish.
kolom	printed column.
kolomnis	columnist.
kolone	(mil.) column.
kolonel	1 colonel. 2 (navy) captain.
kolong	1. 1) space underneath s.t. (a house, table, sky, etc.). 2) pit (as in mine). 2. kolong-kolong, kolong-an rattan ring or bracelet.
koloni	colony.
kolonial	colonial.
kolonis	colonist.
kolonisasi	colonization.
kolonisir	meng-kolonisir colonize.
kolonjono	k.o. tall grass used as fodder.
kolonyet	perfumed tissue.
kolor	1 drawstring. 2 shorts or undershorts. ng-(k)olor bootlick.
kolosal	colossal.
kolot	1 old-fashion, traditional. 2 conservative.
kolporteur	/kolportir/ 1 peddler, hawker. 2 canvasser (of subscriptions).
kolt	see kol 2.
kolumnis	see kolomnis.
kom	(coll.) cereal bowl.
koma	1. coma. 2. comma.
koma-koma	saffron.
komak-kamik	see komat-kamit.
komala	see gemala.
komaliwan	(navy) eating utensils supplied on a boat.
komandan	1 commander. 2 commandant.
komandemen	commandment.
komandite	limited partner (in a business, o. who provides part of the capital without participating in the management).
komanditer	limited partnership.
komando	1 command, area of military jurisdiction. 2 military command (to do s.t.).
komat-kamit	with moving lips but bot speaking aloud (as in offering a silent prayer).
kombali	see kembali.
kombang	see kumbang.
kombek	(coll.) reconciliation of lovers.
kombi	a volkswagen minibus.
kombinasi	combination. kombinasi-fitting combination plug or socket.
kombong	(java) stable, coop. kombong-an feeding trough for horses.
kombor	1. meng-kombor feed a horse. 2. (java, jakarta) too big in size, loose fitting. 3. see es.
komdak	(komando daerah kepolisian] regional police command.
komedi	see komidi.
komendur	1 troop commander. 2 harbormaster. 3 district head.
komeng	dwarfish, stunted in growth, diminutive.
komentar	commentary.
komentator	commentator.
komersial	commercial.
komersialisasi	commercialization.
komersiil,komersil	see komersial.
komes	see kumis 2.
komet	comet.
komfor	see kompor.
komfort	comfort.
komidi	1 comedy. 2 theater. komidi-kuda circus. komidi-putar merry-go-round.
komik	1 clown, humorist, comic. 2 comics.
kominikasi	see komunikasi.
kominike	communique.
kominis	see komunis.
komis	administrative position immediately senior to that of a clerk.
komisariat	1 office of the commissioner. 2 police headquarters.
komisaris	commissioner, superintendent.
komisi	1. 1) commision. 2) commitee (in parliament, etc.). meng-komisi inspect, investigate. 2. 1) commission on a sale. 2) tip, brible.
komisioner	commission agent.
komit	see komet.
komite	committee.
komitmen	commitment.
komkoma	see koma-koma.
komoditi	commodity, raw materials as an item of trade.
komodo	1 an island of the lesser sundas. 2 the komodo dragon found on this island.
komodor	commodore.
kompa	see pompa.
kompak	1 compact, dense. 2 cohesive (of a group). 3 unified.
kompanyi	see kompeni.
kompanyon	associate, colleague (esp. in business).
komparatif	comparative.
kompartimen	two or three departments combined.
kompartimentasi	coordinating of several departments.
kompas	1. compass. 2. blackmail.
kompeni	1 popular term for the dutch e. india company. 2 dutch e. indies soldier or army. 3 dutch rule (during the early colonial period).
kompensasi	compensation.
kompensir	mengk-kompensir compensate.
komperensi	see konferensi.
komperes	see kompres.
kompes	1 give s.o. the 3rd degree. 2 coerce, torture.
kompesan	1 the 3d degree. 2 coercion, torture.
kompeten	competent.
kompetensi	competence.
kompetisi	competition.
kompi	(mil.) company.
kompilasi	compilation.
komplek	/kompleks/ 1 complex. 2 (psychological) complex. 3 site, complex (of buildings).
kompleksitas	complexity.
komplemen	complement, supplement.
komplementaritas	complementarity.
komplementer	complementary.
komplet	complete.
komplikasi	complication.
komplimen	compliment.
komplit	see komplet.
komplong	1. (jakarta) stupid. meng-komplong be agape. 2. komplong-jepang rubber sole of japanese slippers (without the bands).
komplot	1 accomplise, henchman. 2 plot.
komplotan	gang, ring.
kompoi	see konvoi.
kompol	see ompol.
komponen	component.
kompong	1 mutilated, mangled. 2 amputated, only a stump left (of limbs).
komponis	composer.
kompor	hot plate, stove, brazier.
kompos	compost.
komposisi	composition.
komprador	comprador.
komprang	(java) 1 k.o. bell-bottom trousers. 2 loose-fitting (of pants).
komprehensi	comprehension.
komprehensif	comprehensive.
komprei	comfrey.
kompres	compress. s.t. applied as a compress.
kompresan	kompresan
kompresi	compression.
kompresor	compressor.
kompromi	/kompromis/ compromise.
kompromistis	compromising (situation).
komputasi	computation.
komputer	computer.
komputerisasi	computerization.
kompyuter	see komputer.
komres	[komando resort] police district command.
komsat	(kommunikasi lewat satelit] satellite communication.
komsek	[komando sektor] police subdistrict command.
komtabes	[komando kota besar] metropolitan police command.
komunal	communal.
komunalisme	communalism.
komune	commune.
komuni	(rel.) communion.
komunikasi	communication.
komunikatif	communicative.
komunike	communique.
komunis	communist.
komunisme	communism.
komunistofobi	irrational fear of communism.
komutasi	commutation.
komutator	o. who commutes (a juridic sentence).
komwil	[komando wilayah] subregional police command.
konan	meng-konan-i assault, beat up s.o.
konang	meng-konang-i discover, find out about.
konbes	[konperensi besar] major conference.
koncah	wavelet.fluctuate.
konci	1. (coll.) female friend. 2. see kunci 1.
konco	(java) buddy, crony.
kondai	chignon, hair bun.
kondang	1. 1) famous. 2) high official. 2. 1) invitation. 2) be invited, go to an affair. 3. ditch, canal, small river.
kondangan	1 invitation. 2 be invited, go to an affair.
konde	see kondai.
kondektur	conductor on public transportation.
kondensasi	condensation.
kondensator	condenser.
kondisi	condition.
kondite	see konduite.
kondom	condom.
kondomisasi	spreading the use of condoms.
kondor	/kondoran/ inguinal hernia.
konduite	/konduwite/ efficiency report.
kondum	see kondom.
koneksi	connection with s.o. in power.
koneksitas	(leg.) interconnection of jurisdictions.
koneng	see kuning, kunyit.
koneometri	geometry involving problems.
konfederasi	confederation.
konfeksi	ready-made clothes.
konferensi	conference.
konfidensi	confidence.
konfidensial	/konfidensiil/ confidential.
konfigurasi	configuration.
konfirmasi	confirmation.
konfiskasi	confiscation.
konflik	conflict.
konform	be in conformity.
konfrontasi	1 the police of political and armed confrontation with malaysia of the early 1960s. 2 confrontational (attitude, behavior).
konfrontir	mengk-konfrontir confront.
kong,kong-cu	(china) master, teacher, champion.
kongesti	congestion.
konggres	see kongres.
konghucu	confucius.
kongkalikong	intrigue, connivance with s.o. in power to get a favor.
kongkang	see kungkang 2.
kongkau	see kongko.
kongking	(china) k.o. card game.
kongko	(china) talk, chat.
kongkoan	1 a chat. 2 council of china officers (colonial period).
kongkol	talking over s.t.
kongkong	1. loud bark of a dog. 2. see kungkung.
kongkow	see kongko.
kongkret	/kongkrit/ see konkret.
kongkretisasi	concretization.
kongkretisir	mengk-kongkretisir concretize.
kongkur	see konkurs.
kongkuren	/kongkurensi/ see konkurensi.
kongkurs	see konkurs.
konglomerat	/kon-glomerat/ conglomerate.
kongregasi	congregation.
kongres	congress, convention.
kongruen	congruent.
kongsep	see konsep 1,2.
kongsi	(china) 1 commmercial association, partnership. 2 group, association.
kongsol	see konsul 1.
koni	[komite nasional olah raga indonesia] the indonesian national sports commitee.
konifer	conifer.
konjen	[konsulat jenderal] consulate general.
konjungsi	conjunction.
konjungtur	1 business outlook. 2 business cycle. 3 upswing, favorable market.
konklusi	conclusion.
konkordansi	1 (rel.) concordance. 2 agreement.
konkret	concrete, tangible, solid.
konkuren	1 rivalry. 2 compete.
konkurensi	competition., rivalry.
konkurs	match, contest.
konon	1 they say, purportedly. 2 i wonder. 3 perhaps, it seems.
konosemen	bill of lading.
konotasi	connotation.
konpeksi	see konfeksi.
konpensi	see konvensi.
konperensi	see konferensi.
konpergensi	see konvergensi.
konpoi	see konvoi.
konsekrasi	consecration.
konsekrir	mengk-konsekrir consecrate.
konsekuen	consistent.
konsekuensi	1 consistency. 2 consequences.
konsekwen	see konsekuen.
konsekwensi	see konsekuensi.
konselet	see korstsleting.
konseling	counseling.
konselor	counselor.
konsensus	consensus.
konsentrasi	concentration.
konsentrat	concentrate.
konsentrik	concentric.
konsentrir	mengk-konsentrir concentrate.
konsep	1. draft, rough copy. 2. konsepsi concept, notion, idea.
konsepsional	/konsepsionil/ conceptual.
konseptor	1 conceiver. 2 drafter (of a plan).
konseptual	conceptual.
konseptualisasi	conceptualization.
konser	/konsert/ concert, concerto.
konservasi	conservation.
konservatif	conservative.
konservatisme	conservatism.
konservator	curator (of a museum).
konservatori	conservatory (of music).
konserven	preserves.
konsesi	1 concession, special privilege. 2 concessions, partial surrender of o.,s own interest.
konsideran	/konsiderans/ preamble.
konsignasi	see konsinyasi 2.
konsili	(rel.) church council.
konsinyasi	1. confinement to military base. 2. consignment.
konsinyator	consignor.
konsinyering	confinement to base.
konsinyi	1. consignee. 2. see konsinyir 1.
konsinyir	1. (mil.) on alert. 2. consign.
konsisten	consistent.
konsistensi	consistency.
konsol	see konsul 1,2.
konsolidasi	consolidation.
konsolidir	consolidate s.t.
konsonan	consonant.
konsorsium	consortium.
konspirasi	conspiracy.
konspiratif	conspiratial.
konstan	1 a constant. 2 constant, fixed.
konstatasi	draw a conclusion, establish a fact.
konstatering	ascertaining, establishing.
konstatir	mengk-konstatir 1 mention, state. 2 establish a fact, ascertain.
konstelasi	constellation.
konstipasi	constipation.
konstituante	constituent assembly.
konstitusi	constituation.
konstitusional	/konstitusionil/ constitutional.
konstruir	mengk-konstruir construct.
konstruksi	construction.
konstruktif	constructive.
konsul	1. consul. 2. consultation.
konsulat	consulate.
konsulen	consultant.
konsuler	consular (affairs).
konsult	see konsul2.
konsultan	consultant.
konsultatif	consultative.
konsumen	consumer.
konsumerisme	consumerism.
konsumir	mengk-konsumir consume.
konsumsi	1 consumption. 2 refresments.
konsumtif	consumptive.
kontak	1. contact. 2. 1) light switch, ignition. 2) short circuit. 3 electric shock.
kontal-kantil	1 dangle, swing to and fro. 2 flap.
kontaminasi	contamination.
kontan	1 cash. 2 at that very moment. 3 flatly denying s.t.
kontang-kanting	dangle.
konteks	context.
konteler	/kontelir/ district officer of the colonial era (controller).
kontemplasi	contemplation.
kontemplatif	contemplative.
kontemporer	contemporary.
kontensius	contentious.
kontes	contest.
kontestan	1 contestant. 2 candidate (in election).
kontestasi	dispute, conflict.
kontet	stunted in growth.
kontinen	cintinent.
kontinental	continental.
kontingen	contingent, part.
kontinu	/kontinue/ continuous.
kontinuitas	continuity.
kontinyue	see kontinu.
kontol	(vulg.) penis.
kontra	contra.
kontradiksi	contradiction.
kontradiktif	contradictory.
kontradiktoris	contradictory.
kontradisi	see kontradiksi.
kontraksi	(fin.) contraction (of money supply).
kontraktan	contracting party.
kontraktor	contractor.
kontraktual	/kontraktuil/ contractual.
kontras	contrast.
kontrasepsi	contraception.
kontraseptif	contraseptive.
kontrelir	see konteler.
kontribusi	contribution, donation.
kontrol	/kontrole/ 1 control, supervision. 2 trip supervisor. 3 control.
kontrolir	1. controller, ticket taker. 2. see konteler.
kontroversi	controversy.
kontroversial	/kontroversiil/ controversial.
kontrrak	contract. kontrak-an s.t. leased (out).
kontur	contour.
konveks	convex.
konveksi	convection.
konvensi	1 convention, congress. 2 agreement. 3 convention, custom.
konvensional	/konvensionil/ conventional.
konvergen	convergent.
konvergensi	convergence.
konversasi	conversation.
konversi	conversion.
konvertibel	convertible (car).
konvoi	convoy.
konvulsi	convulsions.
konyak	cognac.
konyan	(china) new year's celebration.
konyol	1 foolish, inviting, problem onto o.s. 2 constant bad luck. 3 incompetent, not up to snuff.
konyong	sudden, suddenly.
konyungsi	see konjungsi.
konyungtur	see konjungtur.
kooperasi	see koperasi.
kooperatif	see koperatif.
koops	[komando operasional] operational command.
koordinasi	/ko'ordinasi/ coordination.
koordinat	/ko'ordinat/ coordinate.
koordinator	/ko'ordinator/ coordinator.
koordinatorat	office of coordinating staff.
koordinir	/ko'ordinir/ coordinate.
kop	1. 1) head. 2) letterhead. 3 head of a recorder. 2. nge-kop give cupping suction treatment by applying a heated glass to the skin.
kopah	quantity of blood.
kopak	1. peel (potatoes, etc.). 2. see kupak.
kopasgat	[komando pasukan gerak cepat] rapid action force command.
kopek	1. 1) flaccid (of breasts). 2 (in some regions only) teat. 2. meng-kopek peel with the nails.
kopel	1. (auto.) universal joint. 2. see rumah.
kopeleng	/kopeling/ 1 clutch. 2 connection.
kopelrim	a broad army belt (for carrying grenades, etc.).
koper	see kopor.
koperak	see koprak.
koperal	see kopral.
koperasi	1 a cooperative (economic enterprise). 2 cooperation.
koperatif	cooperative.
koperator	cooperator.
kopet	narrow (of opening, street, passage).
kopi	1. coffee. 2. copy, draft.
kopiah	k.o. rimless cap, headdress worn by muslim men and also by indonesian men in general as a symbol of national identity.
kopkamtib	[komando pemulihan keamanan dan ketertiban] command for the restoration of security and public order.
koplak	/koplakan, kopla'an/ place where carts minibuses, and other vehicles gather to await paddengers.
koplam	/koplamp/ headlight.
koplet	see kuplet.
kopling	see kopeleng.
kopok	/kopokan/ have a runny ear.
kopong	(java,jakarta) empty, hollow.
kopor	1 trunk, footlocker. 2 suitcase.
kopra	copra.
koprak	bamboo clapper to frighten birds.
kopral	1 (mil.) corporal. 2 (navy) petty officer 3d class.
koprol	somesault, tumble.
kopula	(ling.) copula.
kopur	(fin.) denomination.
kopure	denomination, note of money.
kopyok	1 shake s.t., esp. to blend or mix it up. 2 shake up pieces of paper for lottery. 3 (coll.) dancing.
kopyor	a coconut that has developed differently from the others in the bunch and has soft flesh blended with the juice and is esp. tasty and highly prized for snacks.
kor	choir.
korah	1 sphere. 2 spherical.
korak	[kommando perak] 1 name of a crime organization that specializes in pilfering from delivery trucks. 2 petty extortionist.
koral	coral.
koramil	[komando rayon militer] military headquarters at the ward [kecamatan] level.
koran	(islam) the qur'an.
korat-karit	dislocated, scattered, in disorder.
korban	1 sacrifice. 2 (islam) religious offering, the offering made at rites celebrating idul adha. 3 victims.
korden	see gorden.
kordinasi	see koordinasi.
kordinat	see koordinat.
kordinir	see koordinir.
kordon	cordon worn with an academic gown.
kored	k.o. small hoe with short handle.
korek	matches, cigarette lighter. korek-kuping earpick.
koreksi	correction.
koreksian	1 corrected material. 2 papers to be corrected.
korektif	corrective.
korektor	1 proofreader. 2 corection fluid (for stencils).
korelasi	correlation.
korem	[komando resort militer] military command (at a level below the residency).
koreng	1 sore, ulceration. 2 scab (over a sore).
korengan	suffer from skin infections.
koreografer	choreographer.
koreografi	choreography.
kores	[komando resort] district police command.
koresponden	(newspaper) correspondent.
korespondensi	correspondence.
koresta	[komando resort kota] metropolitan police command.
koret	1. leftovers. 2. see korek 1. 3. see kuret.
kori	1. (java) door. 2. see qari.
koriah	see qariah.
koridor	corridor.
korma	see kurma.
korned	see kornet 2.
kornel	1. (sport) corner kick. 2. see kolonel.
kornet	1. canned corned beef. 2. see kenek.
korok	1. excavation, excavated tunnel. snore.
koroner	a coronary (attack).
korong	surroundings.
korosi	corrosion.
korosif	corrosive.
korporasi	corporation.
korpri	[korp pegawai republik indonesia] the indonesian civil service corps.
korps	/korep, koreps/ corps.
korsase	corsage.
korsel	merry-go-round, carousel.
korset	corset.
korsi	see kursi 1.
korsleting	see kortsleting.
korting	discount.
kortison	cortisone.
kortsleting	1 short circuit. 2 (coll.) misunderstand e.o.
korum	see kuorum.
korup	corrupt.
korupsi	corruption, graft.
koruptor	o. who is corrupt.
korut	[korea utara] north korea.
korve	corvee.
korvet	k.o. warship, a corvette.
kos	1 room and board or just board. 2 board with s.o.
kosak-kasik	1 rustling. 2 fidgeting, restless.
kosakata	vocabulary, glossary.
kosambi	see kesambi.
kosar	k.o. autocarpus tree yielding edible fruits and timber.
kosbas	landlord, landlady.
kosek	door mat.
kosel	1 hem and haw. 2 work in fits and starts. 3 have difficulty with tough meat.
kosen	1. window or door frame. 2 brave, courageous, daring.
koset	see keset 2.
kosinus	(math.) cosine.
kosmetik	/kosmetika/ cosmetics.
kosmografi	cosmography.
kosmologi	cosmology.
kosmonaut	/kosmonot/ cosmonaut.
kosmopolit	/kosmopolitan/ cosmopolite, a sophisticate.
kosmos	cosmos.
kosok	kosok-balik antonym, opposite, reverse.
kosong	1 empty, blank, zero. 2 (crd) void suit. 3 unoccupied. 4 hole, empty space.
kosponser	cosponsor.
kost	see kos.
koster	manager of a rectory.
kosthuis	/koshoys/ boarding house.
kostik	caustic (soda).
kostim	/kostum/ 1 costum. 2 woman's westernstyle clothing. 3 dress uniform, formal dress.
kostranas	[komando strategi nasional] national strategic command.
kota	1 city, town. 2 fort. kota-an urbane, from the city.
kotah	total.
kotai	1 hang down (as of old fruit). 2 left to dry up, desicated.
kotak	1 box. 2 compartment, cubicle. 3 drawer. 4 boxshaped section of a garden divided into beds, of paddy fields, etc.
kotak-katik	motion by which s.o. indicates his presence.
kotamara	parapet.
kotangen	/kotangens/ (math.) cotangent.
kotbah	see khotbah.
kotek	1. 1) tail feather. 2) tail plumed with a tuftlike end (e.g. of a comet). 2. a cackle (of a hen).
koteka	penis sheath of irian.
koteng	ter-koteng-koteng alone, friendless.
koterek	see kotrek.
kotes	bits of thread or lint.
kotipa	[kolera, tipes, paratipes] immunization against cholera, typhoid, and paratyphoid.
kotok	1. kotok-ayam having defective vision, i.e. nearsighted or suffering from night blindness. 2. short (of pants legs).
kotong	cut off, amputated.
kotor	1 dirty, soiled, filthy. 2 dirty, vile, filthy (words, etc.). 3 gross (of income, profits).
kotoran	1 feces, dung, manure. 2 muck, waste. 3 impurity.
kotrek	corkscrew.
kotum	quota.
kover	/kafer, kofer/ .
kowad	[korps wanita angkatan darat] army women's corps.
kowak	ber-kowak-kowak 1 jabber, chatter. 2 shout (of drunkards, people wild with joy or excitement).
kowal	[korps wanita angkatan laut] navy women's corps.
kowe	(coll., derog., java, jakarta) you.
kowek	see kuwek.
kower	see koar.
kowil	[komando wilayah) police subregion command.
kowilhan	[komando wilayah pertahanan] defence territorial command.
kowiltabes	[komando wilayah kota besar] metropolitan police command.
koyak	1 torn, ripped. 2 lacerated (of the hand, etc.). koyak-koyak in rags or tatters. koyak-an tear, rip, rent.
koyakan	tear, rip, rent.
koyan	measurement of weight or capacity (27-40 piculs).
koye	see kohir.
koyer	(sport) pitcher in games where a ball is thrown to be batted back.
koyo	/koyok/ 1. nonsense. 2. (china salve put in a medical plaster. 3 stray dog.
kozyn	see kosen 1.
kpd.	[kepada] to.
kpm	[koninkliske paketvaart maatschappij] the royal mail packet lines (of the colonial era).
kr-	see also entries with ker-.
krah	see kerah 2.
kram	see keram 1.
krama	see kromo.
kraman	rebellion.
kramat	see keramat.
kran	see keran 1.
kranggang	k.o. red ant.
krans	funerary wreathe.
krasan	(coll.) feel at home, like a place o. is new at.
krat	crate, case of 24 bottles.
kraton	see keraton.
kre	see kerai.
kreasi	creation.
kreatif	creative.
kreativitas	creativity.
kreator	creator.
krecek	buffalo skin processed for eating.
