pundit	kb. orang yang amat terpelajar.
pungency	kb. 1 kepedasan (of food). 2 ketajaman (of a remark).
pungent	ks. tajam, pedas (of odor, remarks).
punish	kkt. 1 menghukum (s.o.). 2 menyiksa. he was severaly punished ia mendapat siksaan yang berat. punishing game permainan keras/berkeras-kerasan.
punishable	ks. dapat dihukum. kidnaping is p. by death penculikan anak dihukum mati.
punishment	kb. 1 law : hukuman. 2 siksaan. to take o's p. like a man menerima penyiksaannya itu sebagai seorang jantan. 3 perlakuan yang amat kasar.
punitive	ks. menghukum. to take p. action against mengambil tindakan menghukum terhadap.
punk	kb. 1 sumbu. 2 sl.: seorang (muda) yang tak berpengalaman/berarti. -ks. sl.: tidak enak badan. ifeel p. aku merasa tidak enak badan.
punster	kb. orang yang memainkan kata-kata (sehingga kedengaran lucu).
punt	kb. 1 perahu yang lebar dan papar. 2 sport : sepakan bola. -kkt. 1 sport : menyepak bola. 2 menggalahi (a boat).
puny	ks. 1 lemah. he looks p. ia nampak begitu lemah. 2 kecil (of arms, apples). 3 remeh (of effort).
pup	kb. 1 anak anjing. 2 pemuda yang sok aksi. p. tent kemah kecil.
pupil	kb. 1 murid. 2 anat.: biji/manik mata.
puppet	kb. 1 golek, wayang. p. show pertunjukan golek/wayang. 2 boneka. p. government pemerintahan boneka.
puppeteer	kb. dalang.
puppetry	kb. pedalangan, kewayangan.
puppy	kb. (j. -pies) anak anjing. p. love cinta remaja.
purchase	kb. 1 pembelian, belanjaan (of s.t.). 2 belian. -kkt. 1 membeli. 2 memperoleh. -purchasing kb. pembelian. p. power daya beli.
purchaser	kb. pembeli.
pure	ks. 1 bersih (of water, air). 2 murni (of gold). 3 yang bersifat teori (of science). pure-blooded ks. asli, sejati. -purely kk. semata-mata, belaka.
purebred	ks. berdarah asli/murni, berketurunan asli, biang. p. chicken biang ayam.
puree	kb. sup yang kental.
purgative	kb. pencahar, obat cuci perut.
purgatory	kb. (j. -ries) tempat/api penyucian (dosa).
purge	kb. 1 pembersihan (in government). 2 obat pencahar. -kkt. 1 membersihkan. to p. o.s. of sin membersihkan diri dari dosa. 2 mengusir, menyingkirkan (undesirables).
purification	kb. 1 pembersihan, penyaringan (of water). 2 pemurnian (of a language).
purifier	kb. 1 alat pembersih. 2 bahan pembersihan.
purifies	lih purify.
purify	kkt. (purified) 1 membersihkan (water). 2 memurnikan (a language). 3 menyucikan, membersihkan (o's heart, soul).
purist	kb. orang yang mempertahankan kemurnian bahasa.
puritan	kb. orang yang amat teguh berpegang pada peraturan-peraturan terhadap tata-susila.
puritanical	ks. berpegang teguh pada norma-norma moral serta agama.
purity	kb. 1 kemurnian (of water, gold). 2 kesician (of heart).
purl	kki. 1 merajut dengan kaitan-kaitan yang terbalik. 2 memberi pinggiran pada kain berupa lengkungan-lengkungan kecil.
purloin	kkt. mencuri, mencolong.
purple	kb. warna ungu, warna merah lembayung/bungur. the baby was born to the p. bayi itu keturunan raja-raja/bangsawan. -ks. ungu, merah lembayung/bungur.
purplish	ks. keungu-unguan.
purport	kb. pokok, isi, arti. -kkt. 1 mengakui. 2 mempunyai pokok isi.
purpose	kb. 1 maksud. what's the p. of this letter? apakah maksud surat ini ? 2 tujuan. what's his p. in life ? apakah cita-cita hidupnya. 3 kegunaan. for all practical purpose untuk segala macam kegunaan.
purposeful	ks. dengan maksud tertentu.
purposely	kk. dengan sengaja.
purr	kb. 1 dengung (of a matter). 2 dengkur (of a kitten). -kki. 1 mendengung (of a motor). 2 mendengkur (of a kitten).
purse	kb. 1 dompet. 2 sokongan, dana, derma. -kkt. mengerutkan (the lips).
purser	kb. kepala keuangan (di kapal).
pursuance	kb. hal melakukan menurut. in p. of the law menurut undang-undang. in p. of menurut.
pursuant	ks. menurut. p. to your order mengikuti perintahmu.
pursue	kkt. 1 mengejar (s.o., a profession). to p. pleasure/happiness mengejar kesenangan/kebahagian. 2 mengikuti (o's studies, an idea). 3 meneruskan perjalanan.
pursuer	kb. 1 pengejar, pemburu. 2 pengikut.
pursuit	kb. 1 pengejaran (of a bandit). 2 pencarian, pengejaran (of knowledge).
purvey	kkt. memperlengkapi, menyediakan.
purveyor	kb. penyetor, leveransir.
purview	kb. lapangan, bidang. the matter lies outside my p. hal itu diluar lapangan saya.
pus	kb. nanah.
push	kb. 1 dorongan. he needs a p. ia membutuhkan dorongan. 2 desakan. 3 serangan (from the enemy). 4 senggolan. -kkt. 1 mendorong. 2 menekan (a button). 3 mendesak. -pushing ks. giat, suka mendesak.
pushcart	kb. kereta dorong/sorong.
pusher	kb. 1 orang yang ambisius, orang yang bergiat untuk maju. 2 inf.: narc.: penjual obat bius.
pushup	kb. tolak-angkat.
pushy	ks. ambisius, berangan-angan maju, lancang.
pusillanimous	ks. cabar/kecut hati.
puss	kb. 1 kucing. 2 sl.: mulut.
pussy	kb. (j. -sies) kucing, pus.
pussyfoot	kki. malu-malu. stop pussy-footing and get down to business janganlah malu-malu dan katakanlah apa perlunya.
put	kkt. (put) 1 menaruh. 2 menanamkan (o's money into s.t.). 3 mengajukan (questions). 4 menempatkan. 5 menyerahkan. 6 melempar(kan). 7 mengatakan, menguraikan. 8 menaksir. 9 membubuhkan, menaruh.
put-put	kb. deru (of an outboard motor).
putative	ks. disangka, diduga.
putrefaction	kb. perbusukan, keadaan kebusukan.
putrefies	lih putrefy.
putrefy	kki. (putrefied) menjadi busuk.
putrid	ks. busuk, tengik.
putrified	lih putrepy.
putt	kb. golf : pat, pukulan yang lunak. -kkt. mengpat/memukul bola golf dengan lunak. his putting is good patnya baik.
putter	kb. 1 pater. 2 golf : gatokan pat. -kki. meromet (at odd jobs).
putty	kb. (j. -ties) 1 dempul, gala-gala (for glass). p. knife pisau dempul, kape. 2 gala-gala pakal (for ships). -kkt. 1 mendempul. 2 memakal.
puzzle	kb. teka-teki. to do/work puzzles memecahkan teka-teki. -kkt. membingungkan bagi. -puzzling ks. menimbulkan teka-teki.
pvt.	[private] 1 tamtama, prajurit biasa. 2 pribadi. 3 swasta.
pw,p.w.	[prisoner of war] tawanan perang.
pwd,p.w.d.	[public works department] jawatan umum (d.p.u.).
pwt.	[pennyweight] kira-kira satu gram.
px	[post exchange] kb. kantin ab/tentara, toko tentara.
pygmy	kb. (j. -mies) orang kerdil.
pyjamas	= pajamas.
pylon	kb. tiang (yang tinggi), tonggak menara.
pylorus	kb. lubang antara perut dan usus.
pyorrhea	kb. penyakit pada gusi.
pyramid	kb. limas, piramide. -kki. menjadi banyak, berhimpun-himpun (of costs, expenses).
pyramidal	ks. yang berbentuk piramide.
pyre	kb. tumpukan bahan bakar, onggokan kayu bakar.
pyrometer	kb. alat pengukur suhu yang tinggi.
pyrotechnics	kb. 1 pembuatan petasan. 2 tontonan petasan/mercun.
pyrrhic	ks. p. victory kemenangan yang terlalu banyak makan korban.
python	kb. ular sawa (yang besar). ular sanca.
q	huruf ke-17 dari abjad inggris.
q.and a.	[question and answer] soal jawab.
q.m.	[quartermaster] 1 intendan (ad). 2 jurumudi (al).
q.m.c.	[quartermaster corps] korp intendan.
q.m.g.	[quartermaster general] jenderal intendan.
q.t.	[quart] 0.9463 liter.
qto	[quarto] kwarto.
qtrs.	[quarters] 1 markas. 2 tempat tinggal, barak.
qts.	[quarts] j. dari quart.
quack	kb. 1 dukun, tukang obat, penjual koyok. q. remedy obat dari tukang obat. 2 bunyi itik. -kki. berbunyi kwek-kwek.
quackery	kb. (j. -ries) perdukunan.
quad	[quadrangle] kb. inf.: alun-alun segiempat.
quad.	1[quadrangle] segiempat. 2 [quadrant] seperempat lingkaran.
quadrangle	kb. 1 segiempat. 2 alun-alun segiempat.
quadrangular	ks. bersegiempat.
quadrant	kb. kwadran, seperempat dari lingkaran, busur 90.
quadratic	ks. kwadrat. q. equation persamaan kwadrat.
quadrennial	ks. yang terjadi tiap empat tahun.
quadrilateral	ks. berisi empat.
quadruped	kb. binatang berkaki empat.
quadruple	kb. lipat empat. q. amount jumlah empat. -kkt., kki. berlipat empat.
quadruplet	kb. kembar empat.
quadruplicate	kb. rangkap empat. in q. rangkap empat.
quaff	kkt. minum (minuman keras) banyak sekali.
quagmire	kb. paya, rawa.
quail	kb. burung puyuh. -kki. gemetar, cabar hati.
quaint	ks. 1 pelik, aneh. q. style gaya yang aneh. 2 tua tetapi menarik.
quaintness	kb. kelucuan, keanehan.
quake	kb. gempa (bumi). -kki. 1 berguncang (of the earth). 2 gemetar (of a person). to q. in o's shoes gemetar (di kakinya). -quaking ks. gemetar. in a q. voice dengan suara yang gemetar.
quaker	kb. quaker (anggota suatu perkumpulan kristen yang anti-perang dan anti-sumpah).
qualification	kb. 1 kwalifikasi, kecakapan. 2 batas, pembatasan.
qualified	lih qualify.
qualifier	kb. pemberi sifat.
qualifies	lih qualify.
qualify	kkt. 1 memenuhi syarat. 2 merubah (a statement). 3 memberi sifat. kki. memenuhi syarat. -qualified ks. berijazah. -qualifying ks. yang memenuhi syarat.
quality	kb. (j. -ties) 1 mutu, kwalitas. the q. of the work mutu pekerjaan. 2 sifat. her personal qualities sifat-sifat pribadinya.
qualm	kb. 1 rasa cemas. i had qualms as to whether.... aku merasa cemas mengenai.... 2 rasa sesal. to murder without any qualms membunuh tanpa sesal.
quandary	kb. (j. -ries) kebingungan, kesulitan. to be a q. kebingungan.
quantification	kb. hitungan.
quantified	lih quantify.
quantifies	lih quantify.
quantify	kkt. (quantified) mengukur.
quantitative	ks. kwantitatip. q. analisysis analisa kwantitatip. -quantitatively kk. menurut banyaknya, banyak.
quantity	kb. (j. -ties) kwantitas, benyaknya. in great q. dalam jumlah banyak. small q. of potatoes kentang dalam jumlah kecil.
quar.	1[quarter] perempat. 2 [quarterly] majalah tigabulanan.
quarantine	kb. karantina. -kkt. 1 membarak, menempatkan dalam barak. 2 med.: meng(k)arantinakan.
quarrel	kb. perselisihan, pertengkaran, percekcokan. i have no q. with him aku tak ada perselisihan dengannya. -kki. bertengkar, berselisih, bercekcok. -quarreling kb. bertengkar.
quarrelsome	ks. suka bertengkar/bercekcok.
quarries	lih quarry.
quarry	(j. -ries) 1 min.: tambang, penggalian. 2 buruan. to pursue o's q. mengejar buruannya. -kkt. (quarried) menggali.
quart	kb. ukuran sebanyak 0.9463 liter.
quart.	1 [quarter] perempat. 2 [quarterly] (majalah) tigabulanan.
quarter	kb. 1 (money) setalen. 2 tiga bulan. 3 perempat. 4 bagian (of a city, of a game). 5 ampun, maaf. -quarters j. tempat tinggal. -ks. perempat. -kkt. 1 memotong, jadi empat (a sheep, an apple). 2 memberi tempat tinggal (in dalam).
quarterback	kb. sport : gelandang.
quarterdeck	kb. 1 geladak belakang (on merchant ships). 2 nav : geladak bagi nakhoda saja.
quarterfinal	kb. kwarter final.
quarterly	kb. (j. -lies) (majalah) triwulan. ks. triwulan, kwartal(an). q. statement rekwening kwartalan. kk. tiap kwartal.
quartermaster	1 jurumudi (al). 2 intendan (ad). q. corps korp intendan. quartermaster-general jenderal intendan.
quartet(te)	kb. kwartet.
quarto	kb. kwarto.
quartz	kb. kwarsa.
quash	kkt. membatalkan. to q. an indictment membatalkan tuntutan.
quasi	ks. pura-pura, tak benar/sok. a q. attempt at the rescue of s.o. suatu percobaan pura-pura untuk menyelamatkan seseorang. quasi-judicial ks. pura-pura/sok menurut hukum.
quatrain	kb. syair empat baris.
quaver	kb. 1 getaran, gemetar (in o's voice). 2 mus.: suara geletar/gemetar. -kki. gemetar.
quay	kb. dermaga. alongside the q. sepanjang dermaga.
que.	[quebec] kota di kanada.
queasy	ks. mual, muak, mau muntah, loya.
queen	kb. 1 ratu. q. bee ratu lebah. apple q. ratu dari perayaan buah apel. 2 bridge : kartu ratu. q. consort permaisuri raja yang sedang memerintah. queen's english bahasa inggris halus.
queenly	ks. seperti ratu.
queer	kb. homo, homoseks. -ks. aneh, ganjil. a q. person seorang yang aneh. -kkt. merusakkan, menghilangkan.
quell	kkt. memadamkan, mengakhiri, mengatasi, menumpas (a riot, uprising).
quench	kkt. 1 memuaskan (a thirst). 2 memadamkan (a fire).
queried	lih query.
queries	lih query.
querulous	ks. (suka) bersungut-sungut.
query	kb. (j. -ries) pertanyaan. -kkt. (queried) meragukan, menyangsikan (the accuracy of a statement).
ques.	[question] pertanyaan, soal.
quest	kb. 1 penyelidikan. 2 pencarian. the q. for knowledge mencari ilmu pengetahuan. to go in q. of s.o. pergi mencari seseorang.
question	kb. 1 pertanyaan. 2 soal. 3 keraguan, kesangsian. 4 usul. -kkt. 1 menanya(i). (s.o.). 2 meragukan, menyangsikan (s.o's honesty). -questioning kb. soal-jawab. ks.yang berisi/mengandung pertanyaan.
questionable	ks. diragukan. it is q. whether... adalah diragukan... to engage in q. practices melakukan perbuatan yang diragukan kejujurannya.
questioner	kb. penanya.
questionnair	kb. daftar pertanyaan.
queue	kb. 1 antri, antre. 2 ekor babi. -kki. to q. up (ber)antri.
quibble	kki. berdalih, cekcok (over the price).
quick	kb. daging dibawah kuku. -ks. 1 cepat. 2 lekas. -kk. lekas, cepat. to quick-freeze kkt. membekukan cepat-cepat. quick-tempered ks. lekas marah. quick-witted cepat dipikirkan. -quickly kk. dengan cepat.
quicken	kkt. mempercepat (o's pace). -kki. menjadi lebih cepat (of o's pulse).
quickie	kb. sl.: hasil kilat. -ks. kilat. q. course kursus kilat.
quickness	kb. kecepatan, ketangkasan, kekencangan, kecekatan.
quicksand	kb. pasir hanyut/apung.
quicksilver	kb. air raksa.
quid	kb. sugi (of tobacco).
quiescent	ks. tanpa gerak, tidak bergerak, diam.
quiet	kb. ketenangan. -ks. 1 sepi. 2 diam. 3 aman. 4 tenang. 5 tidak ramai. -kkt. meredakan, menenangkan (a child). -quietly kk. dengan diam-diam. -quieting (down) peredaan.
quill	kb. 1 bulu ayam. 2 (pen) pena.
quilt	kb. selimut kapas. -kkt. melapisi (selimut) dengan kapas. -kki. menyambung-nyambung potongan kain.
quince	kb. semacam buah.
quinguennial	ks. sekali lima tahun.
quinine	kb. kina. q. water air kina.
quint	kb. inf.: kembar lima.
quintessence	kb. 1 saripati, inti. 2 contoh murni.
quintet	kb. kwintet.
quintuple	kkt. berlipat lima.
quintuplet	kb. kembar lima.
quintuplicate	ks. rangkap lima.
quip	kb. kata yang tepat, ejekan, sindiran. -kki. (quipped) bersendagurau, mengejek, menyindir.
quire	kb. dua lusin (kertas).
quirk	kb. kebiasaan khusus dalam tingkah laku seseorang.
quit	ks. to be q. of terlepas dari. -kkt. (quit) 1 berhenti. q. it ! berhenti ! 2 meninggalkan (o's room). quitting time waktu untuk berhenti kerja.
quite	kk. sungguh. q. ill sungguh sakit. q. hot sangat panas. he's right ia sungguh benar.
quits	ks. seri. to call it q. menghentikan usaha.
quitter	kb. inf.: orang yang berhenti berusaha.
quiver	kb. 1 sport : tempat anak panah. 2 getaran (in voice or on foce). -kki. gemetar, menggigil.
quixotic	ks. melamun. q. behavior kelakuan yang melamun.
quiz	kb. ulangan. -kkt. (quizzed) 1 menguji (students). 2 memeriksa (by police). q. show/program pertunjukan cerdas-tangkas.
quizzical	ks. aneh, lucu (of a look). -quizzically kk. dengan pandangan aneh.
quorum	kb. k(w)orum. to have a q. mencapai kworum.
quot.	[quotatium] kutipan.
quota	kb. 1 jatah, kwotum. the q. system for immigration sistim/cara kwotum untuk imigrasi. 2 bagian. to contribute o's q. menyumbangkan bagiannya.
quotable	ks. boleh disebut, dipetik. q. comment uraian yang boleh disebut.
quotation	kb. 1 kutipan, tukilan, nukilan (from a book). q. mark tanda kutip/petik. 2 penentuan, penetapan. stock market q. penentuan harga bursa.
quote	kb. 1 kutipan. 2 tanda kutip. in quotes dalam tanda kutip. -kkt. 1 mengutip, memetik (from a book). 2 memberikan. 3 mengulangi. 4 mengutip.
quotient	kb. hasil bagi.
r	kb. huruf kedelapan belas dari abjad inggris. the three r's pelajaran-pelajaran membaca, menulis dan berhitung.
r.	1 [right] kanan. 2 [river] sungai.
r.a.	[rear admiral] laksamana muda.
r.c., rc	1 [roman catholic] rum katolik, katolik roma. 2 [red cross] palang merah.
r.d.	[rural delivery] pos pedesaan/dusun.
r.f.d.	kb. [rural free delivery] antaran pos cuma-cuma luar kota.
r.i.	[rhode island] negara bagian di a.s.
r.n.	[registered nurse] jururawat berijazah.
r.p.m.	[revolution per minute] putaran dalam semenit.
r.r.	[railroad] perusahaan kereta api.
r.s.v.p.	[repondez s'il vous plait] fr.: harap dijawab.
rabbi	kb. pendeta yahudi.
rabbit	kb. kelinci. r. food selada, sayur- sayuran mentah. rabbit's foot kaki kelinci (jimat).
rabble	kb. rakyat jelata, orang-orang jembel. rabble-raouser kb. pengacau, perusuh, peribut.
rabid	ks. 1 fanatik. r. integrationist pejuang pemersatu yang fanatik. 2 gila (of a dog). he was r. with anger ia betul-betul marah.
rabies	kb. penyakit anjing gila, gila anjing.
raccoon	kb. binatang serupa kucing.
race	kb. 1 ras, bangsa. 2 perlombaan. 3 (horse) pacuan (kuda). 4 arena, pertarungan, perlombaan (politik). -kkt. 1 menjalankan cepat-cepat (engine). 2 berlomba dengan, membalap, mengebut. 3 memperlombakan (a horse). -racing kb. balapan.
racer	kb. pembalap, pengebut (oto, sepeda, kuda).
racial	ks. rasial. r. discrimination diskriminasi rasial. r. minoritas suku-suku bangsa golongan kecil.
racialism	kb. rasialisme.
racism	kb. rasisme.
racist	kb. orang yang membenci suku bangsa lain.
rack	kb. rak, para-para. luggage r. rak tempat barang. -kkt. menyiksa, menyakiti. she was racked with pain ia tersiksa oleh rasa sakit.
racket	kb. 1 tenn.: raket. 2 keributan, kegaduhan. 3 lapangan. 4 inf.: usaha penipuan/pemerasan.
racketeer	kb. inf.: pemeras.
racy	ks. 1 agak cabul. r. story cerita yang agak cabul. 2 bersih dan rapi (style).
radar	kb. radar. r. beacon menara radar. r. operator juru radar. r. screen layar radar.
radial	ks. yang berkaitan dengan jari-jari lingkaran. r. arrangement susunan seperti jari-jari lingkaran. r. artery urat-urat darah seperti lingkaran dibawah siku.
radiance	kb. sinar, cahaya.
radiant	ks. 1 berseri-seri (of a woman). 2 bersinar-sinar. r. heat panas pancaran.
radiate	kkt. memancarkan (happiness). -kki. 1 bersinar (of the sun). 2 menyebar. road r. from the town jalan-jalan menyebar dari kota itu. 3 memancar, terpancar. goodwill radioates from every side kemauan baik terpancar dari segala pihak.
radiation	kb. radiasi, pemancaran, penyinaran. nuclear r. radiasi nuklir. r. sidness sakit kena radiasi.
radiator	kb. radiator. r. cap tutup radiator. r. hose pipa radiator.
radical	kb. 1 seorang radikal. 2 math., chin.: akar. -ks. 1 radikal. 2 sampai ke akar-akarnya. -radically kk. sama sekali.
radio	kb. radio. on the r. di radio. r. beacon menara radio. -kkt. meradiokan.
radioactive	ks. radioaktip. r. fallout debut radioaktip.
radioactivity	kb. keradioaktipan, radioaktivitas.
radiocarbon	kb. isotop karbon yang radioaktip dengan berat 14 (=carbon 14).
radiogram	kb. radiogram.
radioisotope	kb. isotop radio.
radiologist	kb. radiolog, ahli pengobatan sinar.
radiology	kb. ilmu sinar, radiologi.
radioman	kb. (j. -men) pegawai pemancar radio.
radiophoto	kb. radiofoto.
radiotelephone	kb. telepon radio.
radiotherapy	kb. radioterapi, pengobatan dengan sinar.
radish	kb. rades, lobak.
radium	kb. radium.
radius	kb. 1 jari-jari (lingkaran). radius. 2 anat.: tulang lengan.
raffle	kb. penjualan dengan undian. -kkt. mengundi, lomba menghabiskan. to r. off a turkey mengadaklan pengundian seekor kalkun.
raft	kb. rakit.
rafter	kb. kasau, kasok.
rag	kb. 1 (kain) lap (for cleaning). 2 kain buruk. -kkt. (ragged) sl.: menggoda. r. doll boneka-boneka dari potongan-potongan kain.
ragamuffin	kb. 1 anak yang tak terpelihara. 2 orang jahat.
rage	kb. 1 kemarahan, kegusaran. 2 kegemaran. -kki. 1 mengamuk. 2 marah-marah. -raging ks. 1 yang mengamuk. 2 hebat, tinggi.
ragged	ks. 1 kasar, tidak rata, gerigis. r. edge of a can top pinggiran yang kasar dari tutup kaleng. 2 yang berpakaian compang-camping (of a child). 3 (imperfect) acak-acakan, tidak teratur. our child runs us r. anak kami meletihkan kami.
ragman	kb. (j. -men) pengumpul kain tua.
ragout	kb. daging cincang yang banyak bumbunya.
ragweed	kb. semacam rumput-rumputan.
rah	kseru, ayuh, hure.
raid	kb. 1 geropyokan, razzia, penggerebekan, pembersihan (on a club). 2 serangan. -kkt. penggeropyokan (of a club). 2 perampasan (of foculty by another university).
raider	kb. penjarah, perompak.
rail	kb. (kereta api). to go by r. naik kereta api. 2 jeruji (of a fence). -kkt. memagari (a yard). -kki. to r. at mencerca, menista, mencemooh. -railing kb. susur(an) tangga.
railroad	kb. 1 jalan kereta api. r. crossing persimpangan jalan kereta api. 2 perusahaan kereta api. -kkt. menyelesaikan dengan cepat.
railroadman	kb. (j. -men) 1 pegawai kereta api. 2 pemilik kereta api.
railway	kb. jalan kereta api. r. express nama perusahaan angkutan cepat di a.s. r. system perkereta-apian. r. yard halaman tempat gerbong kereta api.
raiment	kb. pakaian.
rain	kb. hujan. r. cloud awan hujan. -the rains j. musim hujan. -kkt. menghujani (ticker tape). -kki. 1 hujan turun. 2 menghujan.
rainbarrel	kb. tong penampung air hujan.
rainbow	kb. pelangi, bianglala.
raincoat	kb. jas hujan.
raindrop	kb. tetesan/rintik hujan.
rainfall	kb. curah(an) hujan.
rainproof	ks. tahan hujan, tak tembus hujan.
rainstorm	kb. badai hujan.
rainwear	kb. pakaian hujan.
rainy	ks. banyak hujan. r. season musim hujan.
raise	kb. kenaikan (gaji, upah). -kkt. 1 mengangkat (a window, o's hand). 2 menaikkan (the price, flag, s.o's rank). 3 memelihara (animals, fowl). 4 membesarkan (a child). 5 mendapatkan, mengumpulkan. 6 mendirikan (a monument). 7 menghidupkan (the dead).
raised	ks. ditinggikan, tinggi letaknya. r. porch serambi/beranda yang tinggi letaknya.
raiser	kb. penanam, pemelihara. cattle r. peternak sapi.
raisin	kb. kismis.
rake	kb. 1 (tool) penggaruk. 2 bandot. -kkt. 1 menggaruk (leaves). 2 memberondong/membabat/menyapu (the enemy). -raking kb. menggaruk, penggarukan.
rakish	ks. gagah. to wear o's hat at a r. angle memakai topinya miring dengan gagahnya.
rallied	lih rally.
rallies	lih rally.
rally	kb. (j. -lies) 1 rapat umum. 2 tenn.: permainan dengan pukulan yang bertubi-tubi/pukulan kembali-mengembalikan. -kkt. (rallied) mengumpulkan, mengerahkan. -kki. 1 bersatu, berkumpul. rallying point tempat berkumpul.
ram	kb. 1 (sheep) biri-biri jantan. 2 (battering) alat pelantak. -kkt. (rammed) membenturkan (a barge, car)
ramadan	kb. ramadan, puasa.
ramble	kb. pelancongan, pengembaraan. -kki. 1 berkeliling-keliling. 2 berbicara tak teratur. -rambling ks. melantur-lantur, bertele-tele.
rambler	kb. 1 pengembara. 2 (house) rumah yang tak bertingkat dan beratap rendah. 3 (flower) semacam bunga mawar yang pohonnya menjalar.
rambunctious	ks. inf.: suka ribut, kasar, liar dan tak dapat dikendalikan.
ramification	kb. percabangan.
ramifies	lih ramify.
ramify	kki. (ramified) bercabang-cabang.
ramp	kb. 1 jalur yang melandai (of superhighway). 2 jalan melandai, lerengan (at airport).
rampage	kb. amukan. the river is on the r. sungai itu menjadi buas. -kki. mengamuk, meluap.
rampant	ks. merajalela (of a disease). 2 menjadi(-jadi). gambling is r. penjudian menjadi-jadi.
rampart	kb. kubu, benteng.
ramrod	kb. pelantak. straight as a r. tegak seperti patung.
ramshackle	ks. bobrok, buruk.
ran	lih run.
ranch	kb. 1 tempat pertanian yang luas berikut gedung-gedungnya. 2 peternakan. turkey r. peternakan kalkun.
rancher	kb. pengusaha peternakan.
rancid	ks. tengik, anyir, perat.
rancor	kb. benci, dendam.
random	kb. at r. secara serampangan, dengan sembarangan. to bomb at r. membom secara membabi buta. -ks. 1 sembarangan, serampangan. r. plan rencana yang sembarangan. 2 tidak disengaja. r. error kesalahan yang tidak disengaja.
rang	lih ring.
range	kb. 1 jarak. firing r. jarak tembak. 2 tempat latihan (firing, golf). 3 (stove) kompor. 4 tingkat nada (of a voice). 5 jajaran, barisan. -kkt. menyusun. kki. bergerak, bergeser (of prices).
ranger	kb. 1 for.: penjaga hutan. 2 (police) anggota pasukan keamanan.
rank	kb. 1 pangkat (in armed forces). 2 barisan. 3 mil.: tingkat bawahan. -kki. menduduki. -ranking kb. kedudukan. ks. terkemuka.
rankle	kki. menyayat hati, melukai perasaan. the insult rankled penghinaan itu mengganggu pikiran.
ransack	kkt. merampok, menggedor.
ransom	kb. (uang) tebusan. to hold s.o. for r. menahan seseorang untuk mendapatkan uang tebusan. -kkt. menebus. to r. o's soul from the devil membebaskan jiwanya dari setan.
rant	kb. cakap besar/tinggi, kata-kata kasar/melambung, omong-omong kasar. -kki. bergembar-gembor, berteriak-teriak.
rap	kb. ketokan (on a door). 2 dampratan (on the hand). 3 sl.: hukuman. 4 sl.: kesalahan. 5 inf.: sedikit. -kkt. (rapped) 1 memukul (the knuckles). 2 (criticize) mengecam, mengeritik. -kki. 1 mengetok (on a door, desk). 2 sl.: memperbincangkan.
rapacious	ks. suka merampok/menggarong, tamak, serakah.
rapacity	kb. kesenangan/nafsu merampok/menggarong.
rape	kb. perkosaan. -kkt. memperkosa, mencabuli. r. (seed) oil minyak lobak.
rapid	kb. rapids riam, aliran deras, penderasan (in a river). -ks. cepat, laju. rapid-fire, rapid-firing ks. secara cepat. -rapidly kk. dengan cepat.
rapidity	kb. kecepatan.
rapier	kb. pedang tipis dan tajam.
rapierlike	ks. tajam. r. wit otak yang tajam.
rapist	kb. pemerkosa.
rapport	kb. hubungan. to establish r. between... mengadakan hubungan antara....
rapporteur	kb. pelopor.
rapprochement	kb. dekat-mendekati, persesuaian.
rapt	ks. 1 penuh. to sit in r. attention duduk dengan penuh perhatian. 2 asyik. r. in his task asyik dalam pekerjaannya.
rapture	kb. 1 rasa terpesona (of s.o.'s beauty). 2 kegairahan. 3 rasa gembira. to go into raptures over s.t. bergembira-ria akan sesuatu.
rapturous	ks. 1 yang membayangkan rasa terpesona. 2 yang membayangkan kegembiraan hati.
rare	ks. 1 jarang. r. gem permata yang jarang didapat. 2 aneh, ganjil (of a disease). 3 setengah masak (of meat). 4 luar biasa (of talents). 5 tipis (of air). -rarely kk. jarang. i r. see them anymore aku jarabg melihat mereka lagi.
rarebit	kb. lih welsh.
rarefaction	kb. hal menipiskan. penjernihan, penghalusan.
rarefies	lih rarefy.
rarefy	kkt. (rarefied) menipis(kan). menjernihkan, memurnikan. rarefied atmosphere udara jernih, udara yang dijernihkan.
raring	ks. inf.: penuh kegembiraan. the children were r. to go anak-anak itu penuh kegembiraan akan pergi.
rarity	kb. (j. -ties) 1 hal yang jarang sekali. 2 s.s.t. yang aneh/yang jarang terdapat.
rascal	kb. bangsat, bajingan. you r. !! bajingan kau !.
rash	kb. 1 ruam (on face). 2 sejumlah, banyak. -ks. terburu-buru, kurang pikir, gegabah. -rashly kk. dengan terburu-buru, dengan kurang pikir, dengan gegabah.
rasher	kb. sepotong (of ham/bacon).
rashness	kb. keadaan tergesa-gesa.
rasionalize	kkt. 1 menguraikan/memperlakukan dengan cara yang dapat diterima. 2 mencari-cari alasan/dalih. 3 merasionalisasikan.
rasp	kb. 1 (tool) kukuran, parutan. 2 keserakan (in the voice). -ks. serak (of o's voice). -kkt. memarut (a coconut). -kki. menusuk-nusuk. -rasping ks. serak-kasar, garau, parau (of a voice).
raspberry	raspberry
rat	kb. 1 tikus (besar). 2 sl.: penghianat. 3 inf.: ganjel/bantalan rambut. -kki. (ratted) sl.: to r. on menghianati. sl.: kseru. -rats! omong kosong.
ratcatcher	kb. perangkap tikus.
ratchet	kb. roda bergigi searah. r. wheel roda pasak.
rate	kb. 1 tarip, dasar, suku. 2 bea. 3 kurs. 4 angka. 5 kecepatan. -kkt. 1 menilai. 2 menghitung. 3 menaksir, memberi harga. 4 pantas menerima tanda-tanda penghargaan yang diterimanya (a medal). -rating kb. 1 penilaian. 2 nav.: kelasi.
rather	kk. 1 agak. 2 cukup. 3 lebih (baik). r. than daripada.
rathole	kb. lubang yang digerogoti tikus. to g. down the r. habis terkuras, ludes.
rathskeller	kb. restoran yang letaknya biasanya lebih rendah dari jalan.
ratification	kb. ratifikasi, pengesahan.
ratify	kkt. (ratified) mensahkan , mengesahkan, meratifikasi.
ratio	kb. perbandingan. iin the r. of berbanding sebagai.
ration	kb. rangsum, catuan, pelabur. r. card kartu distribusi/rangsum. -rations j. rangsum-rangsum. -kkt. merangsum, menjatahkan. -rationing kb. pencatuan, pemberian rangsum, pendistribusian.
rational	ks. rasionil, masuk, akal, berakal. r explanation penjelasan yang rasionil.
rationale	kb. dasar rasionil/pemikiran alasan.
rationalist	kb. orang yang selalu berpangkal pada hal yang rasioanil.
rationality	kb. (j. -ties) rasionalitas
rationalization	kb. rasionalisasi.
rattan	kb. rotan.
rattle	kb. 1 kertak-kertuk (of a window in the wind). 2 mainan bayi yang kalau digoyang-goyangkan berbunyi kertak-kertuk, giring-giring. 3 bunyi mendesah seekor ular (of a snake). -kkt. 1 menderak-derakkan. 2 membuat bingung, membingungkan (s.o.).
rattlebrained	ks. kepala angin, tolol.
rattler	kb. inf.: ular berbisa.
rattlesnake	kb. ular berbisa.
rattletrap	kb. kendaraan reyot.
rattrap	kb. 1 perangkap tikus. 2 jebakan. he's caught in a r. ia terjebak. ia terjerat dalam keadaan yang tak ada harapan lagi untuk keluar.
ratty	ks. 1 sl.: jembel (of appearance). 2 seperti tikus. a r. odor bau tikus.
raucous	raucous
raunchy	raunchy
rave	kb. sambutan hangat. -ks. hangat. r. review of a book ulasan yang hangat mengenai suatu buku. -kki. meracau, meraban (of a delirious person).- raving kb. ocehan, repetan. ks. 1 gila. 2 luarbiasa, mempesonakan.
ravel	kb. 1 tiras. 2 kekusutan, komplikasi. -kki. berlepasan, bertiras-tiras. -raveling kb. kekusutan.
raven	kb. (burung) gagak. -ks. hitam. r. locks rambut yang hitam mengkilat.
ravenous	ks. 1 sangat lapar, kemaruk. 2 rakus sekali.
ravine	kb. jurang.
ravish	kkt. memperkosa, mencabuli (a female). -ravishing ks. menggairahkan, sangat menarik.
raw	kb. kulit yang telanjang. to swim in the r. berenang dengan telanjang bulat. -ks. 1 mentah (food). 2 kasar. 3 lecet (of skin, throat, sore). 4 merah (of a throat). 5 buruk (of weather). 6 liar, biadab (of the frontier).
rawhide	kb. belulang, kulit mentah.
ray	kb. 1 sinar. r. of hope sinar harapan. the sun's rays sinar matahari. 2 (ikan) pari.
rayon	kb. rayon.
raze	kkt. meruntuhkan, meratakan dengan tanah. to r. a building meratakan gedung dengan tanah.
razor	kb. pisau cukur. r. balde silet. r. edge a) pinggiran pisau cukur. b) keadaan yang sangat membahayakan. electric r. pisau cukur listerik.
razz	kkt. sl.: mengejek-ejek, menggoda, mentertawakan.
razzle-dazzle	kb. sl.: kekalapan, kebingungan. -ks. geduh.
rd.	[road] jalan.
re	kb. perihal.
re-coun	kb. penghitungan (suara) kembali. -kkt. menghitung kembali.
re-cover	kkt. mengulasi baru. to r. a chair mengganti kain kursi.
re-create	kkt. melukiskan kembali.
re-election	kb. pemilihan ulangan/kembali. to be up for r. sudah bersiap-siap untuk dipilih kembali.
reach	kb. 1 jangkauan (of a boxer). 2 daerah. -kkt. 1 mencapai. 2 sampai pada. 3 sampai di. 4 menghubung. 5 menyentuh. 6 mendekati. 7 memberi. -kki. membentang.
reachable	ks. yang dapat dicapai.
react	kkt. memberi reaksi (against, to terhadap).
reaction	kb. reaksi. nuclear r. reaksi nuklir. the of r. partai/golongan yang reaksioner.
reactionary	kb. (j. -ries) seorang yang reaksioner. -reactionaries j. kaum pembangkang. -ks. reaksioner.
reactivate	kkt. menggiatkan kembali (an organization, naval vessel, military unit).
reactivation	kb. pengaktipan kembali.
reactor	kb. reaktor.
read	kkt. (read/red) 1 membaca (a book). 2 membacakan. 3 melihat catatan (a meter). -kki. 1 membaca. 2 berbunyi. -reading kb. 1 membaca. 2 bacaan.
readable	ks. 1 dapat dibaca. 2 menarik.
readdress	kkt. memberi(kan) alamat yang baru (pada surat).
reader	kb. 1 pembaca. r. of manuscripts korektor/penilai naskah. 2 buku bacaan. french r. buku bacaan perancis.
readership	kb. jumlah pembaca.
readiness	kb. 1 keadaan siap, kecepatan. 2 mil.: keadaan siap-siaga. 3 (willingness) kerelaan.
readjust	kkt. 1 mengatur kembali, menyetel kembali (carburetor). 2 menyesuaikan diri (to a situation).
readjustment	kb. 1 penyesuaian diri kembali. 2 pengaturan kembali (of an instrument).
readmission	kb. diterima kembali, pendaftaran kembali (to school).
readmit	kkt. (readmitted) mengizinkan masuk kembali.
ready	kb. 1 at the r. dalam keadaan siap (of a firearm). -ks. 1 siap. 2 siap-sedia. 3 beres. 4 dengan cepat. -kkt. (readied) menyiapkan. ready-made ks. sudah jadi. ready-mix ks. yang siap-dicampur (of cookies, cement). ready-to-wear ks. siap-dipakai.
reaffirm	kkt. 1 menetapkan/menegaskan lagi. 2 menguatkan lagi.
reagent	kb. reagen, bahan reaksi.
real	kb. yang nyata. -ks. 1 sejati (of a friend, gem). 2 nyata (of a dream, of wages). 3 riil (of value). -kk. sangat, benar-benar. -really kk. benar-benar, sungguh-sungguh.
realign	kkt. menyetel kembali (of wheels).
realignment	kb. 1 penyetelan kemabli (of wheels). 2 penyusunan kembali (of party membership).
realism	kb. realisme.
realist	kb. realis.
realistic	ks. realistis.
reality	kb. (j. -ties) realitas, kenyataan. in r. dalam kenyataannya.
realizable	ks. dapat dicapai.
realization	kb. realisasi.
realize	kkt. 1 menyadari, insyaf akan (o's mistake, responsibility). 2 mencapai (o's ambition). 3 mendapat.
realm	kb. bidang, dunia. 2 kerajaan. 3 alam.
realtor	kb. makelar barang-barang tak bergerak (seperti tanah, rumah).
ream	kb. 1 (paper) rim. 2 banyak sekali. -kkt. melebarkan, membesarkan (a hole).
reanimate	kkt. menghidupkan kembali, menggiatkan, mengembirakan.
reap	kkt. 1 mendapat, memungut (a profit, good harvest). 2 memperoleh (from dengan).
reaper	kb. mesin pemungut/penuai. the (grim) r. malaikat maut.
reappear	kki. muncul lagi.
reappearance	kb. ulangan kemunculan.
reapply	kki. (reapplied) melamar lagi.
reappoint	kkt. mengangkat lagi.
reapportion	kkt. membagi-bagikan.
reapportionment	kb. pembagian baru.
reappraisal	kb. penilaian kembali.
reappraise	kkt. menaksir lagi.
rear	kb. 1 pantat. 2 mil.: garis belakang. 3 bagian belakang (of a room, hall). rear-end ks. di (bagian) belakang.
rearm	kkt. mempersenjatai (diri) lagi.
rearmament	kb. persenjataan kembali.
rearmost	ks. yang paling belakang.
rearrange	kkt. menyusun kemabali. mengatur lagi (furniture).
rearrangement	kb. penyusunan kembali, pengaturan kembali.
rearward	ks., kk. bagian belakang, dibelakang, kebelakang.
reason	kb. 1 sebab, alasan. 2 pertimbangan yang sehat. 3 akal (-budi). -kki. 1 mempunyai akal, dapat berfikir. 2 berunding (with dengan). 3 bermusyawarah. -reasoning kb. pemikiran, pertimbangan.
reasonable	ks. 1 layak. 2 pantas. 3 masuk akal. -reasonably kk. 1 layak. 2 agak.
reassemble	kkt. mengumpulkan lagi. -kki. berkumpul lagi.
reassert	kkt. 1 menekankan lagi (o's innocence). 2 mempertegaskan kembali (o's authority).
reassess	kkt. menaksir, menetapkan harga lagi.
reassign	kkt. menugaskan kembali.
reassignment	kb. penugasan kembali.
reassume	kkt. menerima kembali, mengerjakan /menjabat/memangku kembali.
reassurance	kb. penenteraman hati lagi.
reassure	kkt. menenteramkan hati. -reassuring ks. (bersifat) menenangkan, menentramkan.
reawaken	kkt. menimbulkan/menyalakan kembali. -kki. terbangun lagi. i reaawakened at 2 aku terbangun lagi pada jam 2.
rebate	kb. potongan (harga).
rebel	kb. pemberontak, pendurhaka. -kki. (rebelled) (mem) berontak (against melawan).
rebellion	kb. pemberontakan, pemdurhakaan.
rebellious	ks. suka melawan/memberontak/menentang.
rebind	kkt. (rebound) menjilid kembali.
rebirth	kb lahir/bangkit kembali.
reborn	ks. dilahirkan kembali.
rebound	kb. pantulan (of a rubber ball). -kki. memantul, mengambul, melambung, mengganjal (of a ball, a person).
rebroadcast	kb. penyiaran/siaran kembali. -kkt. menyiarkan kembali.
rebuff	kb. penolakan/penampilan kasar, keingkaran. -kkt. menolak/menampik dengan kasar.
rebuild	kkt. (rebuilt) membangun kembali.
rebuke	kb. comelan, kemarahan. -kkt. mencomeli, memarahi.
rebut	kkt. (rebutted) membantah, menangkis.
rebuttal	kb. bantahan, tangkisan. in r. i wish to say that... sebagai tangkisan aku ingin mengatakan bahwa.
rec.	1[record] catatan. 2 [receipt] kwitansi. 3 [recipe] resep (makanan). 4 [received] telah menerima.
recalcitrance	kb. keadaan yang bersifat melawan.
recalcitrant	ks. 1 keras kepala, kepala batu, bandel. 2 suka melawan.
recall	kb. 1 penarikan kembali (of on envoy). 2 ingatan. -kkt. 1 menarik kembali (an envoy). 2 mengingat. 3 menimbulkan.
recant	kkt. menarik kembali. -kki. mengakui kesalahan.
recap	kb. ikhtisar (recapped) 1 mempulkanisir (a tire). 2 menyumbat lagi (on open battle). -kki. mengikhtisarkan.
recapitulate	kkt., kki. memberikan ikhtisar, mengikhtisarkan.
recapitulation	kb. ikhtisar, rekapitulasi.
recapture	kkt. 1 menangkap kembali. 2 memiliki kembali (the past).
recede	kki. 1 surut (of floodwaters). 2 menyusut (of o's hairline). -receding ks. surut, mundur.
receipt	kb. 1 kwitansi. 2 tanda penerimaan, tanda terima (of money deposited or received). 3 penerimaan (of a letter). -receipts j. uang-uang yang masuk, pemasukan uang. -kkt. memberikan kwitansi.
receivable	ks. dapat diterima. accounts r. jumlah uang-uang yang dapat diterima.
receive	kkt. 1 menerima (a package, a person). 2 mendapat (a grade, blow, injury, degree, a name). 3 menyambut.
receiver	kb. penerima (of an award). 2 pesawat penerima, alat bicara, tangkai telepon. 3 kurator (in bankruptcy). 4 tukang tadah, penadah (of stolen goods). 5 pesawat radio.
receivership	kb. keadaan dalam pengawasan kurator. the bankrupt firm passed into r. perusahaan yang bangrut itu berada dalam pengawasan kurator.
recent	ks. baru saja (diterima). i had a r. letter from him padaku ada suratnya yang baru saja kuterima. -recently kk. baru-baru ini.
receptacle	kb. 1 (container) wadah. 2 elec.: stopkontak.
reception	kb. resepsi. to go to a r. pergi ke resepsi. 2 penyambutan yang hangat. 3 penangkapan (of radio, tv).
receptionist	kb. resepsionis, penerima tamu/pasien.
receptive	ks. mau menerima. r. to new ideas mau menerima ide-ide baru.
receptivity	kb. daya penerimaan (of tv or radio). 2 kesediaan/kemauan menerima (to new ideas).
recess	kb. 1 istirahat, turun main (between school periods). 2 reses (of congress). 3 ceruk (in a wall). -kki. (berhenti untuk ) istirahat.
recession	kb. 1 econ.: resesi. 2 pengunduran.
recessive	ks. terdesak, terpendam (of characteristics).
recharge	kkt. menyetrum lagi, mengisi (a battery).
recheck	kkt. meneliti lagi (o's figure).
rechristen	kkt. menobatkan orang menjadi kristen kembali.
recipe	kb. resep (makanan).
recipient	kb. penerima.
reciprocal	ks. timbal-balik (of an agreement, relationship). 1/2 is the r. of 2 1/2 berbanding 2 terbalik dengan 2.
reciprocate	kkt. membalas. i want to r. your good wishes aku membalas ucapan selamatmu. -kkt. membalas.
reciprocity	kb. (j. -ties) 1 hal timbal-balik, pembalasan. 2 pertukaran (hak).
recital	kb. 1 (piano) pertunjukan. 2 cerita (of woes). 3 pengucapan (of poetry). poetry r. deklamasi puisi.
recitation	kb. 1 pembacaan, hafalan, pengajian. 2 hafalan oleh murid-murid (in class).
recite	kkt. 1 membawakan, mendeklamasikan (poetry). 2 menceritakan (a tale of woe).
reckless	ks. 1 sembrono, koboi-koboian. r. driver pengemudi yang sembrono. 2 nekat, berani, candang, ugal-ugalan. -recklessly kk. secara serampangan.
reckon	kkt. 1 memperhitungkan (the cost). 2 menggabungkan. 3 inf.: berpendapat. -kki. menghitung. reckoning kb. perhitungan.
reclaim	kkt. 1 memperoleh kembali (lost articles). 2 menjadikan tanah (from the sea). reclaimed land tanah yang dimanfaatkan/digarap (dengan cara mengeringkan tanah-tanah rawa, pasang surut, dsb).
reclamation	kb. pekerjaan memperoleh tanah.
reclessness	kb. 1 kesembronoan, keserampangan. 2 kenekatan.
recline	kki. berbaring, bersandar. -kkt. menyandarkan/membaringkan (o's head on a pillow).
recluse	kb. pertapa.
recognition	kb. 1 pengakuan (of a country, by the chairman). 2 pengenalan (by s.o.). 3 penghargaan (for outstanding service).
recognizable	ks. dapat dikenal. -recognizably kk. jelas, nampak nyata-nyata. r. fatter nyata-nyata nampak lebih gemuk.
recognize	kkt. 1 mengakui (o's authority, a country). 2 mengenal. 3 menghargai (the honesty of s.o.). -recognized ks. yang diakui.
recoil	kb. rekoil. -kki. 1 melompat (of a rifle). 2 mundur, berkecut hati (of a person). to r. from takut, tidak sampai hati.
recollect	kkt. mengingat kembali.
recollection	kb. ingatan. tothe best of my r. menurut ingatan saya. within my r. sepanjang ingatanku.
recommence	kkt. mulai lagi.
recommend	kkt. 1 memuji kebaikan (s.o.o./s.s.t.). 2 menasehatkan. 3 menganjurkan.
recommendation	kb. 1 pujian, rekomendasi. 2 surat pujian. he has excellent recommendations ia mempunyai surat-surat pujian yang sangat baik.
recommit	kkt. (recommitted) memasukkan kembali.
recompense	kb. balas/imbalan jasa. -kkt. membalas jasa, mengganti kerugian.
reconcilable	ks. dapat didamaikan.
reconcile	reconcile
reconciliation	kb. perdamaian, perukunan kembali.
recondite	ks. 1 sukar dimengerti. 2 terpendam. 3 kurang dikenal.
recondition	recondition
reconnaissance	kb. pengintaian. r. plane pesawat pengintaian/peninjau/mata-mata.
reconnoiter	reconnoiter
reconsider	kkt. mempertimbangkan kembali.
reconsideration	kb. pertimbangan kembali.
reconsitute	kkt. menyusun kembali.
reconstruct	kkt. merekonstruksi, memulihkan sebagai semula. to r. a crime menyusun kembali kejahatan.
reconstruction	kb. 1 rekontruksi. 2 pembangunan kembali (of a bridge).
reconvene	kkt. memanggil/mengumpulkan kembali. -kki. berkumpul kembali.
reconvert	kkt. 1 mengubah kembali. 2 menukar (money).
record	kb. 1 mus.: peringan hitam. 2 catatan. 3 rekor. 4 dokumen (resmi). 5 riwayat pekerjaan (of s.o.). -ks. rekor. -kkt. 1 mencatat (by s.o.). 2 merekam (on tape pada pita suara). record-breaking ks. memecahkan rekor. -recording kb. rekaman.
recorder	kb. 1 penangkap/perekam suara. 2 pencatat (at court di pengadilan). 3 mus.: semacam suling.
recordholder	kb. pemegang rekor.
recount	kkt. menceritakan (o's adventures, the day's activities).
recoup	kkt. mengganti, menutup (o's losses kerugian-kerugiannya).
recourse	kb. jalan lain. 2 penolong.
recover	kkt. 1 mengejar kembali (o's losses). 2 memperoleh (useful material from wastes). 3 menemukan kembali (a lost dog). 4 menang dengan mendapat ganti (damages). -kki. 1 sembuh (from an illness). 2 pulih.
recoverable	ks. 1 dapat dipulihkan. 2 dapat diperoleh kembali.
recovery	kb. (j. -ries) 1 kesembuhan, sembuhnya (from an illness). 2 penemuan kembali (of lost or stolen goods). 3 didapatnya kembali (of a returned spacecraft).
recreation	kb. rekreasi, hiburan.
recreational	ks. yang berkaitan dengan rekreasi.
recrimination	kb. tuduh-menuduh.
recruit	kb. mil.: cepat, rekrut. 2 calon (for volunteer assistance). -kkt. mendapatkan (new members for armed forces, the help of s.o.). -recruiting kb. menerima tenaga-tenaga baru.
recruiter	kb. orang yang mendapatkan anggota baru.
recruitment	kb. pengerahan.
rectal	ks. yang berkaitan dengan dubur.
rectangle	kb. empat persegi panjang, bujur sangkar.
rectangular	ks. seperti empat persegi panjang.
rectification	kb. pembetulan.
rectify	kkt. (rectified) meralat (a mistake).
rectilinear	ks. seperti garis lurus.
rector	kb. 1 kepala perguruan tinggi. 2 kepala gereja.
rectory	kb. (j. -ries) rumah pendeta protestan.
rectum	kb. dubur.
recumbent	ks. berbaring, telentang. in a r. position sikap berbaring.
recuperate	kki. menguatkan diri kembali, sembuh.
recuperation	kb. penyembuhan (from illness, loss).
recuperative	ks. yang berhubungan dengan penyembuhan. r. powers daya penyembuh.
recur	kki. (recurred) berulang, lagi-lagi timbul. the high temperature kept recurring suhu yang tinggi itu berulang saja.
recurrence	kb. 1 keadaan kumat, keadaan sakit yang terulang (of an illness, mistake). 2 keadaan bentan/kambuh.
recurrent	ks. berulang, kumat, kambuh. to suffer from r. headaches menderita sakit kepala yang berulang.
recycle	kkt. mengembalikan botol-botol/kaleng-kaleng (untuk dipakai lagi).
red	kb. 1 merah. 2 r. orang komunis. -the reds kaum merah. red-blooded ks. jantan, bersifat laki-laki. red-haired ks. berambut merah. red-handed tertangkap basah. red-hot ks. 1 pijar, panas sekali. 2 yang bersemangat sekali.
redcap	kb. pengangkatan barang.
redden	kkt. menjadi merah,memerahkan. -kki. menjadi merah, memerah.
reddish	kb. kemerah-merahan.
redecorate	kkt., kki. menghiasi lagi (a house).
redeem	kkt. 1 menebus (an item from a pownshop, a promissory note). 2 menyelamatkan (from sin). 3 melepaskan (a slave). 4 mendapatkan kembali.
redeemable	ks. dapat ditebus.
redeemer	kb. penebus. the r. sang penebus.
redemption	kb. 1 penebusan (of a pledge). 2 penyelamatan (from sin).
redhead	kb. orang yang merah rambutnya.
redheaded	ks. berambut merah/pirang.
redid	lih redo.
redirect	kkt. mengalihkan jurusan (traffict).
redistribute	kkt. membagi-bagikan lagi.
redistribution	kb. pembagian kembali.
redo	kkt. (redid, redone) 1 mengulangi (an exam). 2 memperbaiki (o's house). 3 menulis.
redolent	ks. berbau harum.
redone	lih redo.
redouble	redouble
redoubt	kb. kubu, perkubuan, benteng.
redoubtable	ks. mengagumkan, menimbulkan respek.
redound	kki. berakhir(kan). to r. to o's crediit berakibat baik bagi seseorang.
redress	kb. ganti-rugi. -kkt. menebus, memperbaiki (a wrong, an economic imbalance).
reduce	kkt. 1 mengurangi, menurunkan (price, fine). 2 mengurangkan (a fraction). 3 mereduksikan. -kki. berkurang. -reduced ks. yang diturunkan/dikurangi. -reducing kb. penurunan.
reduction	kb. 1 penurunan, potongan (in price). 2 pengurangan (in weight, in numbers).
redundancy	kb. (j. -cies) 1 pleonasme. 2 kelebihan, redundansi.
redundant	ks. 1 berlebih-lebihan. 2 pleonastis.
reduplicate	kkt. 1 menggandakan. 2 mengulangi.
reduplication	kb. 1 reduplikasi. 2 penggandaan, pengulangan (of a syllable).
reed	kb. 1 sejenis buluh. to lean on a broken r. bersandar kepada sokongan yang memberi harapan lagi. 2 alang-alang. r. instrument alat semacam buluh.
reef	kb. batu/gosong karang. -kkt. to r. a sail memperpendek/mengandakkan layar.
reefer	kb. sl.: rokok mariwuana/ganja.
reek	kki. 1 berbau busuk. that spoiled meat reeks daging yang busuk itu sudah bau. 2 berbau. his clothes r. of tobaco smoke pakaian-pakaiannya berbau tembakau.
reel	kb. 1 gulung, rol (of film). 2 alat penggulung, kili-kili (fishing rod). 3 kumparan. -kkt. menyebut. -kki. terhuyung-huyung (from a blow).
reemergence	kb. pemunculan kembali.
reenact	kkt. 1 melakukan kembali/lagi. to r. a crime melakukan kembali kejahatan. 2 menghidupkan/membuat berlaku kembali/lagi (a law).
reenter	kki. masuk kembali.
reentry	kb. (j. -ries) masuk(nya) kembali (of a space rocket, in a country). r. permit izin masuk kembali.
reestablish	kkt. menghidupkan (kembali), mendirikan lagi.
reexamination	kb. 1 pemeriksaan kembali. 2 acad.: ujian her/ulangan.
reexamine	kkt. 1 memeriksa kembali. 2 acad.: menguji kembali.
ref.	1 [reference] pedoman, petunjuk, referensi. 2 [refree] wasit.
refashion	kkt. menggubah lagi.
refer	kkt. (referred) 1 menyerahkan (a matter) (to kepada). 2 menghubungi. -kki. 1 menunjuk (to kepada). 2 berkenaan, mengenai. 3 mengarahkan.
referee	kb. wasit, pemisah. -kkt. mewasiti.
reference	kb. 1 surat keterangan, rekomdasi. 2 referansi.
referendum	kb. (j. -dums, -da) referandum, pemungutan suara umum.
referral	kb. penyerahan (of a matter to s.o.).
refill	kb. 1 pengisian kembali. this pen needs a r. pulpen itu perlu diisi lagi. 2 lembaran-lembaran baru pengisi (for a loosleaf notebook). -kkt. mengisi lagi.
refine	kkt. 1 menyuling, menyaring, membersihkan (oil, sugar). 2 memperhalus, menghaluskan (o's language, metals). -refined ks. berbudi halus, beradab, sopan. -refining kb. pengilangan/penyulingan minyak.
refinement	kb. 1 kehalusan budibahasa. 2 perbaikan (in a new model). 3 kemurnian. 4 pengilangan (of petroleum).
refinery	kb. (j. -ries) kilang minyak.
refinish	kkt. mempolitur lagi.
refit	kkt. (refitted) memperlengkapi lagi (a ship).
refl.	[reflexive] refleksip.
reflect	kkt. 1 menggambarkan, membayangkan, mencerminkan (an opinion). 2 mewakili (o's feeling). 3 memantulkan (heat). -kki. 1 membayang. 2 memikirkan (a matter). 3 merendahkan, mengurangi arti.
reflection	kb. 1 bayangan, refleksi (in water, mirror). 2 pemantulan (of a sound). 3 pemikiran (on a matter). 4 celaan.
reflective	ks. 1 yang memantulkan cahaya. 2 termenung, terpekur.
reflector	kb. reflektor, pemantul cahaya.
reflex	kb. refleks. r. movement gerak refleks (yang tidak disengaja).
reflexive	ks. refleksip. r. pronoun kataganti refleksip.
reforestation	kb. reboisasi, peremajaan hutan, penghutanan kembali.
reform	kb. perbaikan. r. movement gerakan pembaharuan (suatu sistem). -kkt. memperbaiki (o's ways, s.o.). -kki. memperbaiki diri, menjadi lebih baik.
reformation	kb. reformasi.
reformatory	kb. (j. -ries) 1 panti asuhan. 2 (prison) penjara, asrama pendidikan.
reformer	kb. pembaharuan, pembuat perubahan.
refract	kkt. membiaskan, membelokkan.
refraction	kb. pembiasan, perubahan arah, pembelokan (of light).
refractory	ks. 1 keras kepala (of a person or animal). 2 yang sukar disembuhkan (of a cough).
refrain	kb. mus.: bagian ulangan. -kki. menahan diri (from supaya jangan).
refresh	kkt. menyegarkan (o.s. diri). to r. o's memory membangkitkan ingatan. -refreshing ks. menyegarkan (of a drink, an attitude).
refresher	kb. penyegar (mis. tea, coca-cola). r. course kursus penyegar.
refreshment	kb. minuman, makanan. it's about time to take some r. sudah tiba waktunya untuk minum dan makan. -refshments j. minuman dan makanan.
refrigerate	kkt. mendinginkan, melemari-eskan. refrigerating plant instalasi pendingin.
refrigeration	kb. pendinginan.
refrigerator	kb. kulkas, lemari es/ pendingin. r. car gerbong pendingin.
refuel	kki. mengisi/menambah bensin.
refuge	kb. tempat perlindungan. to seek/take r. mencari perlindungan.
refugee	kb. pengungsi.
refund	kb. pembayaran kembali. -kkt. mengembalikan uang, membayar kembali.
refurbish	kkt. membaharui lagi.
refusal	kb. penolakan. to give a flat r. menolak mentah-mentah. to have first r. on s.t. mempunyai hak pertama untuk membeli atau menolak sesuatu.
refuse	kb. sampah. -kkt. 1 menolak. to r. admittance menolak untuk memberi izin masuk. 2 tidak menuruti (a child).
refutation	kb. pembuktian kesalahan, sangkalan.
refute	kkt. menyangkal, membuktikan bahwa salah.
reg.	1 [regulation] peraturan. 2 [regent] bupati, wali, pengawas.
regain	kkt. memperoleh/mendapat kembali. to r. consciousness (menjadi) sadar kembali. to r. o's footing tegak kembali.
regal	ks. agung, seperti raja. r. appearance wujud yang agung.
regale	kkt. 1 menghibur, menyuguhi (s.o. with interesting stories). 2 menikmati (o.s. with s.t.).
regalia	kb. tanda-tanda kebesaran, alat/tanda kerajaan.
regard	kb. 1 hormat. 2 salam. 3 hal. -kkt. 1 menganggap. 2 memandang. 3 melihat pada. 4 memperhatikan. -regarding kd. mengenai, berkenaan dengan.
regardless	ks. tanpa memperhatikan/menghiraukan. -kk. bagaimanapun juga.
regatta	kb. perlombaan perahu-layar.
regency	kb. (j. -cies) 1 kabupaten. 2 perwalian.
regenerate	kkt. 1 memperbaharui, menumbuhkan lagi (the lost tail of a reptile). 2 menghidupkan lagi (a despondent person). 3 memperbaiki (a criminal).
regeneration	ks. 1 pembaharuan jiwa, perbaikan spirituil. 2 kelahiran kembali.
regent	kb. 1 bupati. 2 wali, pengawas.
regime	kb. resim, rezim.
regimen	kb. cara/aturan hidup.
regiment	kb. 1 mil.: resimen. 2 jumlah besar (of servants). -kkt. mengatur.
regimental	ks. yang berhubungan dengan resimen.
regimentation	kb. cara hidup teratur, cara hidup yang diawasi.
region	kb. 1 daerah, wilayah. 2 bagian. r. of the brain bagian dari otak.
regional	ks. kedaerahan. r. meeting rapat sedaerah. r. government pemerintah daerah.
regionalism	kb. daerahisme, sifat kedaerahan.
register	kb. 1 (buku) daftar. 2 lobang pengatur panas (heating). 3 tingkat nada (of a voice). -kkt. 1 mendaftarkan (a car). 2 menyatakan (a complaint). 3 menunjukkan (surprise). 4 menunjuk. -registered ks. tercatat.
registrant	kb. pendaftar.
registrar	kb. acad.: panitera (fakultas). 2 pencatat, pendaftar.
registration	kb. pendaftaran, registrasi. voter r. pendaftaran pemilih.
registry	kb. (j. -ries) 1 pendaftaran, registrasi. 2 kantor pendaftaran.
regress	kb. kemunduran. -kki. mundur, surut.
regression	kb. kemunduran, regresi.
regret	kb. sesalan, penyesalan. -(regretted) 1 menyesali (the time spent). 2 menyesal.
regretful	ks. yang menyesal, sesal. -regretfully kk. dengan menyesal.
regrettable	ks. disesalkan. the situation is r. keadaan itu disesalkan. -regrettably kk. disayangkan, disesalkan.
regroup	kkt. menyusun kembali.
regt., regt.	[regiment] resimen.
regular	kb. 1 sport : seorang pemain tetap. 2 mil.: prajurit tetap. 3 langganan tetap (at a store). -ks. biasa (route, routine). 2 tetap (of a soldier, customer). 3 teratur, biasa. -regularly kk. dengan/secara tetap.
regularity	kb. (j. -ties) sifat beraturan. r. of mail service hantaran pos secara beraturan.
regularize	kkt. membuat beraturan/teratur, mengatur secara tetap/mantap.
regulate	kkt. 1 mengatur. 2 menyetel (the carburetor). -regulating kb. pencocokan, penyetelan. r. of a compass pencocokan sebuah kompas.
regulation	kb. peraturan. army regulations peraturan-peraturan tentara/ketentaraan.
regulator	kb. (alat) pengatur.
regulatory	ks. yang berkaitan dengan pengaturan. r. measures tindakan-tindakan pengaturan.
regurgitate	kkt. memuntahkan. -kki. muntah.
rehabilitate	kkt. merehabilitasikan.
rehabilitation	kb.rehabilitasi. r. center tempat penampungan.
rehash	kb. pengulangan, pengolahan dalam bentuk baru. -kkt. membicarakan kembali, membangkit-bangkitkan.
rehearsal	kb. latihan, ulangan, repetisi.
rehearse	kkt. melatih lagi (o's role). -kki. berlatih.
reign	kb. pemerintahan. 2 kekuasaan (of law and order). -kki. 1 memerintah. 2 merajalela.
reimburse	kkt. membayar kembali, mengganti uang. to r. s.o. for his outlay membayar kembali pengeluaran-pengeluaran uang seseorang.
rein	kb. tali kekang, kendali. -kkt. to r. in mengekang (a horse).
reincarnation	kb. reinkarnasi, penjelmaan kembali.
reindeer	kb. rusa kutub.
reinforce	kkt. 1 menguatkan, menebalkan (a statement). 2 memperkuat (a bridge, troops). reinforced concrete beton bertulang.
reinforcement	kb. 1 penguatan (of a wall, bridge). 2 mil.: bala bantuan.
reinstate	kkt. mengembalikan lagi, mendudukkan/menerima kembali.
reintroduce	kkt. mengajukan lagi (a bill).
reissue	kb. penerbitan kembali. kkt. menerbitkan lagi.
reiterate	kkt. mengulangi pertanyaan.
reject	kb. apkiran (from the army). 2 barang apkiran (from an orchard). -kkt. 1 menolak (an offer). 2 mengapkir. the navy rejected him angkatan laut mengapkirnya.
rejection	kb. 1 penolakan (of o's parents). r. slip kartu penolakan (from editor). 2 pengapkiran (by the armed forces).
rejoice	kki. girang, gembira. to r. at hearing... girang mendengar... -rejoicing kb. kegirangan, kegembiraan.
rejoin	kkt. menggabungkan lagi (o's family, a firm). -kki. membalas, menjawab.
rejoinder	kb. jawaban, balasan.
rejuvenate	kkt. menjadikan muda kembali, memudakan, mempermuda.
rejuvenation	kb. peremajaan lagi.
rel.	1 [religious] religius, beragama. 2 [relative] sanak, famili; nisbi, relatip; berhubungan dengan. 3 [relating] mengenai, berhubungan dengan.
relapse	sakit lgi. to suffer a r. kambuh, bentan. -kki. jatuh sakit lagi. to r. into silence kembali keadaan menjadi sunyi senyap.
relate	kkt. 1 menceritakan (an account). 2 mempertalikan, menghubungkan (two matters). -kki. berkenaan, berhubungan (to dengan). -related ks. 1 berhubungan. 2 bertalian.
relation	kb. 1 hubungan (between two countries). 2 pamili, sanak. relations j. persetubuhan. to have relations with bersetubuh dengan.
relationship	kb. 1 hubungan, perhubungan. there's a good r. between... ada hubungan yang baik antara... 2 pertalian. language r. pertalian bahasa.
relative	kb. sanak, pamili. -ks. 1 nisbi (of humidity). 2 relatip. -relatively kk. secara relatip.
relativity	kb. kerelatipan, kenisbian.
relax	kkt. 1 mengendurkan (muscles, a hold). 2 mengurangi (o's vigilance, pressure). -kki. bersenang-senang, beristirahat, bersantai-santai. -relaxed ks. (ber)santai, tenang sekali (badannya).
relaxation	kb. 1 istirahat, persantaian. 2 pengendoran (of muscles, military discipline).
relay	kb. lari beranting. -kkt. 1 menyampaikan (a massage). 2 menyiarkan.
