execrable	ks. buruk sekali, benar-benar terlalu /keterlaluan. her dutch is e. bahasa belandanya buruk sekali.
execution	kb. 1 pelaksanaan. 2 law : menghukum mati, pelaksanaan hukum mati. 3 pembuatan . 4 penandatanganan, pengesahan / pengabsahan dengan penandatanganan.
executioner	kb. algojo.
executive	kb. pelaksana, eksekutip, laksanawan (of a firm). -ks. 1 eksekutip. 2 pelaksana. e. board meeting rapat kepala-kepala bagian.
executor	kb. wali, pengawas seseorang yang dalam surat wasiat ditunjuk sebagai pelaksana dari ketentuan-ketentuan dalam surat wasiat.
executrix	kb. wali wanita.
exegesis	kb. penjelasan, penafsiran.
exemplary	ks. patut dicontoh. e. behavior kelakuan yang patut dicontoh.
exemplification	kb. 1 pemberian contoh. 2 contoh.
exemplify	kkt. (exemplified) 1 memberikan contoh. 2 menunjukkan. his manners e. his breeding tingkah lakunya menunjukkan didikannya.
exempt	ks. dibebaskan. e. from taking examinations dibebaskan dari ujian. -kkt. membebaskan, mengecualikan.
exemption	kb. 1 pembebasan. e. from military duty pembebasan dari dinas militer. 2 pengecualian, potongan (for income tax purposes).
exercise	kb. 1 gerak badan. 2 latihan. 3 penggunaan, penghikmatan. -kkt. 1 menggunakan (a right, duty). 2 menjalankan, melakukan. 3 mengadakan. 4 meminta perhatian. -kki. bergerak badan.
exert	kkt. menggunakan, mendesak. to e. pressure menggunakan tekanan.
exertion	kb. 1 penggunaan, penyelenggaraan. 2 pemerasan / pengerahan tenaga, usaha.
exfoliation	kb. pengelupasan kulit.
exhalation	kb. pernapasan keluar.
exhale	kkt. mengeluarkan (dengan bernafas), menghembuskan. to e. air from the lungs mengeluarkan udara dari paru-paru. -kki. mengeluarkan napas.
exhaust	kb. tempat atau alat pembuangan uap atau gas. -kkt. 1 meletihkan, menghabiskan tenaga. 2 melemahkan. 3 menanduskan. 4 menyelesaikan. -exhausted ks. 1 kehabisan tenaga, sangat letih. 2 habis, terpakai. -exhausting ks. meletihkan, melelahkan.
exhaustion	kb. kelelahan, keletihan, kepayahan. to be in a state of e. dalam keadaan sangat lelah.
exhaustive	ks. yang mendalam, lengkap. e. search penyelidikan yang mendalam.
exhibit	exhibit , kb.pameran
exhibition	kb. pameran, pertunjukan. he gave e. of temper ia memperlihatkan kemarahan yang besar sekali.
exhibitionist	kb. orang yang suka sekali memperlihatkan kecakapan-kecakapannya.
exhilarate	kkt. meriangkan, menggembirakan. the atmosphere exhilarated us suasananya meriangkan kami. -exhilarating ks. yang menyegarkan, yang meriangkan.
exhilaration	kb. keriangan, kegembiraan.
exhort	kkt. mendesak. to e. s.o. to greater efforts mendesak seseorang untuk berusaha lebih keras.
exhortation	kb. 1 desakan. 2 nasihat, peringatan.
exhume	kkt. menggali (dari kuburan).
exigency	kb. (j. -cies) urgensi, keadaan darurat.
exile	kb. 1 pembuangan, pengasingan. 2 orang buangan. he was sent into e. dia dibuang. dia diasingkan. -kkt. mengasingkan, membuang.
exist	kkt. 1 ada. 2 hidup.- existing ks. yang ada. in e. circumstances dalam keadaan demikian.
existence	kb. 1 adanya. to be aware of its e. sadar akan adanya. 2 kehidupan, keadaan hidup. to come into e. menjelma, menjadi ada.
existential	ks. eksistensial.
existentialism	kb. eksistensialisme.
exit	kb. (jalan) keluar. to make a hasty e. keluar dengan cepat. -kkt. keluar, pergi, meninggalkan.
exodus	kb. 1 kepergian banyak orang. the june e. from school kepergian anak- anak dari sekolah dalam bulan juni. 2 bible : keluaran.
exogamy	kb. eksogami, perkawinan diluar suku, perkawinan campuran.
exonerate	kkt. membebaskan dari tuduhan/celaan, membuktikan tidak bersalah.
exorbitant	ks. melebihi yang biasa. e. price for a house harga yang terlalu tinggi untuk sebuah rumah.
exorcise	kkt. mengusir setan, membebaskan dari roh jahat. to e. a spirit from s.o. mengusir roh jahat dari tubuh seseorang, membebaskan seseorang dari roh jahat.
exotic	ks. aneh-aneh, luar biasa, asing. e. dishes makanan-makanan yang aneh-aneh, makanan dari negeri asing.
expand	kkt. memperluas, mengembangkan. to e. a business memperluas perusahaan. -kki. mengembang, meluas, memuai. -expanding ks. yang mengembang/berkembang.
expandable	ks. dapat diperluas/di(per)kembangkan.
expanse	kb. suatu ruang/bidang/permukaan yang luas. an ocean is a large e. of water samudera adalah permukaan air yang luas.
expansion	kb. 1 perluasan (of business). 2 pengembangan, pemuaian (of ballon, metal). 3 ekspansi.
expansive	ks. 1 luas. 2 meluap-luap. he's in on e. mood perasaannya meluap-luap.
expatiate	kki. mengarang/bercakap dengan panjang-- lebar.
expatriate	kb., ks. seorang yang melepas kewarganegaraannya. e. writer penulis dalam pengasingan. -kkt. 1 meninggalkan negeri asalnya. 2 mengusir, membuang (dari negeri asalnya).
expect	kkt. 1 mengharapkan. to e. him home tonight mengharapkan dia pulang malam ini. 2 menyangka. 3 mengira. what did you e. me to do ? apa yang kau kira akan saya perbuat/lakukan ?
expectancy	kb. (j. -cies) 1 pengharapan. 2 harapan. life e. harapan lamanya orang hidup, harapan panjangnya umur seseorang.
expectant	ks. 1 yang mengandung harapan. an e. smile senyuman yang mengandung harapan. 2 yang sedang mengandung, hamil. e. mother ibu yang sedang mengandung.
expectation	kb. (peng) harapan, dugaan. beyond expectations diluar dugaan.
expectorate	kki. meludah.
expediency	kb. (j. -cies) keadaan yang layak, kelayakan, kebijaksanaan, kemanfaatan, kegunaan.
expedient	kb. jalan yang berguna sekali. -ks. bijaksana. to take an e. course mengambil jalan yang bijaksana.
expedite	kkt. mempercepat, melancarkan. it will e. matters if we cooperate dengan bekerja sama kita akan menyelesaikan hal-hal lebih cepat.
expediter	kb. ekspeditur.
expedition	kb. 1 ekspedisi. 2 kecepatan.
expeditious	ks. 1 cara terbaik, tepat guna. 2 cepat.
expel	kkt. (expelled) 1 mengeluarkan, memaksa keluar. 2 mengeluarkan, menghembuskan. 3 membuang (from society group).
expend	kkt. 1 mengeluarkan, membelanjakan to e. money mengeluarkan uang. 2 mencurahkan. to e. time on a project mencurahkan waktu untuk suatu rencana.
expendable	ks. dapat dihabiskan.
expenditure	kb. pengeluaran, belanja.
expense	kb. biaya, ongkos. at the e. of 1 atas biaya. 2 dengan mengorbankan. -expenses j. ongkos-ongkos, pengeluaran-pengeluaran.
expensive	ks. mahal.
experience	kb. pengalaman. -kkt. mengalami. -experienced ks. berpengalaman. he is e. in reporting ia sudah berpengalaman sebagai wartawan.
experiment	kb. percobaan, eksperimen. e. station balai percobaan/penyelidikan. -kki. mengadakan percobaan (on/with dengan).
experimental	ks. bersifat percobaan. e project proyek percobaan.
experimentation	kb. (pelaksanaan suatu) percobaan, pencobaan.
expert	kb. ahli. to call in an e. minta nasehat seorang ahli. -ks. ahli. e. advice nasehat seorang ahli.
expertise	kb. keahlian.
expiration	kb. 1 waktu berakhir. e. date on an insurance policy tanggal berakhirnya polis asuransi. 2 penghembusan nafas terakhir, mati, meninggal.
expire	kki. 1 berakhir, habis waktunya. the policy has expired polis itu telah berakhir. 2 (die) meninggal. -expired ks. daluwarsa (of a policy, treaty, contract).
expiry	kb. (j. -ries) waktu berakhir, habis waktu.
explain	kkt. menerangkan, menjelaskan. to e. away menghilangkan dengan memberi alasan.
explanation	kb. keterangan, penjelasan. we owe an e. for... kita perlu memberi keterangan tentang...
explanatory	ks. bersifat menjelaskan. to provide some e. remarks memberikan keterangan-keterangan yang bersifat mejelaskan.
expletive	kb. 1 kata seru/lontaran. 2 kata yang tak ada artinya, kata pengisi.
explicit	ks. 1 tegas, eksplisit. 2 jelas. -explicitly kk. dengan tegas, secara eksplisit.
explode	kkt. meledakkan, meletuskan (dynamite). -kki. 1 meledak, meletus. 2 marah sekali.
exploit	kb. perbuatan yang berani/luarbiasa. -kkt. 1 mengeksploitir (s.o.). 2 mengeksploitasi, memanfaatkan. to e. the mineral resources mengeksploitasi sumber-sumber mineral.
exploitation	kb. eksploitasi, pengharapan, pemerasan.
exploration	kb. eksplorasi, penjelajahan.
exploratory	kb. yang berhubungan dengan penyelidikan untuk suatu penemuan. e. talks pembicaraan mengenai usaha-usaha penyelidikan, pembicaraan bersifat penyelidikan.
explore	kkt. 1 menjelajahi (an island, cave). 2 menyelidiki (opportunies). 3 memeriksa (a wound). -kki. mengadakan penyelidikan. to e. for uranium mengadakan penyelidikan untuk menemukan uranium.
explorer	kb. penjelajah.
explosion	kb. letusan, ledakan, letupan. e. of anger kemarahan yang meledak.
explosive	kb. 1 bahan peledak. 2 phon.: bunyi eksplosif. -ks. bersifat meledak. e. temper sifat orang yang suka marah dengan tiba-tiba.
exponent	kb. 1 orang yang menerangkan/menguraikan. 2 eksponen, pangkat dalam aljabar. 3 contoh, lambang.
exponential	ks. yang berhubungan dengan eksponen aljabar. e. curve garis lengkung yang tergantung dari suatu fungsi eksponen.
export	kb. (bahan) ekspor. -kkt. mengekspor.
exporter	kb. eksportir.
expose	kkt. 1 membuka, menyingkapkan terhadap cahaya (film). 2 membongkar. -exposed ks. yang tidak tersembunyi/terlindung. e. to the air kena udara, terbuka terhadap udara.
expose`	kb. pembongkaran, pembeberan.
exposition	kb. 1 (exhibit) pameran, pertunjukan, eksposisi. 2 penjelasan yang terperinci. 3 karangan yang menjelaskan sesuatu proses atau gagasan, perawian.
expostulate	kki. 1 bertukar pikiran dengan sungguh-sungguh. 2 berbantah, membantah
expostulation	kb. 1 peringatan. 2 bujukan.
exposure	kb. 1 pembukaan. 2 kedapatan, pembongkaran. 3 pencahayaan (of film). e. meter meteran cahaya pada alat pemotret.
expound	kkt. menjelaskan/menguraikan secara terperinci.
express	kb. kereta api kilat. -ks. 1 kilat. 2 jelas, tegas, tepat. -kk. dengan ekspres. -kkt. 1 menyatakan, mengutarakan, mengungkapkan. 2 memperlihatkan. 3 menandakan. 4 mengirimkan dengan ekspres. 5 mengucapkan, menyatakan. 6 menyampaikan.
expression	kb. 1 ungkapan, ucapan. 2 pernyataan. 3 perasaan, ekspresi. 4 tanda, lambang.
expressive	ks. bersifat menyatakan perasaan. her face was e. of her feelings mukanyamembayangkan perasaan-perasaannya.
expressly	kk. 1 dengan jelas. 2 (dengan) sengaja.he went e. to avoid you ia sengaja pergi untuk menghindari kamu.
expressman	kb. (j. -men). petugas (cepat) pada perusahaan pengiriman barang-barang dengan cepat.
expressway	kb. jalan raya untuk lalu lintas kendaraan cepat.
expropriate	kkt. mengambil alih. the government expropriated the firm pemerintah mengambil alih perusahaan itu.
expropriation	kb. pengambilan alih.
expulsion	kb. 1 pengusiran (from school). 2 pengenyahan, pengeluaran dengan paksa (of undersirables).
expunge	kkt. menghapus, menghilangkan, mencoret. e. those remarks from the court record hapuslah pernyataan-pernyataan itu dari catatan pengadilan.
expurgate	kkt. menghilangkan bagian-bagian atau kata-kata yang tidak patut (dari buku, surat dsb). expurgated version versi yang telah banyak dihilangkan bagian-bagiannya yang tidak patut.
exquisite	ks. 1 indah sekali, sangat elok. 2 halus sekali. 3 hebat sekali. -exquisitely kk. dengan sangat indah, secara halus.
exsistent	ks. = existing.
ext.	1 [extension] sambungan. 2 [external] ekstern/luar. 3 [extra] ekstra/tambahan.
extant	ks. (masih) ada. his manuscripts are still e. naskah-naskahnya masih ada.
extemporaneous	ks. yang dilakukan tanpa persiapan. e. speech pidato yang diucapkan tanpa persiapan.
extend	kkt. 1 memperpanjang (a visa, ladder, vacation. 2 menyampaikan. 3 mengulurkan. 4 memberikan. 5 memperluas. -kki. sampai. extended ks. secara luas, diperpanjang.
extension	kb. 1 perpanjangan (time, visa). 2 perluasan. e. cord kawat sambungan, kabel penyambung.
extensive	ks. luas. e. search pencaharian yang luas.
extent	kb. 1 luas. e. of the plain luas dari dataran itu. 2 tingkat. the e. of the crime is still not known tingkat kejahatan itu belum lagi diketahui.
extenuate	kkt. memperlunak, memperingan. -extenuating ks. yang meringankan. e. circumstances keadaan-keadaan yang meringankan.
exterior	kb. 1 bagian luar. e. of a house bagian luar rumah. 2 lahirnya. he has a severe e. ia pada lahirnya seorang yang keras. -ks. (sebelah) luar.e. angle sudut luar.
exterminate	kkt. membasmi, memusnahkan. to e. mosquitoes membasmi nyamuk.
extermination	kb. pembasmian nyamuk, pemusnahan.
exterminator	kb. 1 pembasmi. 2 (instrument) alat pembasmi.
external	kb. externals j. rupa, keadaan luar. -ks. 1 luar. e. ear telinga luar. 2 luar negeri. e. affairs urusan-urusan luar negeri.
extinct	ks. 1 padam. the fire is e. api itu telah padam. 2 mati. the cigarette is e. rokok itu mati. 3 punah, hilang. an e. animal binatang yang punah.
extinction	kb. 1 pemadaman (of lights). 2 pematian (of cigarette). 3 kepunahan, punahnya (of species).
extinguish	kkt. 1 memadamkan. to e. a flame memadamkan api. 2 mematikan. to e. the lights mematikan lampu.
extinguisher	kb. alat pemadam. fire e. alat pemadam api.
extol	kkt. memuji. to e. her beauty to the skies memuji kecantikannya setinggi langit.
extort	kkt. memeras. to e. money from s.o. memeras uang dari seseorang.
extortion	kb. pemerasan, penghisapan.
extortioner	kb. pemeras.
extortionist	kb. pemeras.
extra	kb. 1 edisi tambahan (of a newspaper). 2 film : figuran. -extras j. pengeluaran-pengeluaran tambahan. -ks. ekstra, tambahan. kk. istimewa.
extract	kb. sari, kutipan. -kkt. 1 mencabut (a tooth). 2 menyadap (sap from trees). 3 menyuling. 4 mengeduk, menggali. 5 memeras, memaksakan. e. of vinegar biang cuka.
extraction	kb.1 pencabutan (of tooth). 2 keturunan. of polish e. keturunan polandia.
extractive	ks. yang dikeduk/digali. e. industries industri yang menghasilkan bahan-bahan baku.
extracurricular	ks. diluar rencana pelajaran. e. activities aktivitas ekstrakurikuler
extradite	kkt. menyerahkan. to e. a prisoner to a neighboring state menyerahkan seorang tawanan kepada negara bagian tetangga.
extradition	kb. penyerahan tawanan.
extramural	ks. diluar sekolah. e. sports olahraga diluar sekolah.
extraneous	ks. 1 yang tak ada hubungannya. e. remarks ucapan-ucapan yang tak ada hubungannya. 2 asing (matter).
extraordinary	ks. luarbiasa. he has an e. capacity for food ia luar biasa kuatnya makan. extraordinarily kk. secara luar biasa. his remarks proved to be effective pernyataannya ternyata luarbiasa tepatnya.
extrapolate	kkt. kki. memperhitungkan/meramalkan kemungkinan. to e. from the reactions received meramalkan kemungkinan atas dasar reaksi-reaksi yang diterima.
extrapolation	kb. ramalan, perhitungan.
extrasensory	ks. diluar jangkauan/tanggapan normal pencaindra. e. perception tanggapan diluar pancaindra.
extraterritoriality	kb.keadaan atau hal mempunyai hak-hak ekstraterritorial.
extravagance	kb. 1 keroyalan, pemborosan. 2 yang berlebih-lebihan. the e. of some advertising beberapa periklanan yang berlebih-lebihan.
extravagant	ks. ks. boros, royal. 2 luarbiasa. 3 yang berlebih-lebihan (praise). -extravagantly kk. secara mewah sekali.
extravaganza	kb. pertunjukan (musik) yang hebat sekali.
extreme	kb. perbedaan yang besar. in the e. sangat, sungguh-sungguh. -ks. 1 ekstrim, ekstrem. 2 hebat sekali, bukan main/buatan. 3 keras. 4 bukan main. 5 tertinggi. e. penalty hukum mati. -extremely kk. luarbiasa, sekali.
extremist	kb. ekstremis.
extremity	kb. (j. -ties) 1 kaki dan tangan. his lower extremisties were burned kakinya terbakar. 2 kebutuhan yang sangat.
extricate	kkt. melepaskan. to e. a child from a fence melepaskan anak dari pagar.
extrovert	kb. orang yang mementingkan hal-hal lahir.
exuberance	kb. 1 kegembiraan yang besar sekali. 2 kesuburan, kerimbunan. e. of foliage kesuburan daun-daunan.
exuberant	ks.1 gembira sekali. 2 banyak sekali. 3 subur, rimbun.
exude	kkt. 1 memancarkan (confidence, sweetness). 2 menetes (sweat).
exult	kki. bersuka-ria. to e. in o's good fortune bersuka-ria karena bernasib baik.
exultant	ks. gembira, yang menunjukkan kegembiraan. e. shout sorak/seruan/teriakan gembira.
exultation	kb. kegembiraan yang meluap-luap.
eye	kb. mata. without batting an e. tanpa memejamkan sebelah matapun. -kkt. 1 memandang. 2 mempertimbangkan. eye-catching ks. menyolok, menarik (perhatian). e. opener 1 sesuatu yang tidak disangka-sangka. 2 yang menakjubkan.
eyeball	kb. biji/bola mata, mata-bola.
eyebrow	kb. alis mata. to raise an e. at s.t. heran ketika melihat atau mendengar sesuatu.
eyedropper	kb. (pompa) penetes mata.
eyeful	kb. sebanyak yang dapat dilihat oleh mata pada satu ketika. she presented quite an e. in her new outfit dia sedap, dipandang dalam pakaian barunya.
eyeglasses	kb. j. kacamata, tesmak.
eyelash	kb. bulumata. our team lost by an e. regu kami kalah tipis.
eyelet	kb. lubang tali (seperti pada sepatu).
eyelid	kb. kelopak mata.
eyepatch	kb. tutup mata.
eyepiece	kb. lensa mata. e. on a microscope lensa mata pada mikroskop.
eyeshade	eyeshade
eyesight	kb. penglihatan. to have good e. mempunyai penglihatan yang baik.
eyesore	kb. yang merusak pemandangan. that house is an e. rumah itu merusak pemandangan.
eyestrain	kb. kelelahan/ketegangan mata.
eyetooth	kb. gigi taring disebelah atas. to cut o's e. yang tidak hijau lagi, melampaui masa kekanak-kanakan.
eyewash	kb. obat cuci mata. sl.: what he said was pure e. apa yang dikatakannya itu omong kosong belaka.
eyewitness	kb. saksi mata, saksi yang melihat dengan mata sendiri. to give on e. account memberi laporan pandangan mata.
f	1[fahrenheit] fahrenheit. 2 [february] pebruari. 3 [fryday] jum'at. 4 [france] perancis. 5 [french] bahasa perancis. 6 [fellow] anggouta (terhormat.
f, f	kb. 1 huruf keenam pada abjad inggris. 2 penghargaan angka kurang pada pekerjaan sekolah. 3 titinada, huruf musik.
f.	[feminine] perempuan. 2 [florin] rupiah belanda. 3 [fluid] cairan.
f.o.b., f.o.b.	[free on board] harga sampai diatas alat pengangkutan. to buy a car f.o.b membeli oto dengan harga sampai diatas tempat pengangkutan.
faa	[federal aviation agency] jawatan penerbangan federal.
fable	kb. 1 dongeng perumpamaan. 2 bohong. -fabled ks. 1 yang banyak diceritakan dalam dongeng. 2 yang dibuat-buat.
fabric	kb. 1 barang tenunan, kain. sheer f. kain tipis. 2 susunan, struktur (of society)
fabricate	kkt. 1 membuat, membangun. 2 memalsukan, mengarang - ngarang.
fabrication	kb. 1 pembuatan, pembikinan. 2 pemalsuan. f. of reports laporan yang dibikin-bikin.
fabulous	ks. 1 hebat, menakjubkan. f. view pemandangan yang hebat. 2 besar. f. salary gaji yang luar biasa tingginya.
facade, facade	kb. 1 bagian muka dari suatu gedung. 2 tedeng aling-aling (terutama)kalau dianggap untuk menyembunyikan sesuatu kesalahan atau kelemahan.
face	kb. 1 muka, rupa, paras. 2 permukaan (of a cliff). 3 wajah. 4 keberanian. -kkt. 1 menghadapai. 2 menghadapkan muka, menghadap. 3 berhadapan (muka) dengan. -kki. menghadap. -facing kb. 1 bis, pinggiran. 2 lapisan (luar).
facecloth	kb.kain penyeka muka.
facedown	kk. to turn s.t. f. menelungkupkan/ meniarapkan sesuatu, sehingga mukanya berpaling kebawah.
facet	kb. 1 segi, sanding. facets of te problem segi-segimasalah itu. 2 permukaan (of a gem).
facetious	ks. secara berkelakar. f. remarks ucapan-ucapan jenaka.
facial	kb. masase muka. -kt. yang berhubungan dengan muka. f. expression ekspresi muka.
facile	ks. lancar. her f. nature tabiat yang lancar, sifatnya yang penurut.
facilitate	kkt. memudahkan.
facility	kb. (j. -ties) 1 fasilitas, kesempatan. 2 kecakapan. f. for languages kecakapan dalam bahasa-bahasa.
facsimile	kb. reproduksi, jiplakan. a reasonable f. sesuatu yang serupa dengan itu.
fact	kb. 1 fakta, kenyataan. 2 kebenaran. fact-finding kb. pencarian fakta.
faction	kb. golongan, kumpulan orang-orang dalam partai politik, gereja dsb.
factor	kb. faktor, unsur. a f. in his defeat faktor dalam kesalahannya.
factory	kb. (j. -ries) paberik.
factual	ks. yang mengandung atau berdasarkan fakta-fakta, yang sesungguhnya.
faculty	kb. (j. -ties) 1 staf pengajar disekolah (tinggi). 2 kemampuan, kecakapan. 3 pancaindera. 4 fakultas.
fad	kb. mode, iseng(-iseng). it's a f. hanya iseng saja.
faddist	kb. pengikut mode.
fade	kkt. memudarkan. -kki. 1 meluntur, menjadi pudar. 2 menghilang. 3 layu. to f. away 1 menjadi kabur, berangsur hilang. 2 mati, wafat. 3 menghilang, berangsur pergi. -fading kb. 1 kehilangan warna. 2 tv, tel.: kehilangan kekuatan suara atau gambar.
fadeproof	ks. tak/tahan luntur.
faeces	= feces.
fag	kb. ujung, akhir. f. end akhir ujung, sisa yang paling jelek. -kki. (fagged) inf.: to f. out meletihkan. i'm fagged out saya letih sekali.
faggot	kb. =fagot.
fagot	kb. berkas kayu api, seikat kayu bakar.
fahrenheit	kb. ukuran suhu atau termometer yang memakai skala fahrenheit.
fail	kb. without f. pasti, tentu. -kkt. 1 gagal/jatuh dalam. 2 meninggalkan, membiarkan. 3 menjatuhkan, tidak meluluskan.(a student). -kki. 1 lalai. 2 lupa. 3 menjadi rusak, gagal. -failing kb. kekurangan, kelemahan.
failure	kb. 1 kegagalan, pengabaian, pelalaian. 2 kerusakan, gangguan.
faint	kb. pingsan. -ks. 1 pusing. 2 redam, redup (of sounds). -kki. (jatuh) pingsan. -fainting ks. sedang/membikin pingsan. -faintly kk. sedikit.
fainthearted	ks. pengecut, penakut, tidak berani.
fair	kb. pekan raya, pasar malam. -ks. 1 kuning langsat, perang (of complexion). 2 terang. 3 adil. 4 cukup, wajar. 5 sedang, lumayan. 6 cantik. -fairly kk. 1 agak baik. 2 hampir.
fairground	kb. tempat, gelanggang pekan raya.
fairness	kb. kejujuran, keadilan, kewajaran. in all f. i must admit... dengan segala kejujuran saya harus mengakui....
fairway	kb. 1 nav.: aluran/jaluran pelayaran. 2 golf.: bagian dari lapangan golf antara tempat pemukulan bola golf pertama di tiap hole dan lapangan hijau.
fairy	kb. (j. -ries) peri. f. tale 1 cerita dongeng. 2 bohong.
fairyland	kb. tempat yang menyenangkan dan menarik.
fait accompli	kb. keadaan yang dihadapi, ketentuan yang harus diterima.
faith	kb. 1 kepercayaan. 2 agama, keyakinan. to act in bad f. berbuat tidak jujur. to keep f. with tetap setia kepada. f. healer ahli pengobatan dengan menggunakan kebatinan.
faithful	kb. the f. j. orang-orang yang beriman. -ks. 1 setia. 2 tepat. -faithfully kk. tepat. to promise f. berjanji tepat.
faithless	ks. 1 tidak setia. 2 rel.: tak percaya kepada agama, tanpa iman. 3 durhaka (of a wife).
fake	kb. 1 penipu. 2 gadungan, sesuatu yang palsu. -ks. palsu. f. bill uang kertas palsu. -kkt. 1 memalsukan. 2 berbuat seakan-akan, berpura-pura.
faker	kb. pemalsu, penipu.
fakir	kb. ahli sihir, seorang wali yang hidup mengemis.
falcon	kb. semacam burung elang yang dipergunakan untuk berburu.
fall	kb. 1 meteor.: musim gugur/rontok. 2 jatuh. 3 jatuhnya. 4 runtuhnya. 5 surut. 6 turunnya. 7 tingginya. -falls j. air terjun. -kki. (fell, fallen) 1 jatuh. 2 turun. 3 gugur. 4 melihat kebawah. fall-off kb. kemerosotan. falling-out kb. pertengkeran, sen
fallacious	ks. salah, keliru. f. statement pernyataan yang menyesatkan.
fallacy	kb. (j. -cies) buah pikiran yang keliru.
fallen	lih fall.
fallible	ks. dapat berbuat keliru/salah.
fallopian	ks. f. tubes saluran/pembuluh telur ke kandungan rahim.
fallout	kb. jatuhan (radioaktif). f. shelter lubang/ruang perlindungan dibawah tanah terhadap radioaktif.
fallow	ks. kosong, belum ditanami. to lie f. tandus.
false	ks. 1 palsu. 2 bohong. 3 tidak benar. 4 sumbang. f. colors 1 bendera palsu. 2 pembawaan diri yang dibikin-bikin. f. pretenses alasan-alasan palsu.
falsehood	kb. kebohongan, dusta.
falsetto	kb., ks. suara buatan bernada tinggi, suara tinggi yang tidak wajar.
falsies	kb., j. inf.: sumpalan, isi bh supaya buah dada kelihatan lebih montok
falsify	kkt. (falsified) memalsukan.
falsity	kb. (j. -ties) kepalsuan.
falter	kki. 1 bimbang. 2 terputus-putus. 3 berjalan bergoyang atau terhuyung, tertatih. -faltering ks. yang bergoyang, terhuyung. -falteringly kk. dengan terputus-putus, dengan gagap.
fame	kb. kemasyhuran, popularitas. to win f. menjadi tenar/terkenal. of ill f. yang mempunyai nama buruk.
famed	ks. terkenal, termasyhur, ternama.
familial	ks. yang berhubungan dengan keluarga. f. relationship hubungan keluarga.
familiar	ks. 1 terkenal, dikenal. 2 akrab. 3 yang sudah lazim.
familiarity	kb. (j. -ties) 1 keakraban, kebiasaan. f. breeds contempt keakraban menimbulkan benih kebencian / rasa kurang hormat. 2 hal mengetahui.
familiarize	kkt. to f. 0.s. with membiasakan diri dengan mempelajari supaya mengenal.
family	kb. (j. -lies) 1 keluarga. the human f. keluarga manusia 2 rumpun. f. of languages rumpun bahasa. family - size ks. yang dapat memuat seluruh keluarga, cukup untuk seluruh keluarga. family-style ks. gaya yang disukai atau cocok untuk seluruh keluarga.
famine	kb. kelaparan.
famished	ks. sangat lapar. i'm f. saya sangat lapar.
famous	ks. terkenal, termasyhur, tersohor, kenamaan (for sebagai/akan).
fan	kb. kipas (angin). 2 penggemar. -kkt. (fanned) 1 mengipas (a fire). 2 mengusir dengan kipas. 3 memperbesar, menghembus.
fanatic	kb. seorang yang fanatik. -ks. fanatik.
fanatical	ks. secara fanatik. to be f. on fanatik dalam, keranjingan yang berlebih-lebihan.
fanatisicm	kb. fanatisme.
fancier	kb. 1 penggemar. 2 pemelihara (of dogs, birds, etc.) 3 lih fancy.
fanciful	ks. 1 aneh, fantastis. 2 khayal. f. writer penulis cerita-cerita khayal, penulis yang penuh daya khayal.
fancy	kb. (j. -cies) 1 khayalan, fantasi. 2 kesukaan. 3 angan-angan. -ks. (fancier, fanciest) 1 tinggi. 2 indah. -kkt. (fancied) 1 mengkhayalkan, membayangkan. 2 mengira. 3 menyukai. 4 berangan-angan. -fancied ks. yang dikhayalkan.
fancywork	kb. pekerjaan jahitan indah seperti sulaman dsb.
fanfare	kb. 1 keriuhan di pawai, pawai yang riuh. 2 mus.: musik yang dimainkan oleh terompet-terompet. without f. tanpa gembar-gembor.
fang	kb. kb. 1 gigi taring. 2 gigi anjing, ular, dsb.
fanny	kb. (j. -nies) sl.: pantat, bokong.
fantail	kb. 1 ekor/ujung/bagian yang melebar seperti kipas yang terbuka. 2 nav.: bagian buritan yang terletak diatas air dikapal.
fantastic	ks. 1 fantastik, luar biasa. f. story cerita yang luar biasa. 2 inf.: sangat / amat tinggi. f. price harga yang amat tinggi. 3 tak masuk akal.
fantasy	kb. (j. -nies) fantasi, khayalan, lamunan.
far	ks. (farther, farthest). paling ujung. -kk. jauh. far better jauh lebih baik. far-flung ks. luas sekali. far-off ks. jauh sekali. far -out ks. aneh sekali, sangat menyimpang dari yang biasa. far-ranging ks. luas. far-seeing ks. bijaksana.
faraway	ks. 1 jauh. f. places tempat-tempat yang jauh. 2 bersifat melamun.
farce	kb. 1 pertunjukan jenaka. 2 sandiwara pelawak/lelucon.
farcical	ks. lucu, jenaka, yang menggelikan hati.
fare	kb. 1 ongkos/biaya perjalanan, ongkos/harga karcis. 2 makanan (at a restaurant, boarding house). 3 penumpang (in taxi). -kki. berjalan, bepergian. to f. well 1 berjalan baik. 2 kenyang makan.
farewell	kb. ucapan selamat (jalan). -kseru. f.! selamat jalan ! to bid f. to s.o. mengucapkan selamat jalan kepada seseorang.
farm	kb. kebun, perkebunan, rumah dan ladang, tanah pertanian, usaha tani -kkt. bercocok tanam, menanami tanah. -kki. bertani. -farming kb. pertanian. f. community masyarakat petani.
farmer	kb. petani, orang tani.
farmhouse	kb. rumah petani.
farmland	kb. tanah pertanian.
farmstead	kb. tanah beserta rumah-rumah pertanian.
farmworker	kb. buruh tani, pekerja pertanian.
farmyard	kb. halaman pertanian, pekarangan rumah petani.
fart	kb. vulg.: kentut, angin busuk. -kki. berkentut.
farther	kk. lih far. lebih jauh. i can't go any f. saya tak bisa pergi lebih jauh.
farthermost	ks. yang paling jauh.
farthest	ks. lih far. paling jauh, terjauh. the f. corner of the yard pelosok terjauh di halaman.
fasc.	[fascicle] untai(an), lembaran, jilid.
fascinate	kkt. mengagumkan, mempesonakan. his skill fascinates me kecakapannya mengagumkan saya. fascinating ks. sangat menarik, mempesonakan. f. story cerita yang sangat menarik.
fascination	kb. pesona, daya tarik yang sangat kuat. he has a real f. for that girl gadis itu betul-betul terpesona olehnya.
fascism	kb. fasisme.
fascist	kb. seorang fasis.
fashion	kb. cara, kebiasaan, basa-basi. 2 mode. fashion- conscious ks. memperhatikan mode. f. designer pencipta mode. f. plate. a) gambar pola pakaian menurut mode terakhir. b) orang yang mengikuti mode terbaru. -kkt. menciptakan/ membuat.
fashionable	ks. 1 modern, sesuai dengan mode terakhir. 2 menjadi kebiasaan yang baik. -fashionably kk. yang sesuai dengan mode terakhir.
fast	kb. puasa, saum. -kki. berpuasa. -ks. 1 cepat. 2 karib, erat, akrab (of a friend). 3 tahan cuci. 4 bebas. -kk. 1 cepat. 2 teguh. fast-moving ks. yang cepat lajunya, yang berjalan/ bergerak cepat. fast-stepping ks. maju/melangkah dengan cepat.
fasten	kkt. 1 mengikatkan. 2 memasang. 3 mengaitkan, mengunci. 4 mengancingkan. -kki. to f. upon mengaitkan pada. -fastening kb. pengikat, (alat) pengunci, pengancing.
fastener	kb. 1 alat pengunci. a lock is a common f. kunci adalah alat pengunci yang umum. 2 pengancing. a zipper is a useful f. resleting adalah pengancing yang berguna.
fastidious	ks. terlalu berpilih-pilih, tidak mudah puas, sangat kritis, cerewet, rewel.
fastness	kb. 1 kecepatan. 2 kubu, benteng. mountain f. benteng pegunungan.
fat	kb. gemuk, lemak. -ks. 1 gemuk, tambun. 2 banyak, besar. 3 sl.: kecil, sedikit.
fatal	ks. 1 yang menimbulkan kematian, yang membunuh, yang membawa maut, yang menewaskan. 2 yang menimbulkan bencana. 3 penting, yang menentukan. -fatally kk. dalam keadaan yang menuju ke kematian.
fatalism	kb. fatalisme, kepercayaan bahwa nasib menguasai segala-galanya.
fatalist	kb. fatalis.
fatalistic	ks. fatalistis.
fatality	kb.(j. -ties) kematian.
fate	kb. nasib, takdir. by the irony of f. secara kebetulan.
fated	ks. ditakdirkan. we were f. to marry kami ditakdirkan untuk kawin.
fateful	ks. amat penting. that f. day hari yang amat penting itu, hari yang menentukan itu.
fathead	sl.: kb. orang tolol/bodoh/dungu.
father	kb. 1 bapak, ayah. 2 theol.: pendeta, paderi. 3 theol.: sang ayah/bapa. -kkt. 1 menjadi ayah. 2 berlaku sebagai ayah. father-in-law (j. fathers-in-law) mertua laki-laki, bapak mertua. father's day hari bapak.
fatherhood	kb. hal menjadi bapak, keayahan.
fatherland	kb. tanah air.
fatherless	ks. 1 tanpa ayah. 2 anak zina, yatim.
fatherly	ks. yang berhubungan dengan ayah. he has a f. manner ia bersifat kebapa-bapaan. f. advice nasihat dari seorang bapak.
fathom	kb. depa. -kkt. 1 mengukur. to f. the ocean mengukur dalamnya samudera. 2 mengerti. he's hard to f. ia sukar dimengerti.
fathomless	ks. tak dapat diduga/diukur (mis. dalamnya laut).
fatigue	kb. kepenatan, kelelahan, keletihan. he is suffering from f. dia sakit karena terlalu lelah. -kkt. menghabiskan tenaga, melelahkan. f. clothes, fatigues j. pakaian (kerja, korpe). -fatiguing ks. melelahkan.
fatness	kb. kegemukan.
fatted	ks. yang telah digemukkan.
fatten	kkt. menggemukkan. to f. up menggemukkan. -fattening ks. yang menggemukkan.
fatty	ks. gemuk. f. tissue jaringan lemak.
fatuous	ks. tolol, bodoh, dungu. f. smile senyuman tolol.
faucet	kb. k(e)ran.
fault	kb. 1 kesalahan, salah. 2 kekurangan. 3 sifat (yang buruk). -kkt. menyalahkan. i can't f. him for forgetting saya tak dapat menyalahkan karena ia lupa.
faultfinder	kb. seorang yang rewel, seorang yang selalu menemukan kesalahan-kesalahan.
faultfinding	kb. bawel, cerewet.
faultless	ks. tak ada cacadnya, sempurna. -faultlessly kk. sangat rapi, tanpa cacad. f. dressed berpakaian sangat rapi.
faulty	ks. salah, cacad. f. brakes rem cacad, rem yang tidak makan.
fauna	kb. 1 bintang-bintang di suatu daerah atau pada suatu waktu. 2 dunia binatang.
faux pas	kb. 1 kesalahan dalam berbicara/tindakan. to commit a f. melakukan kesalahan, melanggar tatacara. 2 kecerobohan.
favor	kb. 1 kemurahan/kebaikan hati. 2 hadiah, tanda-mata. 3 surat. 4 tolong. -kkt. 1 menyokong. 2 berlaku berhati-hati. 3 menyerupai. 4 memperlakukan lebih baik daripada yang lain-lain. 5 menyukai/lebih suka 6 berbaik/bermurah hati. -favored ks. kesayangan.
favorable	ks. baik. 2 baik, menyenangkan, menguntungkan. -favorably kk. baik, menguntungkan, menyenangkan.
favorite	kb. favorit, kesayangan. -ks. kesayangan, kesukaan. f. son a) anak mas, anak lelaki kesayangan. b) (di a.s.) tokoh politik yang diajukan sebagai calon presiden.
favoritism	kb. sikap/tindakan memilih-milih orang yang menjadi kesayangan, sikap pilih-kasih, sikap pilih bulu.
fawn	kb. anak rusa. -kki. to f. (up)on 1 menjilat, bertingkah laku yang bersifat membudak. 2 mengibas-ngibaskan ekor kepada (of dog).
faxe	kkt. mengganggu. the bad news did not f. him kabar buruk itu tak mengganggunya.
fbi, f.b.i.	[federal bureau of investigation] biro penyelidikan federal.
fcc, f.c.c.	kb. [federal communications commission] panitia perhubungan federal.
fear	kb. 1 ketakutan, rasa takut. 2 kekhawatiran. -kkt. 1 takut, kuatir. 2 kira, kuatir. -kki. to f. for kekhawatiran akan.
fearful	ks. 1 takut. she is f. of loasing her ring ia takut kehilangan cincinnya 2 menakutkan. f. sight pemandangan yang menakutkan. -fearfully kk. terlalu amat, sangat. f. bad headache sakit kepala yang amat berat.
fearless	ks. tidak takut/gentar, tak kenal takut.
fearsome	ks. yang menakutkan. f. sight pemandangan yang menakutkan.
feasibility	kb. kemungkinan terjadi/dikerjakan.
feasible	ks. mungkin, dapat dikerjakan dengan mudah. it isn't f. you to be away now tidak ada kemungkinan bagimu untuk pergi sekarang.
feast	kb. pesta, makan besar. f. day hari besar/raya. -kkt. menyenangkan diri sendiri. -kki. mengadakan pesta.
feat	kb. 1 prestasi. f. of strength prestasi kekuatan. 2 perbuatan. tremendous f. perbuatan yang hebat sekali.
feather	kb. bulu. a f. in o's cap suatu kehormatan bagi seseorang. -kkt. av.: memutar daun baling-baling. f. bed kasur dari bulu. -feathered ks. berbulu. our f. friends burung, unggas.
featherbed	kki. mempekerjakan lebih banyak buruh daripada yang diperlukan.
featherbrained	ks. tolol, dungu, bodoh.
featherweight	kb. kelas bulu (tinju).
feature	kb. 1 roman. 2 keistimewaan, segi. 3 film utama. 4 ciri-ciri. -kkt. mengutamakan, menonjolkan. feature-length ks. sepanjang tajuk karangan. -featured ks. yang diutamakan.
feb.	[february] pebruari.
feces	kb., j. tahi, berak, kotoran, tinja.
fecund	ks. produktif, subur.
fed	lih feed.
fed.	[federal] federal.
federal, federal	ks. federal. f. government pemerintahan federal.
federation	kb. federasi.
fee	kb. biaya, ongkos, bayaran. dentist's f. ongkos bayaran seorang dokter gigi. 2 uang (pembayaran).
feeble	ks. 1 lemah. 2 sayup, lemah. 3 suram, remang-remang. feeble - minded ks. lemah pikiran. -feebly kk. dengan lemah.
feebleness	kb. kelemahan.
feed	kb. makanan. -kkt. (fed) 1 memberi makanan. 2 menjadi makanan. -feeding kb. pemberian makanan.
feedback	kb. 1 skakelar arus balik. 2 pengaruh arus-balik.
feedbag	kb. kantung makanan (untuk kuda). sl.: to put on the f. (mulai) makan.
feeder	kb. 1 orang yang memberi makanan kepada binatang. 2 tempat makanan binatang. 3 pembantu. 4 pengisi.
feel	kb. rasa, rabaan, sentuhan. -kkt. (felt) 1 meraba. 2 merasa. -kki. 1 merasa. 2 kira, pikir. -feeling kb. 1 perasaan. 2 daya perasaan -feelings j. perasaan. -feelingly kk. dengan penuh perasaan/semangat.
feeler	kb. 1 (insers) peraba, tanduk perasa. 2 penyelidikan. 3 penjajag.
feet	lih foot.
feign	kkt. berpura-pura. to f. illness berpura-pura sakit. -feigned ks. dibuat-buat, pura-pura. f. politeness sopan sanrtun yang dibuat-buat.
feint	kb. pukulan pura-pura. -kki. membuat gerakan pura-pura.
felicitate	kkt. mengucapkan selamat. we f. you on your 21st birthday kami mengucapkan selamat atas hari ulang tahunmu yang ke-21.
felicitation	kb. ucapan selamat.
felicitous	ks. sangat tepat, sangat baik, sangat pada tempatnya. f. remarks kata-kata/ucapan-ucapan yang sangat tepat.
felicity	kb. (j. -ties) kebahagiaan (yang besar).
feline	kb. binatang termasuk keluarga kucing. -ks. seperti kucing. to walk with f. grace berjalan dengan gaya lembut seperti kucing.
fell	kkt. menebang (a tree). he was felled by a tree ia jatuh/rubuh tertimpa pohon. lih fall.
fella	kb. sl.: kawan, bung. how're ya. f.? apa kabar, bung ?
fellow	kb. 1 orang laki-laki. 2 kawan, orang, anak. 3 anggota. 4 mahasiswa tingkat doktoral yang menerima beasiswa. f. worker teman/rekan sekerja.
fellowship	kb. persahabatan. 2 acad.: beasiswa.
felon	kb. penjahat, narapidana.
felonious	ks. jahat, kejam. f. homicide pembunuhan yang kejam.
felony	kb. (j. -nies) kejahatan, tindak-pidana yang tergolong berat.
felt	kb. lakan, bulu kempa. lih feel.
fem.	[feminine] 1 wanita, perempuan. 2 betina (of animals).
female	kb. 1 wanita, perempuan. 2 betina. that dog a f. anjing itu betina. -ks. wanita, perempuan. f. companion teman wanita.
feminine	ks. dari atau berhubungan dengan gadis atau wanita.
femininity	kb. kewanitaan.
feminisme	kb. feminisme, keadaan kewanitaan.
feminist	kb. pejuang hak-hak wanita.
femoral	ks. dari atau berhubungan dengan tulang paha. f. artery pembuluh nadi paha.
femur	kb. tulang paha.
fence	kb. 1 pagar. 2 (receiver or stolen goods) tukang tadah. -kkt. memagari. -kki. bermain anggar. fence-sitter orang, golongan atau negara yang tidak berpihak. -fence-straddling kb. (ber)sikap netral -fencing kb. olahraga anggar.
fencer	kb. pemain anggar.
fend	kkt. menolak, menangkis. to f. off blows menangkis pukulan-pukulan. -kki. menjaga diri. to f. for myself menjaga diri saya sendiri.
fender	kb. spatbor, sayap recik/roda.
fennel	kb. adas.
ferment	kb. keadaan meragi. -kki. beragi, meragi. the cider fermented air apel itu meragi.
fermentation	kb. peragian, fermentasi
fern	kb. pakis, paku.
ferocious	ks. 1 ganas, buas, garang. 2 galak (of a dog).
ferocity	kb. (j. -ties) keganasan, kebuasan, kegarangan. the f. of the wind keganasan angin.
ferret	kb. semacam musang yang telah dijinakkan dan dipakai untuk membunuh tikus-tikus atau berburu kelinci. -kkt. to f. out menguber-uber, menemukan.
ferric	ks. f acid asam besi.
ferris	kb. f. wheel kincir ria.
ferrous	ks. f. sulfide besi belerang.
ferry	kb. (j. -ries) 1 perahu/kapal tambang, tambangan. 2 menerbangkan pesawat udara untuk diserahkan kepada yang membeli. -kkt. menambangkan.
ferryboat	kb. perahu/kapal tambang.
ferryman	kb. (j. -men) tukang tambang.
fertile	ks. 1 subur. f. mind pikiran yang subur. 2 yang dibuahi. f. egg. telur yang dibuahi.
fertility	kb. kesuburan.
fertilization	kb. 1 perabukan, pemupukan. 2 penghamilan, pembuahan (of an egg).
fertilize	kkt. 1 merabuk, memupuk (soil, yard). 2 membuahi (an egg).
fertilizer	kb. pupuk, rabuk.
fervent	ks. kuat, keras, sungguh-sungguh. -ferventely kk. dengan kuat, dengan sangat.
fervor	kb. kegairahan, semangat.
fess	kki. sl.: to f. up mengaku. the little boy fessed up that... anak kecil itu mengaku bahwa...
fester	kki. 1 bernanah. 2 membusuk, memburuk. don't let your hate f. jangan biarkan rasa bencimu itu memburuk.
festival	kb. pesta (perayaan). water f. pesta air. f. atmosfphere suasana perayaan/pesta.
festive	ks. dari atau berhubungan dengan pesta. in a f. mood dalam suasana pesta.
festivity	kb. (j. -ties) pesta-pesta, pesta ria, perayaan.
festoon	kkt. memperhias, menghias (dengan rangkaian bunga yang bergantung).
fetal	ks. yang berhubungan dengan janin.
fetch	kkt. 1 mengambil(kan). 2 menjemput. 3 mencapai, mendapat, memperoleh. fetching ks. yang menarik. f. dress pakaian (wanita yang menarik).
fete, fete	kb. pesta (raya), jamuan. -kkt. menjamu. he was feted on the occasion of the award dia dijamu meriah pada peristiwa pemberian hadiah itu.
fetid	ks. berbau-busuk, kohong.
fetish	kb. 1 jimat. 2 pemjaan yang mutlak/mendalam.
fetter	kb. 1 (shackle) belenggu. 2 kekangan-kekangan. -kkt. mengikat, membelenggu.
fettle	kb. keadaan. in fine f. dalam keadaan baik. baik.
fetus	kb. janin.
feud	kb. permusuhan, perseteruan, kasemat.
feudal	ks. feodal.
feudalism	kb. feodalisme.
fever	kb. demam. to run a f. sakit demam.
fevered	ks. 1 hangat, penuh kegelisahan. 2 panas. f. brow dahi yang panas.
feverish	ks. mendemam. -feverishly kk. bergesa-gesa, tergesa-gesa, keburu-buru, lekas-lekas.
few	kb. golongan kecil. 2 sedikit, beberapa orang. -ks. beberapa. f. and far between jarang sekali.
fex	kb. kopiah, tarbus.
fiance, fiance	kb. tunangan (lelaki).
fiancee, fiancee	kb. tunangan (wanita).
fiasco	kb. kegagalan.
fib	kb. kebohongan, kedustaan. to tell a f. (ber)bohong. -kki. (fibbed) berbohong, membohong.
fiber	kb. 1 serabut, serat. rope f. serabut tali. 2 urat. muscle f. urat otot.
fiberboard	kb. papan serat.
fiberglass	kb. serat gelas, kaca-serat.
fibre	kb. = fiber.
fibrous	ks. bersabut, berserat, berbenang- benang, berserabut.
fibula	kb. tulang betis.
fickle	ks. berubah-ubah, tidak tetap, plin-plan. a f. girl seorang gadis yang pikirannya berubah-ubah.
fiction	kb. 1 fiksi, cerita rekaan. 2 khayalan. the "average" american is a f. yang disebut orang amerika "pukul rata" hanya khayalan saja.
fictional	ks. (bersifat) khayal.
fictitious	ks. 1 khayalan. 2 samaran. 3 yang dibuat-buat.
fiddle	kb. inf.: 1 biola. 2 (indonesian) rebab. -kkt. menggesek(kan). to f. with memainkan.
fiddle-de-dee	kseru. omong kosong.
fiddle-faddle	kki. inf.: menghabis-habiskan waktu dengan hal remeh.
fiddler	kb. pemain biola.
fiddlestick	kb. inf.: penggesek biola. -fiddlesticks kseru. j. omong kosong.
fidelity	kb. (j. -ties) 1 kesetiaan, ketaatan. 2 kejituan, kebenaran. high. f. recording perekaman yang sangat teliti dan murni.
fidget	kb. keadaan/perasaan gelisah. to give s.o. the fidgets memberikan seseorang kegelisahan, membuat seseorang gelisah. -kki. menjadi gelisah.
fidgetiness	kb. keresahan, kegelisahan.
fidgety	ks. gelisah, tidak tenang, resah.
fiduciary	kb., ks. (j. -ries) gadai(an).f. possession milik gadaian.
field	kb. 1 ladang, tanah lapang, padang. 2 lapangan, bidang. 3 medan, alun-alun. 4 dasar. -kkt. 1 menjawab dengan tangkas. 2 menangkap dan mengembalikan bola. (baseball).
fiend	kb. setan, iblis. you f.! persetan kau!
fiendish	kb. jahat dan kejam. f. look pandangan buas.
fierce	ks. 1 sengit, hangat, dahsyat. f. argument perdebatan sengit. 2 galak. f. animal binatang yang galak. 3 terik. f. heat panas yang terik. -fiercely kk. dengan ganas/dahsyat. we were f. attacked kami diserang dengan hebat.
fierceness	kb. keganasan, kebuasan. the f. of the attack a) keganasan kedahsyatan serangan/terkaman seekor binatang buas liar. b) (by a political opponent) kehebatan serangan (seorang lawan politik).
fiery	ks. 1 berapi-api. f. lecture ceramah yang berapi-api. 2 pedas. f. sauce f. kuah yang pedas.
fiesta	kb. pesta.
fife	kb. suling, seruling, serunai.
fifteen	kb., ks. lima belas.
fifteenth	ks. yang kelima belas. the f. of march tanggal lima belas maret.
fifth	kb. 1 = 1/5 gallon setakaran) (minuman keras). 2 seperlima. -ks. yang kelima. f. wheel barang orang yang tak diperlukan. -fifthly kk. (yang) kelima.
fiftieth	ks. yang kelima puluh.
fifty	kb. (j. -ties) lima puluh. to go fifty-fifty masing-masing separuh. -fifties j. sekitar lima-puluhan.
fig	kb. ara. f. leaf daun ara.
fig.	[figure] gambar.
fight	kb. 1 perkelahian, pertengkaran, pertarungan. 2 box.: pertandingan tinju. -kkt. 1 berjuang melawan. 2 memerangan, mengalahkan. 3 memperjuangkan. 4 meninju, beradu tinju dengan. 5 berkelahi dengan. -fighting kb. perkelahian. ks. berjuang.
fighter	kb. 1 pejuang (for a cause, an idea) 2 box.: petinju. 3 av.: pesawat tempur.
figment	kb. isapan jempol. f. of my imagination kilasan khayalan saya.
figurative	ks. bersifat perlambang atau kiasan. -figuratively kk. beribarat, mengandung ibaratsecara kiasan. f. speaking beribarat.
figure	kb. 1 bentuk badan. 2 bilangan, angka. 3 jumlah, bilangan. 4 tokoh. 5 gambar. 6 harga. -figures j. ilmu hitung. -kkt. 1 menghitung, menjumlahkan. 2membayangkan. -kki. 1 berhitung. 2 inf.: kira. 3 terdapat, tertera. -figured ks. bergambar.
figurehead	kb. bukan pemimpin sungguh - sungguh, pemimpin namanya saja, boneka.
figurine	kb. arca/patung kecil.
filament	kb. kawat pijar.
filch	kkt. mencuri (secara kecil-kecilan). to f. candy from a jar mencuri gula-gula dari stoples.
file	kb. 1 arsip, catatan, berkas. 2 tempat surat. 3 berkas catatan - catatan, bundel surat-surat. 4 kikir. 5 baris. -files j. perkintalan, arsip. -kkt. 1 menyimpan. 2 mengajukan. 3 mengikir. 4 menurunkan. 5 memangur, mematar.
filer	kb. 1 tukang kikir. 2 juru arsip.
filet	kb. = fillet. f. mignon daging sapi (bagian belakang) yang tebal dan empuk.
filial	ks. yang berhubungan dengan anak laki-laki atau anak perempuan. f. affection kasih-sayang anak.
filibuster	kb. usaha menggagalkan penetapan undang-undang dengan pidato-pidato yang amat panjang dan tak habis-habis. -kki. berusaha menggagalkan penetapan undang-undang dengan pidato-pidato yang amat panjang.
filifies	lih vilify.
filigree	kb. barang perhiasan dari benang mas yang sangat halus.
filipino	kb. orang filipina.
fill	kb. tanah dan kerikil pengisi (untuk kereta api, jalan raya). -kkt. 1 mengisi. 2 memenuhi, mengisi. 3 memenuhi, melayani. 4 membuat. 5 menempati, 6 menambal (a tooth). -kki. diisi, terisi. fill-in kb. 1 pengganti. 2 keterangan-keterangan data-data.
fillagree	kb. = filigree.
filler	kb. 1 pengisi. f. for s looseleaf notebook lembaran-lembaran kertas untuk mengisi buku catatan yang memakai kertas-kertas lepas. 2 news : berita-berita pendek pengisi (halaman) surat kabar.
fillet	kb. potongan tipis daging yang tak bertulang. f. of fish daging ikan yang tak bertulang.
fillip	kb. perangsang, penyegar. lime juice gives an added f. to this drink air jeruk menjadikan minuman ini bertambah segar/lebih menyegarkan.
filly	kb. (j. -lies) 1 ( horse) anak kuda betina. 2 seorang gadis yang lincah.
film	kb. 1 pilem. 2 lapisan tipis ganggang / lumut (on a pond). 3 selaput. 4 lapisan pada gigi (on the teeth). -kkt. mempilem, membuat pilem. -kki.
filmgoer	kb. penonton bioskop, pengunjung pilem.
filmstrip	kb. rentetan foto di pilem.
filter	kb. 1 saringan. 2 penapis, tapisan. 3 penyaring. -kkt. menyaring, menapis (water, oil). -kki. merembes. f. cigarette sigaret filter, sigaret pakai saringan. f. tip 1 pangkal penyaring. 2 sigaret pakai saringan.
filth	kb. 1 kotoran, sampah. 2 kecemaran, kemesuman, cabul, porno. 3 (of animals) najis.
filthiness	kb. 1 kekotoran. 2 kecabulan, kemesuman.
filthy	ks. 1 kotor, dekil. her hands were f. tangannya kotor. 2 mesum, cabul, ceroboh. f. magazines majalah-majalah cabul.
fin	kb. 1 sirip (of fish). 2 sirip-sirip karet (of swimmers).
finagle	kkt. mendapatkan (dengan kecerdikan atau menipu). to try to f. s.t. extra berusaha (dengan cara licik) untuk mendapatkan sesuatu sebagai tambahan.
final	kb. finals j. 1 acad.: penamatan sekolah, hari wisuda. 2 acad.: ujian terakhir. 3 sport : pertandingan terakhir, finale. -ks. 1 terakhir. 2 menentukan. 3 penghabisan. 4 keras hati. -finaly kk. akhirnya.
finale	kb. 1 penutup, finale. 2 babak wasana/mutakhir, bagian terakhir dari musik atau sandiwara.
finalist	kb. orang finalis.
finalize	kkt. mematangkan, menyelesaikan, mengakhiri, membereskan. to f. plans for menyelesaikan rencana-rencana untuk.
finance	kb. keuangan. -kki. 1 membiayai, membelanjai. 2 membayar. f. company perusahaan pemberi kredit. -financing kb. pembelanjaan, pembiayaan.
financial	ks. finansiil, yang berhubungan dengan keuangan. f. difficulties kesulitan keuangan. -financially kk. mengenai soal-soal keuangan, dalam soal keuangan.
financier	kb. pembiaya, yang memberi modal, ahli keuangan, modalwan.
finch	kb. semacam kutilang (jenis burung penyanyi).
find	kb. penemuan. -kkt. (found) 1 menemukan. 2 mendapati. 3 mengenai. 4 mendapatkan. 5 merasa(kan). 6 mengetahui. 7 melihat. -finding kb. 1 penemuan, pendapatan. 2 kesimpulan (of a report). 3 keputusan (of a jury). 4 temuan.
finder	kb. penemu. range f. pengukur jarak.
fine	kb. law : denda. -ks. 1 sangat baik, bagus. 2 runcing, halus (of a pen point). 3 menyenangkan. 4 halus. 5 tajam. -kk. 1 baik. 2 enak.-kkt. mendenda. fine-cut ks. rajangan / racikan halus. fine-grained ks. berjaringan halus. -finely kk. dengan halus.
fineness	kb. 1 kehalusan (of wire, thread, steel) 2 keindahan, kebagusan. 3 ketajaman, keruncingan (of a needle).
finery	kb. (j. -ries) 1 dandanan, pakaian bagus. 2 perhiasan.
finesse	kb. 1 kecakapan, kecerdikan, kecekatan, kemahiran. 2 bridge : muslihat. -kki. bridge : mempergunakan siasat.
finger	kb. jari. inf.: to have a f. in the pie ikut campur, turut mengambil bagian. -kkt. menyentuh. -fingering kb. mus.: main jari, cara memainkan jari.
fingernail	kb. kuku tangan/jari.
fingerprint	kb. sidik jari. -kkt. mengambil sidik jari.
fingertip	kb. ujung jari. to have the information at his fingertips mengenal keterangan-keterangan yang segera dapat dipergunakan.
finicky	ks. rewel. he is awfully f. about what he eats dalam hal makanan ia sangat rewel.
finis	kb. akhir, kesudahan.
finish	kb. akhir, penghabisan. 2 cat penutup, politur. 3 kesempurnaan. 4 lapisan penutup. -kkt. 1 menyelesaikan, menyudahi. 2 menghabiskan. 3 menghaluskan (wood). 4 tutup. -kki. 1 selesai. 2 menamatkan. -finished ks. selesai. -finishing ks. terakhir.
finite	ks. terbatas. f. number bilangan terbatas.
finland	kb. finlandia.
finn	kb. orang finlandia.
finnish	kb. bahasa finlandia. -ks. yang berhubungan dengan finlandia. the f. language bahasa finlandia.
fir	kb. semacam pohon cemara.
fire	kb. 1 api. 2 (api) kebakaran. -kkt. 1 menembakkan (a gun, torpedo). 2 memecat. 3 menyalakan (a furnace). -kki. berbunyi, meletus. -firing kb. 1 penembakan. 2 pemecatan (discharge). 3 pembakaran.
firearm	kb. senjata api.
fireball	kb. 1 bola api. 2 inf.: seorang yang mempunyai semangat yang luar biasa besarnya, seorang yang penuh gairah. he's a real f. dia sungguh hebat. dia bersemangat.
fireboat	kb. kapal pemadam kebakaran.
firebomb	kb. bom api/pembakar.
firebox	kb. tungku, perapian.
firebrand	kb. 1 puntung berapi. 2 pengasut.
firebug	kb. inf.: pembakar (rumah, gedung).
firecracker	kb. mercon, petasan.
firefighter	kb. seorang pemadam kebakaran.
firefly	kb. (j. -lies) kunang-kunang.
firehouse	kb gedung jawatan pemadam kebakaran, pos kebakaran.
fireless	ks. tanpa api. f. cooker panci listrik.
fireman	kb. (j. -men) 1 rr.: tukang api, setoker. 2 anggota pemadam kebakaran. f. 's knot simpul penolong.
fireplace	kb. perapian, tungku.
firepower	kb. daya tembak.
fireproof	ks. tahan api. f. point cat penahan api. -kkt. membuat tahan api.
firer	kb. 1 penembak (of a gun). 2 pemecat (of personnel).
fireside	kb. tempat duduk di muka perapian.
firetrap	kb. gedung yang mudah terbakar. that building is a f. gedung itu mudah terbakar.
firewarden	kb. penjabat pemadam kebakaran yang bertanggung jawab di satu daerah.
firewater	kb. sl.: minuman keras.
firewood	kb. kayu bakar.
fireworks	kb., j. mercon, petasan, kembang api. inf.: when she found her husband with another woman, there were f. ketika diketahuinya suaminya bersama dgn wanita lain, meledaklah pertengkaran hebat.
firm	kb. perusahaan, firma. -ks. 1 tetap, tegap. 2 tegas. 3 akrab. 4 kokoh, kuat. 5 teguh. 6 keras (of breast). -kk. 1 kuat. 2 tetap tabah. -firmly kk. 1 benar-benar, sungguh. 2 rapat-rapat. 3 dengan kuat.
firmament	kb. cakrawala.
first	kb. 1 hadiah pertama. 2 auto.: persneling satu. 3 yang terbagus, berkwalitas paling baik. -ks. 1 yang pertama. 2 satu. 3 yang pertama - tama.-kk. 1 pertama-tama. 2 dulu(an) terdahulu. -first-string ks. dari pertama, ulung, baik sekali. -firstly
fiscal	ks. yang berhubungan dengan keuangan. f. policy politik keuangan. f. year tahun pembukuan.
fish	kb. ikan. -kkt. mengambil, merogoh. -kki. mengail. to f. out 1 menangkap ikan sampai habis. 2 mendapat keterangan dengan bertanya hati - hati. -fishing kb. pemancingan, pengailan, penangkapan ikan.
fishbone	kb., tulang ikan.
fisherman	kb. (j. -men) nelayan.
fishery	kb. (j. -ries) 1 industri penangkapan ikan. 2 perikanan. bureau of fisheries jawatan perikanan.
fishhook	kb. mata kail, pancing.
fishpond	kb. kolam ikan.
fishworm	kb. cacing pengail, umpan.
fishy	ks. 1 amis. the kitchen smells f. dapur itu amis baunya. 2 inf.: mencurigakan. there is s.t. f. about the affair ada sesuatu yang mencurigakan dalam peristiwa itu.
fission	kb. 1 pembelahan, pembagian (sel). 2 nucl.: pemecahan.
fissure	kb. celah, belahan, retak(an).
fist	kb. tinju, kepalan tangan. f. fight baku hantam.
fistful	kb. segenggam.
fisticuffs	kb.,j. adu/main tinju, baku hantam.
fistula	kb. med.: hiliran.
fit	kb. 1 serangan tiba-tiba. 2 pas. -ks. 1 pantas, patut, layak. 2 sehat. 3 dapat, siap. 4 baik. -kk. to see f. memutuskan. -kkt. (fit atau fitted) 1 cocok dengan. 2 mencocokkan / menyusun kembali. 3 menjadikan. fitings kb., j. benda-benda, perabot.
fitful	ks. resah, gelisah, tidak tenang. f. sleep tidur yang tidak tentram.-fitfully kk. tertegun-tegun, gelisah, lasak. i slept f. last night tidurku gelisah saja semalam.
fitness	kb. 1 kemampuan. i question his f. for the job saya sangsikan kemampuannya untuk pekerjaan itu. 2 (appropriateness) kecocokan. physical f. kesehatan jasmani.
fitter	kb. 1 pemasang, pengepas. pipe f. pemasang pipa. 2 cloth.: tukar ukur baju, tukang jahit.
five	kb., ks. lima. five-spot kb. inf.: 1 uang kertas lima dolar. 2 kartu lima (card). five-star ks. berbintang lima. five-year ks. lima tahun.
fiver	kb. inf.: uang kertas lima dolar.
fix	kb. 1 kesulitan. 2 nav.: penentuan posisi. 3 sl.: suapan. 4 narc.: sl.: dosis obat bius. -kkt. 1 memperbaiki, membetulkan. 2 menyediakan. 3inf.: mengatur, merapikan. 4 inf.: main kongkalikong, menyuap. 5mengatur, mengurus. 6 menentukan. - fixed
fixation	kb. fiksasi, pendapat/perasaan yang mendalam. a f. about cleanliness fiksasi mengenai kebersihan, perasaan yang mendalam mengenai kebersihan.
fixer	kb. 1 tukang pasang. 2 inf.: tukang suap.
fixture	kb. perlengkapan tetap, peralatan tetap. she's become a f. iin the office ia telah menjadi perlengkapan tetap di kantor itu.
fiz	= fizz.
fizz	kb. 1 desis (air). 2 minuman yang menguap. -kki. meruap, mendesis.
fizzle	kb. kegagalan. -kki. 1 mendesis (of rockets, firecracker). 2melempem,gagal. the project fizzled out proyek itu gagal/mati.
fla	(florida) negara bagian a.s.
flabbergast	kkt. inf.: sangat mengherankan. i was flabbergasted when... saya ternganga keheranan ketika...
flabbiness	kb. kelembekan, kelembutan, kelemahan.
flabby	ks. lembek lembut (dagingnya bergantungan), lemah, lunak, kendur-kendur.
flaccid	ks. lembek, lembut, lemah.
flag	kb. bendera. f. of truce bendera putih. -kkt. (flagged) melambaikan tangan. -kki. merosot berkurang. -flagging ks. mengendor, lesu. to revive o's f. spirits menghidupkan kembali semangatnya yang mengendur.
flagpole	kb. tiang bendera.
flagrant	ks. yang menyolok. f. error kesalahan yang menyolok. f. act of murder perbuatan pembunuhan yang menggemparkan.
flagship	kb. kapal pemimpin.
flagstone	kb. batu hampar, batu ubin besar.
flail	kkt. memukuli, mencambuk.
flair	kb. 1 pengamatan yang tajam, kepandaian memilih dan menentukan. 2 bakat.
flak	kb. 1 tembakan penangkis udara. 2 meriam penangkis udara.
flake	kb. serpih atas, jonjot. f. of snow serpih salju. -kki. mengelupas, menyerpih.
flaky	ks. 1 mengeripik. the pie crust is f. kulit kueh itu mengeripik. 2 berlapis- lapis, mudah dibelah. sandstone is a f. rock batu pasir adalah batuan yang berlapis-lapis.
flamboyance	kb. keelokan semarak.
flamboyant	ks. 1 (ber)semarak/cemerlang. f. personality pembawaan yang semarak, pribadi yang cemerlang. 2 penuh bunga bahasa. f. speech pidato yang penuh bunga bahasa.
flame	kb. 1 lidah/nyala api. 2 api. -kki. bernyala, berkobar. -flaming ks. 1 sedang terbakar/menyala. 2 berapi. 3 bersinar-sinar. f. eyes mata yang bersinar-sinar, pandangan yang berapi-api.
flameproof	ks. tahan api.
flammable	ks. mudah terbakar, yang bisa cepat dimakan api.
flange	kb. flens, pinggiran roda.
flank	kb. 1 panggul (of person or animal). 2 sayap, sisi. -kkt. mengapit.
flannel	kb. cita pelanel. he looks nice in his flanels ia tampan tampaknya dengan baju pelanel itu.
flap	kb. 1 penutup. 2 tutup. 3 sl.: keadaan bingung, kehebohan. 4 sirip sayap pesawat terbang. -kkt. (flapped) 1 mengepak (its wings). 2 memukul. 3 mengelepakkan (o's arms). -kki. 1 terkepak-kepak. 2 mengelepak.
flapjack	kb. penekuk, semacam serabai.
flapper	kb. inf.: seorang gadis modern jaman 1920-an.
flappy	ks. yang mengepak-ngepak. f. hat topi yang terkulai-kulai.
flare	kb. 1 cerawat, nyala api, suar. 2 bagian yang melebar (of a skirt or dress). -kki. 1 menyala. 2 mengembang. flare-up kb. 1 kemarahan, pertengkaran sengit. 2 golak-gejolak (of a struggle). flared skirt rok layang.
flash	kb. 1 cahaya. 2 kilasan. -kkt. 1 menyiarkan. 2 memberikan, mengirim. 3 menyorotkan. -kki. menyala. -flashing ks. sebentar - sebentar menyala. f. lights cahaya kelap-kelip.
flashback	kb. sorot balik.
flashbulb	kb. balon/bolah lampu potret.
flashcard	kb. kartu pengingat, kartu yang diperlihatkan sekilas.
flashlight	kb. lampu senter. f. battery batu senter/baterai.
flashy	ks. (serba) menyolok, menyilaukan. f. tie dasi yang menyolok.
flask	kb. botol, labu (di laboratorium kimia).
flat	kb. 1 flat, rumah petak bertingkat. 2 tapak, setapak. 3 ban yang kempes. -flats j. sepatu bertumit rata. -ks. 1 datar. 2 rata. 3 ceper. 4 kempis, kempes. 5 mentah-mentah. -kk. 1 hambar, tawar. 2 tepat, persis. 3 sama sekali.
flatcar	kb. gerobak datar.
flatiron	kb. seterika.
flatland	kb. tanah datar, dataran.
flatten	kkt. 1 meratakan, memaparkan. 2 memesekkan (a nose). 3 meluruskan
flatter	kkt. 1 merayu. 2 menganjung, menyanjung, memuji. -flattering ks. memuji-muji, menyanjung-nyanjung.
flattere	kb. pemuji, penyanjung, perayu.
flattery	kb. (j. -ries) bujukan yang berlebih-lebihan, puji-pujian yang sifatnya menjilat, rayuan, sanjungan.
flattop	kb. nau : inf.: kapal induk.
flatulence	kb. gas dalam perut/usus.
flatulent	ks. mengandung/membentuk gas dalam perut.
flatus	kb. kentut.
flatware	kb. 1 piring-piring ceper. 2 sendok garpu dan pisau terbikin dari atau berlapis perak.
flatwork	kb. bahan-bahan kain/lenan (handuk, sarung bantal dsb.) yang tak begitu perlu diseterika sesudah dicuci.
flaunt	kkt. melagak, menjual tampang, memamerkan. to f. o's wealth melagakkan kekayaannya
flautist	kb. pemain suling logam.
flavor	kb. 1 rasa, selera. f. of candy rasa gula-gula. 2 bau. f. of onions bau bawang. 3 ciri rasa. -kkt. membumbui, memberi bumbu. -flavoring kb. perencah. vanilla f. perencah panili.
flavorless	ks. tanpa rasa, hambar.
flaw	kb. 1 cacat, kerusakan (in garments, china, etc.) 2 kekurangan.
flawed	ks. bercacat. f. diamond intan yang bercacat.
flawless	ks. sempurna, mulus, tanpa cacat. f. record angka-angka yang sempurna.
flax	kb. rami (halus), batang lenan.
flaxen	ks. terbuat dari rami, berwarna kuning muda. flaxen-haired ks. rambut yang berwarna seperti jerami.
flay	kkt. 1 menguliti (skin, hide). 2 mengecam. to be flayed by the critics dikecam habis-habisan oleh para kritikus/pengulas.
flea	kb. kutu (pada hewan). flea-bitten ks. digigit kutu (anjing, kuda dsb). f. market pasar loak/rombengan.
fleabite	kb. bekas gigitan kutu anjing dsb.
fleck	kb. bintik-bintik (pada kulit).
fled	lih flee.
fledgling	kb. calon, seorang yang masih muda dan belum berpengalaman. f. pilot calon penerbang.
flee	kkt. (fled) melarikan diri. -kki. 1 melarikan diri. 2 mengambil langkah seribu. 3 (meng)hilang, lenyap. 4 lari. to f. for o's life lari menyelamatkan diri.
fleece	kb. bulu domba. -kkt. 1 memotong/mencukur bulu domba. 2 merampas, menipu.
fleecy	ks. 1 dilapis dengan atau terdiri dari lapisan wol. 2 putih dan lembut. f. clouds awan putih dan lembut.
fleet	kb. 1nau.: armada. 2 konvoi, iring-iringan. -ks. tangkas, cekatan, cepat. -kki. time is fleeting waktu berlalu cepat. -fleeting ks. yang berlalu (cepat).
flesh	kb. daging. to put on f. bertambah gemuk. -kkt. to f. out meluaskan, menyempurnakan. -flesh-colored ks. berwarna seperti daging. flesh-eating ks. yang makan daging. f. wound luka enteng.
flew	lih fly.
flex	kkt. melenturkan. to f. o's muscles menegangkan otot-ototnya.
flexibility	kb. sifat melentur.
flexible	ks. 1 lunak, lemas, mudah dilenturkan. 2 bisa ditukar-tukar, mudah disesuaikan.
flick	kb. 1 ceklikan. 2 sl.: pilem. -kkt. 1 menjentik(kan). 2 mengibaskan.
flicker	kb. 1 kerdipan, kelap-kelip, kedipan 2 kejapan. -kki. 1 berkelip-kelip. 2 berkelip, berkelap. 3 berkedip. -flickering kb. kerlap-kerlip..
flier	kb. = flyer. inf.: to take a f. in politics mengadu untung dalam politik.
flies	lih fly.
flight	kb. 1 penerbangan. 2 terbangnya. 3 tingkat. 4 lari (nya). 5 pengaliran. f. deck 1 landasan peawat terbang diatas kapal induk. 2 ruang pesawat terbang yang digunakan oleh pilot, co-pilot dsb.
flightiness	kb. tingkah laku yang tak karuan, kesemberonoan.
flighty	ks. bertingkah, bertingkah laku tak karuan.
flimflam	kkt. (flimflammed) menipu.
flimsy	kb. 1 semacam kertas tipis yang digunakan oleh wartawan. 2 naskah berita diatas kertas yang tipis. -ks. 1 tipis, sangat halus. 2 yang bukan - bukan, lemah.
flinch	kki. 1 menyentak. 2 mengingkari, meninggalkan, menarik/menjauhkan diri.
fling	kb. masa bebas, belum puya tanggung jawab. -kkt. 1 melemparkan, menghempaskan. 2 menjebloskan. -kki. lari dengan cepat. to f. out 1 merentangkan. 2 mencaci-maki (at the government).
flint	kb. batu api/geretan.
flip	kb. terjun, sambil memutar badan. -kkt. (flipped) 1 melemparkan. 2 menjentikkan. 3 memadamkan, memutar mati (a switch). 4 membalik. -kki. sl.: memberontak, memprotes flip-flop kb. 1 main salto. 2 perubahan (mutlak). kki. (flip-flopped)
flippancy	kb. (j. -cies) kesembronoan dalam berbicara.
flippant	ks. 1 sembrono. f. reply jawaban yang sembrono. 2 pandai ngomong, bermulut usil.
flipper	kb. sirip (ikan paus, anjing laut). 2 sayap (of penguin).
flirt	kb. orang yang genit. -kki. 1 main-main, bercumbu-cumbuan. 2 mereka-reka. -flirting kb. bercumbu-cumbuan.
flirtation	kb. asyik-ma'syuk, berpacaran, (ber) main-main, cumbu-cumbuan.
flirtations	ks. genit.
flit	kb. f. flit. -kkt. (flitted) 1 berganti-ganti. 2 terbang. 3 melintasi, melayang dengan cepat. f. gun alat penyemprot obat (pembunuh) serangga.
flivver	kb. sl.: mobil kecil yang harganya murah dan tidak baru lagi.
float	kb. 1 pengapung, pelampung. 2 kendaraan berhias (dalam pawai). -kkt. 1 mengadakan. 2 mengapungkan, mengangkat. -kki. 1 terapung, mengapung. 2 berapung - apung. 3 (of the dollar) mengambang melayang. 4 hanyut. 5 tersebar. floating kb. pengambangan.
floater	kb. 1 inf.: orang yang sering berganti-ganti kerja. 2 polis asuransi yang meliputi segolongan barang-barang seperti perabot rumah tangga.
flock	kb. 1 kawan. 2 jemaah. -kki. berkumpul.
floe	kb. gumpalan es yang terapung, kepingan dari bidang es yang terapung.
flog	kkt. (flogged) mencemeti, mencambuk dengan cemeti, mendera. sl.: to f. a dead horse mencari jejak didalam air. -flogging kb. dera, pukulan-pukulan.
flood	kb. banjir, air bah (of tears, letters, etc). -kkt. 1 membanjiri. 2 mengaliri. 3 mengairi/menggenangi. -kki. 1 meluap. 2 membanjir. flood-stricken ks. dilanda banjir. -flooding kb. kebanjiran, membanjirnya, penggenangan.
floodgate	kb. pintu air.
floodlight	kb. lampu sorot. -kkt. (flood-lighted atau floodlit) menyinari dengan lampu sorot. -floodlit ks. yang disinari dengan/oleh lampu sorot.
floor	kb. 1 lantai. 2 tingkat. 3 dasar. 4 mimbar pidato. -kkt. 1 melantai, memapani. 2 inf.: merubuhkan / menjatuhkan. 3 inf.: membingungkan. -flooring kb. bahan untuk lantai.
floorboard	kb. lantai sebuah mobil, terutama di tempat (ruang) sopir.
floormat	kb. tikar, babut.
floorwalker	kb. pegawai di toko besar yang mengawasi penjualan di suatu tingkat.
floozie, floozy	kb. (j. -zies) sl.: 1 perempuan sundal. 2 gadis atau wanita yang tidak cerdas dan tidak menarik.
flop	kb. inf.: kegagalan. -kki. (flopped) inf.: 1 gagal. 2 menggeletak.
floppy	ks. yang terkelapai, yang (berat) terkulai. f. hat topi yang terkelapai.
flora	kb. 1 tumbuh-tumbuhan pada suatu daerah atau waktu tertentu. 2 buku tumbuh-tumbuhan.
floral	ks. yang berhubungan dengan bunga. f. arrangement susunan bunga. f. wreath karangan bunga.
floriculture	kb. pemeliharaan bunga.
florid	ks. 1 kemerah-merahan. f. complexion wajah kemerah - merahan. 2 penuh hiasan. f. speech pidato yang penuh hiasan, pidato yang penuh bunga bahasa.
florist	kb. tukang/penanam bunga. which is the best f.? toko/penjual bunga mana yang terbaik ?
floss	kb. 1 benang/serat sutera yang pendek. 2 serat yang halus seperti sutera.
flossy	ks. mentereng. her dress was too f. for the occasion bajunya terlalu mentereng untuk keramaian itu.
flotilla	kb. armada kecil.
flotsam	kb. reruntuh muatan kapal karam yang terapung-apung di laut. f. and jetsam reruntuh kapal serta barang-barang muatannya yang terapung-apung di laut.
flounce	kb. lipatan (rok) -kki menyentakkan, menggelepakkan badan karena marah. to f. out of the room in a rage keluar dari kamar dengan perasaan amat marah.
flouncy	ks. berkelepak, berkelepai (dress).
flounder	kb. semacam ikan laut yang gepeng. -kki. menggelepar.
flour	kb. tepung. f. mill pabrik/gilingan tepung. wheat f. tepung terigu.
flourish	kb. tulisan hiasan. -kkt. melambaikan (a ticket). -kki. tumbuh dengan subur. -flourishing ks. maju, berjalan baik.
flout	kkt. mencemoohkan. to f. a father's admonitions mencemoohkan teguran seorang ayah.
flow	kb. 1 aliran. 2 arus. 3 iriing-iringan, arus. -kkt. 1 mengalir. 2 melambai. 3 membanjir. -flowing ks. yang berjela-jela. land f. with milk and honey daerah yang penuh dengan makanan dan minuman.
flower	kb. bunga, kembang. in f. sedang berbunga. -kki. berbunga. -flowered ks. yang dihiasi dengan bunga. f. rug babut/permadani berhias gambar bunga. -flowering ks. berbunga. f. plant tumbuh-tumbuhan yang sedang berbunga.
flowerpot	kb. pot bunga.
flowery	ks. 1 penuh dengan bunga. 2 muluk-muluk. f. speech pidato dengan bahasa yang muluk-muluk, pidato yang penuh bunga bahasa.
flown	lih fly.
flu	kb. inpelenza, inplinsa, influenza.
flub	kkt. (flubbed) gagal. to f. an exam gagal dalam ujian. to f. a ball gagal menangkap bola.
fluctuate	kki. turun naik, berubah-ubah, lonjak-anjlok. his grades f. angkanya turun naik.
fluctuation	kb. fluktuasi, turun naik. f. in prices ketidaktetapan dalam harga.
flue	kb. jalan asap, corong/pipa asap.
fluency	kb. kepasihan, kelancaran.
fluent	ks. pasih, lancar. he is in english ia pasih berbahasa inggris. -fluently kk. dengan lancar, dengan pasih. he speaks indonesian f. bahasa indonesianya lancar.
fluff	kb. 1 bulu-bulu yang ringan, pendek dan halus/lunak seperti kapas. 2 sl.: kesalahan dalam membaca atau berbicara (sandiwara). -kkt. membuat kesalahan dalam bacaan atau berbicara.
fluffy	ks. seperti benang rambut halus, halus. f. kitten anak kucing yang berbulu halus dan lunak seperti busa.
fluid	kb. 1 zat cair gas, cairan dan gas. 2 nafta (for a lighter) -ks. berubah-ubah, tak tetap.
fluidity	kb. ketidakstabilan, kemudahan mengalir, keadaan cair.
fluke	kb. inf.: 1 kebetulan, yang menguntungkan. 2 nau.: ujung sauh. 3 semacamikan gepeng. 4 sejenis cacing pipih/pita.
flume	kb. saluran air, jurang sempit yang dilalui air.
flung	lih fling.
flunk	kkt. inf.: menggagalkan, menjatuhkan. -kki. jatuh dalam ujian.
flunk(e)y	kb. (j. -kies) 1 bujang, pelayan pria. 2 penjilat.
