safekeeping	kb. penyimpanan yang aman. for s. untuk diamankan.
safety	kb. (j. -ties) 1 keselamatan (of o's health). 2 keamanan (of an area).
saffron	kb. semacam kunyit. -ks. kuning-jingga.
sag	kb. kelonggaran (in a dress, coat). -kki. (sagged) 1 melentur, melengkung, melendut (of a floor). 2 terkulai (of clothing). 3 berkedut (of cheeks, breasts). 4 berkurang, turun, menurun (of sales). 5 mengendor (of a rope).
saga	kb. 1 hikayat. icelandic s. hikayat islandia. 2 kisah. his biography is a s. of courage biografinya merupakan kisah keberanian.
sagacious	ks. bijaksana, cerdas, cerdik.
sagacity	kb. kecerdasan, kecerdikan, kebijaksanaan.
sage	kb. 1 (plant) sejenis tumbuhan yang daunnya harum dan dipergunakan sebagai bumbu-bumbu. 2 orang bijaksana, guru. -ks. bijaksana. s. advice nasihat yang bijaksana.
sagging	kb. pelenturan, pelengkungan (of a floor, roof). ks. 1 merosot, menurun. s. economy keadaan ekonomi yang merosot. 2 yang menggantung (of roof, breasts).
saggy	ks. longgar, kendor, kedodoran (of trousers).
sago	kb. sagu.
said	lih say.
sail	kb. 1 layar. main s. layar utama. 2 pelayaran. -kkt. 1 melayarkan (a boat). 2 mengarungi (the sea). -kki. 1 berlayar. 2 melayang. 3 berangkat. -sailing kb. berlayar, naik perahu layar.
sailboat	kb. perahu layar.
sailfish	kb. sejenis ikan gergaji.
sailor	kb. pelaut, kelasi, anak kapal. she's a good s. dia tidak mabuk laut. sailors' home rumah pelaut.
saint	kb. orang yang suci.
saintliness	kb. kesucian, kedewaan.
saintly	ks. saleh, suci.
sake	kb. for the s. of 1 demi. 2 untuk kepentingan.
salable	ks. dapat/mudah dijual, laku.
salacious	ks. 1 cabul. 2 gasang.
salad	kb. selada, sayur-mayur dimakan sebagai lalap. s. bowl mangkok/kom/wadah/tempat sayuran.
salamander	kb. sejenis kadal.
salami	kb. semacam sosis.
salaried	ks. bergaji, menerima gaji.
salary	kb. (j. -ries) gaji.
sale	kb. 1 penjualan. 2 obral. to go to a s. pergi ke obral. -sales j. jumlah penjualan.
saleable	= salable.
salesclerk	kb. pelayan toko, pramuniaga(wan).
salesgirl	kb. gadis pelayan toko, pramuniaga(wati).
saleslady	kb. (j. -dies) wanita pelayan toko, pramuniaga(wati).
salesman	kb. (j. -men) penjual barang-barang, pedagang.
salesmanship	kb. kepandaian berjualan, keahlian berdagang.
salespeople	kb., j. 1 orang-orang pelayan toko. 2 orang-orang pedagang.
salesperson	kb. 1 pelayan toko. 2 orang pedagang.
salesroom	kb. ruangan penjualan.
saleswoman	kb. (j. -women) wanita pelayan toko.
salient	ks. yang menonjol/penting, yang menyolok mata.
saline	ks. yang berkaitan dengan garam. s. solution larutan garam.
salinity	kb. kadar garam, salinitas.
salisbury	kb. s. steak daging sapi dicencang sebelum masak, dibentuk menjadi semacam pergedel, biasanya diberi kuah.
saliva	kb. air liur, (air) ludah.
salivary	ks. yang berkaitan dengan air liur. s. gland kelenjar ludah.
salivate	kki. mengeluarkan air liur/ludah.
salk	kb. s.vaccine vaksin pencegah polio.
sallow	ks. 1 pucat, pudar. 2 kekuning-kuningan.
sally	kb. (j. -ies) 1 mil.: serangan tiba-tiba. 2 kelakar, gurau. -kki. (sallied) pergi keluar.
salmon	kb. ikan salem. -ks. merah-muda kekuning-kuningan.
salon	salon
saloon	kb. warung minum (minuman keras). passenger s. ruang umum untuk para penumpang (di kapal).
salt	kb. 1 garam. s. water air garam. 2 inf.: pelaut, kelasi (yang berpengalaman). -kkt. 1 menggarami (food). 2 memberi garam (streets). salt-water ks. asin, laut. -salted ks. diasin, asin. s. peanuts kacang asin.
saltcellar	kb. tempat garam.
saltpeter	kb. sendawa.
saltshaker	kb. tempat garam.
saltworks	kb. paberik garam, pegaraman.
salty	ks. 1 asin (to the taste). 2 lucu dan tidak sopan (remark).
salubrious	ks. menyehatkan, menyegarkan. s. effect on pengaruh yang menyegarkan bagi.
salutary	ks. 1 menyehatkan (of exercise) 2 bermanfaat. to have a s. effect on berakibat baik bagi.
salutation	kb. 1 salam. 2 salam pembukaan/pendahuluan (in correspondence).
salutatorian	kb. mahasiswa, biasanya juara kedua, yang mengucapkan pidato selamat datang pada upacara hari wisuda (pembagian ijazah).
salute	kb. 1 pemberian hormat. 2 saluir. -kkt. 1 menghormat, bersaluir, memberi salut (the flag, on officer). 2 memberi salam (friends).
salvage	kb. 1 barang-barang yang diselamatkan. 2 (payment for) penyelamatan/untuk simpanan. 3 tindakan penyelamatan dari kebakaran dsb. -kkt. menyelamatkan (a ship, o's dignity, s.t. from defeat).
salvation	kb. 1 keselamatan. 2 hal menyelamatkan.
salve	kb. 1 mel.: obat (salep). 2 obat penawar (for o's discouragement). -kkt. 1 mengobati, menaruh salep pada, memalit (a cut). 2 menenangkan, meredakan (o's conscience).
salvo	kb. 1 salvo, tembakan serentak. 2 sorakan, semburan (of jeers). to fire a s. a) melepaskan tembakan salvo. b) melancarkan serangan bertubi-tubi.
samaritan	kb. orang samara.
same	ks. 1 sama. 2 serupa. 3 itu juga. 4 yang dulu.
sameness	kb. 1 kesamaan. 2 (similarity) persamaan.
sample	kb. contoh. -kkt. 1 mencicipi, mengecap (food). 2 mengalami (the experiences of life). 3 mencoba (a new restaurant). -sampling kb. penarikan contoh.
sampler	kb. 1 (cloth) sulaman. 2 pencoba (of wines).
sanatorium	kb. 1 sanatorium. 2 petirahan.
sanctification	kb. persucian, penycian, pengsucian
sanctifies	lih sanctify.
sanctify	kkt. (sanctifiied) menyucikan, menguduskan. -sanctified ks. suci (holiday).
sanctimonious	ks. berlagak suci, berpura-pura suci, suci lamisan.
sanction	kb. 1 persetujuan (of s.o.). 2 saksi. -kkt. menyetujui, mendukung (a proposal).
sanctity	kb. (j. -ties) kesucian (of the church/home).
sanctuary	kb. (j. -ries) 1 bagian dari gereja didekat altar. 2 rel.: tempat perlindungan. 3 (wildlife) cagar alam. 4 perlindungan.
sand	kb. pasir. -sands. j. pantai pasir. -kkt. 1 menutupi (jalan) dengan pasir (a road). 2 mengamril, mengampelas (wood).
sandal	kb. sandal, cerpu, terompah, lapik kaki. s. tree pohon cendana.
sandalwood	kb. kayu cendana.
sandbag	kb. karung berisi pasir.
sandbank	kb. beting, gosong.
sandblast	kb. semprotan/semburan pasir (untuk membersihkan tembok dsb).
sandbox	kb. bak pasir (untuk anak-anak).
sander	kb. alat/orang yang menaburkan pasir (of a road). floor s. alat/orang yang menaburi/menggosok lantai dengan pasir.
sandhog	kb. pekerjaan kasar dibawah tanah/air.
sandman	kb. tokoh dalam dongengan yang menidurkan anak dengan menaburkan pasir kedalam mata mereka.
sandpaper	kb. ampelas, amril. -kkt. mengampelas.
sandpiper	kb. (burung) kedidi.
sandspit	kb. daerah tanjung berpasir.
sandstone	kb. batu pasir/paras.
sandstorm	kb. badai pasir.
sandwich	kb. roti berlapis/isi/apit. ham s. dua keping roti dengan isi ham, roti apit dengan ham. -kkt. menyisipkan, menyelipkan (between diantara).
sandy	ks. 1 berpasir. s. beach pantai pasir. 2 pirang-pasir (of color).
sane	ks. waras otak, sehat ingatan. 2 bijaksana (of speech, views).
sang	lih sing.
sanguine	ks. riang dan penuh harapan, periang dan optimis. he is s. of success ia berkepercayaan penuh akan berhasil.
sanitarium	kb. sanatorium, balai tetirah, petirahan.
sanitary	ks. bersih, sehat. s. engineering teknologi kesehatan.
sanitation	kb. 1 kebersihan, penjagaan kesehatan/kebersihan. s. department jawatan kebersihan.
sanitize	kkt. membersihkan, mendesinfeksi(kan).
sanity	kb. kesehatan jiwa/rohaniah.
sank	lih sink.
sanskrit	kb. bahasa sansekerta.
santaclaus	kb. sinterklas, sinyo/santa kolas.
sap	kb. 1 air/getah tumbuh-tumbuh. 2 sl.: orang goblok/tolol. -kkt. (sapped) melemahkan (o's energy).
sapling	kb. pohon muda, anak pohon.
sapphire	kb. batu nilam, nilakandi.
sappy	ks. sl.: gila-gilaan, tolol.
sarcasm	kb. sarkasme, sindiran tajam.
sarcastic	ks. sarkastis, tajam.
sarcophagus	kb. peti mayat dari batu.
sardine	kb. ikan sardencis/sarden. we were packed in like sardines kita berdempet-dempet seperti ikan sardencis.
sardonic	ks. sengit, tajam.
sarong	kb. sarong, (kain) sarung.
sarsaparilla	kb. sarsaparila, saparila.
sartorial	ks. yang berkaitan dengan tukang jahit. he was decked out in s. splendor dia mengenakan pakaian yang mentereng.
sash	kb. 1 ikat/pita pinggang, selempang. 2 (window) bingkai/daun jendela.
sass	kb. inf.: kekurangajaran, kelancangan. -kkt. bertindak lancang. to s. s.o. lancang terhadap seseorang.
sassafras	kb. sejenis pohon bunga-bungaan (jenis laurel).
sassy	ks. inf.: lancang.
sat	lih sit.
sat.	[saturday] hari sabtu.
satan	kb. setan.
satchel	kb. tas.
sate	kkt. mengenyangkan.
sateen	kb. kain saten/antelas.
satellite	kb. 1 satelit. artificial s. satelit buatan. communication s. satelit perhubungan/komunikasi. 2 negara satelit/bebek. s. town kota satelit.
satiate	kkt. mengenyangkan. to feel satiated merasa kenyang.
satiation	kb. kekenyangan, kejenuhan, kejemuan.
satin	kb. kain satin.
satire	kb. 1 (writing) karangan sindiran. 2 sindiran.
satirical	ks. 1 suka menyindir. 2 bersifat/secara menyindir.
satirist	kb. 1 penyindir, orang satiris. 2 pengarang satire.
satirize	kkt. menyindir, mengecam dengan penuh sindiran.
satisfaction	kb. 1 kepuasan (hati). 2 pelunasan (of a debt).
satisfactory	ks. memuaskan. his work is s. pekerjaannya memuaskan. -satisfactorily kk. dengan memuaskan.
satisfied	lih satisfy.
satisfies	lih satisfy.
satisfy	kkt. (satisfied). 1 memuaskan bagi. 2 memenuhi (requirements, a claim). 3 menghilangkan (o's thirst). 4 mayakinkan. -satisfied ks. 1 puas. 2 menyenangkan.
saturate	kkt. memenuhi. -saturated ks. (yang) penuh dengan, jenuh.
saturation	kb. penjenuhan, kejenuhan. s. point titik jenuh. he reached the s. point dia sampai pada batas ketahanannya.
saturday	kb. (hari) sabtu).
saturn	kb. zohal.
sauce	kb. kuah, saus. to add a s. to s.t. menambah kuah kepada sesuatu.
saucebout	kb. tempat/mangkuk saus.
saucepan	kb. panci bergagang.
saucer	kb. piring cawan, lepek(an). cup and s. mangkuk dan piring (tadah).
sauciness	kb. kekurangajaran, kelancangan.
saucy	ks. 1 tampan, cakep (of looks). 2 lancang (hat).
sauerkraut	kb. acar/asinan kobis.
saunter	kb. berjalan-jalan. to s. into the room berjalan luntang-lantung masuk kamar.
sausage	kb. sosis.
saute	kkt. menggoreng sebentar, menumis dengan sedikit minyak atau mentega.
savage	kb. orang biadab/liar/ganas. -kk. secara kejam/biadab.
savageness	= savagery.
savagery	kb. (j. -ries) kekejaman, kebuasan.
savannah	kb. padang rumpiut yang sangat luas (yang tak berpohon).
savant	kb. sarjana, orang yang terpelajar.
save	kb. sport : penyelamatan, tangkapan. -kd. kecuali. -kkt. 1 (banking) menabung (money). 2 menghemat (time, money). 3 menyelamatkan (the situation). 4 memelihara, menyelamatkan. 5 menyimpan.- saving kb. 1 penghematan. 2 penyelamatan.
saver	kb. penghemat. time s.penghemat waktu.
savior	savior
savoir-faire	kb. kecakapan berbicara dan bertindak.
savor	kb. rasa, bau. -kkt. 1 mengecap (food). 2 menikmati (life).
savory	ks. sedap, lezat, enak.
savvy	kb. sl.: akal, kecerdasan. he has a lot of s. dia mudah sekali mengerti. -kkt., kki mengerti, faham, tahu.
saw	kb. 1 gergaji. 2 pepatah, peribahasa. -kkt. (sawed, sawed atau sawn) menggergaji (a board). -kki. menggergaji (with an electric s.).
sawdust	kb. abuk/tahi/serbuk gergaji, abu kayu.
sawfish	kb. ikan hiu todak.
sawhorse	kb. kuda-kuda.
sawmill	kb. penggergajian, kilang gergaji.
sawn	lih saw.
sax	kb. inf.: saksofon.
saxophone	kb. saksofon.
saxophonist	kb. pemain saksofon.
say	kb. suara. -kkt. (said) 1 mengatakan. 2 berkata. 3 katanya. 4 mengucapkan. -kki. 1 kata, berkata. 2 kira-kira. -said ks. law : tersebut. -saying kb. pepatah, peribahasa.
sb.	[subtantive] katabenda.
sc.	[science] ilmu pengetahuan.
scab	kb. 1 keropeng. 2 sl.: buruh penghianat. -kki. (scabbed) sl.: to s. over berkeropeng.
scabbard	kb. sarung pedang.
scabby	ks. berkeropeng.
scabies	kb. kudis, gudik.
scads	kb., j. sl.: jumlah besar, banyak sekali. she has s. of money ia mempunyai banyak sekali uang.
scaffold	kb. 1 tangga-tangga, perancah. to put up the s. memasang perancah. 2 tempat penggantungan. he went to the s. ia digantung.
scaffolding	kb. perancah. to erect s. mendirikan perancah.
scalawag	kb. inf.: bajingan, bandit.
scald	kb. luka kebakaran. -kkt. 1 mencuci dengan air mendidih (dishes). 2 memanaskan (milk).
scale	kb. 1 skala. 2 derajad, skala. 3 sisik (of a fish). 4 kerak air (inside a boiler). -scales j. 1 neraca, timbangan. -kkt. 1 mendaki (a mountain). 2 menyisik (a fish). 3 menimbang.
scalene	ks. sisi tak sama ( panjang). s. triangle segitiga yang tidak sama kakinya.
scallion	kb. sejenis brambang.
scallop	kb. 1 sejenis remis. 2 baju wanita yang pinggir bawahnya berlekuk-lekuk (seperti kulit kerang berjejer) (on a dress). -kkt. memasak dengan kuah dan deretan roti.
scalp	kb. kulit kepala beserta rambutnya, jangat kepala. -kkt. 1 menguliti kepala, membeset kulit kepala. 2 inf.: mencatutkan (ticketnya). 3 inf.: sport : mencukur gundul.
scalpel	kb. pisau bedah.
scalper	kb. inf.: tukang catut.
scaly	ks. bersisik(-sisik).
scamp	kb. bangsat, berandal, anak nakal.
scamper	kki. berlari-lari, pergi tergesa-gesa, ambil langkah seribu.
scan	kb. pengamatan, peninjauan. -kkt. (scanned) 1 meneliti (the horizone). 2 membaca dengan cepat (a book or magazine). 3 membagi sebaris sajak dalam bagian-bagian menurut iramanya (poetry). 4 menatap(i) (a crowd). -scanning kb. membaca sepintas kilas .
scandal	kb. perbuatan yang memalukan, perkara (yang) keji, skandal, keonaran.
scandalize	kkt. memalukan, melanggar sopan-santun, menyinggung rasa susila.
scandalmonger	kb. pemfitnah, penyebar desas-desus.
scandalous	ks. keji, memalukan.
scandinavian	ks. yang berhubungan dengan skandinavia.
scanner	kb. 1 penyaring gambar (tv). 2 antena (radar).
scant	ks. 1 (sedikit) kurang, tak cukup. 2 kurang dari.
scantiness	kb. kesedikitan, kejarangan.
scantling	kb. balok kecil, kayu/tiang penunjang.
scanty	ks. hanya sedikit. having had a s. dinner... karena makan malam hanya sedikit... -scantily kk. sedikit, hampir tak.
scapegoat	kb. sebab kesalahan, korban.
scapula	kb. 1 tulang belikat (of mammals). 2 tulang lembusir (cattle, sheep).
scar	kb. 1 bekas luka, birat (on the body). 2 gores(an), parut (on furniture). 3 kesan yang buruk (on the mind). -kkt. (scarred) menggoresi, meninggalkan parut.
scarce	ks. jarang, langka. oranges are s. this winter jeruk (manis) jarang dalm musim dingin. -scarcely kk. 1 hampir tidak. 2 tidak mungkin.
scarcity	kb. (j. -ties) 1 kekurangan, kejarangan (of food). 2 kelangkaan.
scare	kb. ketakutan. -kkt. menakuti, membuat ketakutan. -kki. menjadi takut. -scared ks. takut, ciut hati.
scarecrow	kb. orang-orangan untuk menakut-nakuti burung.
scaremonger	kb. penyebar panik, pembangkit kegelisahan.
scarf	kb. syal, selendang.
scarlet	kb. merah-tua, merah-padam. s. fever penyakit jengkering.
scary	ks. menakutkan.
scat	kseru. ayo pergi ! husy !.
scathing	ks. menyakiti hati, pedas dan tajam (of remarks).
scatter	kkt. 1 menyebar, menghamburkan (papers). 2 menabur (seed). -kki. bubar, berpencar. -scattered ks. terpencar-pencar, tersebar disana-sini. -scattering kb. sejumlah kecil (of follewers).
scatterbrain	kb. orang kepala angin, orang yang suka lengah.
scatterbrained	ks. berkepala angin.
scavenge	kkt., kki. mencari-cari sesuatu dalam sampah, mengeruk-ngeruk sampah untuk mencari (sesuatu yang dapat dimakan atau dijual).
scavenger	kb. binatang atau burung yang makan bangkai.
scenario	kb. senario cerita film. s. writer penulis senario.
scene	kb. 1 pemandangan. 2 adegan (of a play). 3 kancah (of disturbances). 4 tempat. 5 suasana, iklim. 6 gaduh, rewel.
scenery	kb. (j. -ries) 1 pemandangan (in the valley). 2 dekor (for a play).
scenic	ks. permai, indah (of an area, view). s. highway jalan-raya dengan/yang penuh pemandangan.
scent	kb. 1 bau. 2 penciuman (of an animal). 3 wangi-wangian. -kkt. 1 memberi wangi-wangian (a room). 2 mencium (o's master, an escapee). 3 mencurigai (trickery). 4 mengharumkan (a handkerchief).
scepter	kb. tongkat lambang kekuasaan.
sceptic	= skeptic.
sceptical	= skeptical.
sch.	[school] sekolah.
schedule	kb. 1 daftar perjalanan (bus, plane, train). 2 daftar/rencana pelajaran (of classes). -kkt. merencanakan, mengatur. -scheduled ks. tetap.
schema	kb. skema, bagan.
schematic	ks. skematis, menurut bagan.
scheme	kb. 1 rencana. 2 maksud yang tidak baik, rencana kotor. 3 pola. -kkt. membuat rencana. -kki. berkomplot, bersekongkol. -scheming kb. rencana (jahat/busuk), perencanaan yang licik.
schemer	kb. pengatur siasat, penyusun komplot.
schism	kb. pemisahan, perpecahan, keretakan.
schismatic	ks. berbuat/bersifat memecah-belah.
schizoid	ks. menderita schizofrenia.
schizophrenia	kb. penyakit jiwa berupa suka mengasingkan diri, schizofrenia.
schizophrenic	ks. menderita schizofrenia.
schmal(t)z	kb. sl.: sifat sentimentil yang berlebih-lebihan.
schmo	kb. sl.: orang tolol.
schofflaw	kb. inf.: pelanggar peraturan.
scholar	kb. 1 sarjana. greek s. sarjana bahasa yunani. 2 pelajar. he's good s. dia seorang pelajar yang baik.
scholarly	ks. 1 ilmiah. 2 seperti sarjana atau cendekiawan. 3 kesarjanaan.
scholarship	kb. ilmu pengetahuan, kesarjanaan. 2 beasiswa, danasiswa.
scholastic	ks. yang mengenai pelajaran. s. achievement kemajuan pelajaran yang dicapai.
school	kb. sekolah. 2 fakultas. -schooling kb. pendidikan yang diterima di sekolah.
schoolbag	kb. tas sekolah.
schoolbook	kb. sekolah/pelajaran.
schoolboy	kb. murid (sekolah) laki-laki, siswa.
schoolchild	kb. murid/anak sekolah.
schoolgirl	kb. murid (sekolah) wanita, siswi.
schoolhouse	kb. rumah/gedung sekolah.
schoolmate	schoolmate
schoolroom	kb. kamar/ruangan sekolah.
schoolteacher	kb. guru (sekolah).
schoolwork	kb. pekerjaan rumah (untuk) sekolah, pr.
schoolyard	kb. halaman/pekarangan sekolah.
schooner	kb. 1 nau.: sekunar, sekonyar. 2 inf.: gelas besar (of beer).
sci.	1 [science] ilmu pengetahuan. 2 [scientific] (bersifat) ilmiah.
sciatica	kb. 1 penyakit pegal pada pinggang. 2 linu panggul.
science	kb. ilmu pengetahuan. s. of language ilmu pengetahuan bahasa.
scientific	ks. (secara) ilmiah. s. approach pendekatan secara ilmiah. -scientifically kk. secara ilmiah, berdasar ilmu pengetahuan.
scientist	kb. ahli ilmu pengetahuan, sarjana.
scintillate	kki. berkilau-kilau. -scintillating ks. gemilang, gemerlapan.
scion	kb. keturunan.
scissor	kb. (pair of) scissor j. gunting. -kkt. menggunting.
sclerosis	kb. sklerosa.
scoff	kki. to s. at mengejek(kan). -scoffing kb. cacian, cercaan, ejekan. -scoffingly kk. secara mengejek.
scoffer	kb. pengejek, penyindir, pencela.
scold	kb. orang yang cerewet, orang yang suka mengomel/mengata-ngatai. -kkt. mencaci-maki, memarahi, mengomel, menghardik. -scolding kb. omelan, cercaan, hardikan, kopi pahit.
scoop	kb. 1 sekop (of a steam shovel). 2 sendok (of ice cream). 3 gayung (for water). 4 pencedok, sauk. 5 sl.: berita pertama (news). 6 keduk.
scoot	kki. inf.: (ber)lari. s.! cepat (lari) !.
scooter	kb. 1 sekuter. m. scooter sepeda motor sekuter. 2 sepeda dorong.
scope	kb. 1 bidang, lapangan. 2 jangkauan. 3 kesempatan. 4 keleluasaan.
scorch	kkt. menghanguskan. -scorched ks. gosong, hangus. -scorching ks. 1 amat panas (heat). 2 yang membakar (criticism).
scorcher	kb. inf.: 1 hari yang amat panas. 2 (criticism) kecaman yang pedas sekali.
score	kb. 1 skor, angka, biji. 2 mus.: lembaran musik. 3 kodi. 4 alasan, sebab. -kkt. 1 memasukkan, mencetak (a goal). 2 mendapat. 3 mengarang, menyusun (music). 4 menghitung angka/biji (a sport). 5 bridge : memperoleh "trick/slag".
scoreboard	kb. papan angka.
scorecard	kb. kartu catatan angka (pemain - pemain).
scorekeeper	kb. pencatat angka/hasil pertandingan.
scoreless	ks. tanpa angka, nol-nol, sama kosong, kosong-kosong. s. tie pertandingan/seri kosong-kosong.
scorer	kb. 1 tukang cetak biji. 2 pencatat hasil pertandingan. 3 penilai. 4 4 pemberi sifat. 5 sport : pembuat gol.
scorn	kb. caci-maki, cemoohan. -kkt. 1 menolak (help). 2 memandang rendah, mencemoohkan (s.o.).
scornful	ks. menghinakan, mempunyai rasa penghinaan. he is s. of those who fail ia penuh rasa penghinaan terhadap mereka yang gagal.
scorpio	kb. zod.: kricika.
scorpion	kb. kalajengking.
scot	kb. orang skotlandia.
scot-free	ks. tanpa hukuman. to get off s.-free dibebaskan tanpa hukuman.
scot.	1 [scotland] skotlandia. 2 [scotch] yang berkaitan dengan skotlandia.
scotch	kb. wiski skotch. -ks. 1 inf.: kikir. 2 yang berhubungan dengan skotlandia. -kkt. 1 menggalang, mengganjal (wheels). 2 memberantas, membasmi (a rumor). scotch-irish kb., ks. skot-irlandia.
scotchman	kb. (j. -men) orang skotlandia.
scotsman	kb. (j. -men) orang skotlandia.
scottish	ks. yang berhubungan dengan sotlandia.
scoundrel	kb. bajingan, bangsat.
scour	kkt. 1 menggosok (a floor, a pan). 2 menjelajah, memeriksa (the countryside). -scouring kb. penggosokan.
scourer	kb. 1 seorang penggosok. 2 bahan penggosok (for pots).
scourge	kb. 1 momok. he's the s. of the region ia merupakan momok di daerah itu. 2 bencana (of t.b.).
scout	kb. 1 mil.: pengintai. 2 pandu. boy s. pramuka, pandu. 3 sl.: seorang. -kkt. 1 mengintai (the enemy). 2 menolak dengan mengejekkan. -kki. mencari. - scouting kb. kepanduan, pramuka.
scoutmaster	kb. pemimpin (regu) pramuka.
scow	kb. tongkang.
scowl	kb. bersut, pendangan marah. -kkt. she scowled dislike of us mukanya cemberut menunjukkan bahwa ia tidak senang kepada kami. -kki. mengerutkan dahi, membersut, memberungut.
scrabble	kki. membanting tulang, berjuang sungguh-sungguh (to make a living).
scrag	kb. leher orang.
scraggly	ks. tidak rata, kasar, jarang (of hair, grass).
scraggy	ks. kurus(-kering)
scram	kki. (scrammed) sl.: pergi dengan segera. s. ! enyah dari sini ! ayo, lekas pergi !.
scramble	kb. 1 perebutan (for the ball). 2 pertarungan (to reach o's present high position). 3 perjuangan. -kki. berebut, berjuang.
scrap	kb. 1 sisa (of food). 2 carik. 3 guntingan, potongan. 4 sl.: pertengkaran. -kkt. (scrapped) 1 membatalkan, mengesampingkan (o's plants). 2 membongkar (a ship). -kki. sl.: berkelahi.
scrapbasket	kb. keranjang sampah.
scrapbook	kb. buku tempel, buku tempat mengumpulkan guntingan-guntingan koran, kutipan-kutipan dll.
scrape	kb. 1 (bunyi) garutan (of a finger on a blackboard). 2 perkelahian. 3 goresan (of a pen). 4 pergesekan (of a violin bow). 5 goresan. -scrapings kb., j. kikisan, parutan, hasil kikisan.
scraper	kb. 1 pengikis (for paint). 2 alat pengerik.
scrapheap	kb. tumpukan sampah.
scrapper	kb. 1 sl.: tukang berkelahi. 2 box.: sl.: petinju.
scrappy	ks. 1 suka berkelahi, agresip (of a person). 2 terdiri dari sisa-sisa (makanan).
scratch	kb. 1 luka garutan. 2 luka kecil. 3 penggarukan, penggoresan (at the door pada pintu). 4 goresan (on a chair, table). 5 gurat, goresan (on paper). -scratching kb. 1 penggarukan, penggarutan. 2 goresan, garutan.
scratchy	ks. 1 kasar menggatalkan (of cloth, material). 2 yang menggarut (of a pen).
scrawl	kb. tulisan buruk, tulisan cakar ayam. -kkt. menulis secara cakar ayam.
scrawny	ks. kurus(-kering).
screak	kb. pekikan, jeritan. -kki. menciut-ciut (of brakes).
scream	kb. 1 pekikan, jeritan, teriakan. 2 sl.: badut, pelawak. -kki. menjerit, memekik, berteriak. -screaming kb. teriakan, jeritan. ks. menyolok (of a headline). -screamingly kk. amat, sangat. s. funny lucu sekali.
screech	kb. bunyi berciut (of brakes). s. owl sejenis burung hantu yang kuat pekikannya. -kki. menciut-ciut, berciut-ciut.
screechy	ks. yang melengking (of voice, brakes, record).
screen	kb. 1 kasa. 2 layar (putih) (for slides, movies). 3 tabir. 4 sekat. -kkt. 1 melindungi (o's face from the wind). 2 menyaring (applicants, sand). 3 memutar (a movie). 4 menutupi (the view from s.o.).
screening	kb. 1 penyaringan (of applications). 2 pemutaran pilem. 3 kosa.
screeningplay	kb. cerita untuk pilem, senario.
screw	kb. 1 sekrup. 2 baling-baling (of a ship). -kkt. 1 menyekerup(kan). 2 memutar, memasang (screws).
screwball	kb. sl.: orang sinting/aneh/edan. that's a s. idea itu buah pikiran yang sinting.
screwdriver	kb. obeng. philip's s. obeng bintang.
screwy	ks. sl.: 1 aneh, ganjil (situation). 2 aneh, sinting, edan (person). 3 luar biasa, aneh (weather).
scribal	ks. yang berkaitan dengan tulisan. s. error kesalahan menulis.
scribble	kb. tulisan cakar ayam. -kkt. menulis (dengan tergesa-gesa).
scribe	kb. ahli menulis.
scrimmage	kb. latihan football. -kki. melakukan latihan football.
scrimp	kki. berhemat, hidup hemat.
scrimpy	ks. sangat sedikit. s. meal makanan yang amat sedikit.
scrip	kb. uang kertas darurat.
scrip(t).	[scripture] kitab injil.
script	kb. 1 naskah (of a play). 2 tulisan.
scriptural	ks. yang berkaitan dengan kitab injil.
scripture	kb. kitab injil. the holy scriptures kitab injil.
scriptwriter	kb. penulis lakon/cerita (sandiwara atau pilem).
scrofula	kb. penyakit kelenjar, semacam penyakit tbc.
scroll	kb. gulungan surat perkamen, surat gulungan. s. saw gergaji ukir.
scrotum	kb. kantung buah pelir, kantung kemaluan.
scrounge	kkt. sl.: 1 mencuri. 2 mengemis. 3 mencari-cari (for food).
scrounger	kb. sl.: 1 pengemis, orang minta-minta. 2 tukang colong, pencopet.
scrub	kb. 1 semak, belukar. 2 sport : pemain pengganti. 3 penggorokan. -kkt. (scrubbed) 1 menggosok (a floor, pan). 2 membuang (a plan, idea). 3 sl.: menghapuskan, mengurungkan (a game, match). -scrubbing kb. hal menggosok (dengan sabun), menyikat.
scrubby	ks. kerdil. s. beard janggut yang (lebat dan) kasar. s. land tanah penuh dengan semak-semak.
scrubwoman	kb. (j. -women) wanita/babu pengepel lantai.
scruff	kb. kuduk, tengkuk.
scrumptious	ks. 1 mewah (dwelling). 2 lezat, enak (food).
scruple	kb. keberatan. to have no scruples about tak berkeberatan terhadap. -kki. berkeberatan. he doesn't s. to... ia tidak segan-segan untuk...
scrupulous	ks. 1 cermat (house-keeper). 2 teliti, seksama (in o's dealings). -scrupulously kk. dengan teliti, sampai kepada yang sekecil-kecilnya, dengan amat teliti, sangat hati-hati.
scrurry	kb. jalan cepat/terburu-buru. -kki. (scurried) 1 bergegas-gegas. 2 berlari-lari.
scrutinize	scrutinize
scrutiny	kb. (j. -nies) penelitian dengan cermat. to bear close s. tahan terhadap penelitian yang keras.
scuba	kb. alat untuk bernapas dibawah air (bagi penyelamat).
scuff	kkt. melecetkan (shoes, the floor).
scuffle	scuffle
scull	kb. dayung buritan. -kki. berkayuh, mengayuh, mendayung dengan dayung buritan.
sculler	kb. 1 pendayung, pengayuh. 2 perahu dayung.
sculpt	kkt. memahat.
sculptor	kb. pemahat/ahli patung.
sculptress	kb. ahli patung wanita.
sculpture	kb. 1 seni pahat/ukir. 2 patung, arca, pahatan. -sculpturing kb. seni memahat/pahat/ukir.
scum	kb. 1 kekam, buih (on the water). 2 sampah. he's the s. of the earth ia sampah masyarakat.
scummy	ks. 1 berbuih (of a liquid). 2 tak berguna, jahat (person, trick, deal).
scurried	lih scurry.
scurries	kih scurry.
scurrility	kb. (j. -ties) kelakar/lelucon yang tidak senonoh, kemesuman.
scurrilous	ks. 1 kasar, kotor, keji. 2 tak senonoh, carut.
scurvy	kb. penyakit kudisan. -ks. hina, keji, curang (trick).
scuttle	kb. ember, bak (for coal). -kkt. 1 menenggelamkan (a ship). 2 membuang, membatalkan (a plan). to s. away/off berlari tergesa-gesa.
scythe	kb. sabit besar.
sdixteen	kb. enam belas.
se. s.e.	[southeast(ern)] tenggara.
sea	[southeast asia] asia tenggara.
seabed	kb. dasar laut.
seaboard	kb. daerah pesisir.
seaborne	ks. diangkat dengan kapal. s. troops pasukan yang diangkat dengan kapal.
seacoast	kb. pantai laut.
seafarer	kb. 1 pelaut, kelasi. 2 penumpang kapal.
seafaring	ks. yang berlayar di laut. s. vessel kapal laut. s. man pelaut.
seafood	kb. makanan hasil laut.
seagoing	ks. yang berlayar di laut. s. tug kapal tarik laut. s. vessel kapal laut.
seal	kb. 1 anjing laut. 2 segel. 3 tanda, cap. 4 (ring) khatam. 5 meterai. -kkt. menutup (a letter). 2 menyegel (a house, building). 3 membubuhi segel, mencap (a contract). 4 memperkuat, mengunci, men(ge)sahkan. -sealed ks. tertutup.
seam	kb. 1 kelim, pelipit (of clothing). 2 lapisan (of coal).
seaman	kb. (j. -men) pelaut, kelasi, bahariawan.
seamanship	kb. ilmu bahari/pelayaran, kepelautan.
seamless	ks. tanpa kelim. s. hoose kaus kaki wanita yang tak ada kelimnya.
seamstress	kb. penjahit wanita, tukang jahit wanita.
seamy	ks. (paling) buruk. s. side of life segi yang buruk dari penghidupan.
seance, seance	kb. pertemuan untuk mencoba berhubungan dengan roh orang mati.
seaplane	kb. pesawat terbang air.
seaport	kb. bandar, pelabuhan laut, kota pelabuhan.
sear	kkt. membakar, melayur, menyelarkan, menghanguskan. -searing ks. yang membakar (heat).
search	kb. 1 pencaharian, pengejaran (for a lost child, dog). 2 penggeledahan (of a house). 3 penyelusuran, penyelidikan (for information). 4 penyelidikan, penelitian (for a cure). -searching kb. penggeledahan (of a house). ks. menyorot dengan tajam (of eye).
searcher	kb. penyelidik, pemeriksa, penggeledah.
searchlight	kb. lampu sorot.
seashore	kb. pantai laut.
seasick	ks. mabuk laut.
seaside	kb. tepi laut. s. resort tempat bertamasya di tepi laut.
season	kb. 1 musim. 2 waktu, masa.
seasonable	ks. sesuai dengan musimnya (weather).
seasonal	ks. 1 bermusim(-musim), menurut musim (of fruits). 2 musiman. s. worker buruh musiman.
seasoned	ks. 1 pedas. highly s. food makanan yang banyak sekali bumbunya. 2 berpengalaman, sudah makan garam, kawakan. -seasoning kb. bumbu (makanan).
seat	kb. 1 tempat duduk. 2 tempat. 3 kursi. 4 pusat, kedudukan. 5 tempat kedudukan. 6 bagian belakang, pantat (of o's pants). -seated ks. telah duduk. -seating kb. (tempat) /susunan duduk.
seatmate	kb. teman duduk.
seato, s.e.a.t.o.	[southheast asia treaty organization] organisasi pertahanan asia tenggara.
seaward	ks., kk. menuju/mengarah kelaut.
seaway	kb. terusan yang berhubungan dengan laut dan cukup dalam untuk dilalui kapal-kapal laut yang besar.
seaweed	kb. ganggang laut, kemumu.
seaworthiness	kb. kelaikan laut.
seaworthy	ks. laik laut.
sec	kb. inf.: detik. wait as. ! tunggu sebentar !
sec'y	[secretary] sekertaris, panitera.
sec.	1 [second] detik ; kedua. 2 [secant] garis potong. 3 [secretary] sekretaris, panitera. 4 [section] seksi, bagian.
secant	kb. garis potong.
secede	kki. melepaskan diri (from dari).
secession	kb. penarikan diri, pemisahan.
seclude	kkt. memencilkan (o.s. diri). -secluded ks. menyendiri, terpisah. to live a s. life hidup menyendiri.
seclusion	kb. pengasingan, khalawat, pingitan. to go into s. mengasingkan diri.
second	kb. 1 detik, sekon. 2 pendukung, penyokong. 3 (china) piring kedua. 4 nomor dua. 5 persneling dua. - seconds j. barang-barang bekas/murahan. -secondly kk. yang kedua.
secondary	ks. 1 tidak sama penting dengan. 2 kedua. 3 sekunder (of a stress). 4 tambahan.
seconder	kb. pendukung (suatu mosi/usul).
secrecy	kb. (j. -cies) sifat rahasia, kerahasiaan.
secret	kb. rahasia. -ks. yang berhubungan dengan rahasia. -secretly kk. secara rahasia, dengan diam-diam.
secretarial	ks. yang berkaitan dengan pekerjaan seorang sekretaris. s. service tugas-tugas seorang sekretaris.
secretariat	kb. sekertariat, kepaniteraan.
secretary	secretary
secretaryship	kb. jabatan sekretaris.
secrete	kkt. 1 mengeluarkan (a fluid). 2 (hide) menyembunyikan (on o's person).
secretion	kb. pengeluaran, keluarnya.
secretive	ks. suka berahasia.
secretory	ks. yang keluar/mengeluarkan.
sect	kb. mazhab, sekte.
sect.	[section] bagian, seksi.
sectarian	ks. picik, terkungkung pada satu aliran saja.
section	kb. 1 bagian, seksi. 2 golongan. 3 pangsa (of a fruit). 4 urusan. 5 belahan. 6 bab. -kkt. membelah/memotong (a fruit).
sectional	ks. 1 bersekat-sekat. s. book-case rak buku yang bersekat-sekat. 2 setempat (sports, interests).
sector	kb. 1 mil.: sektor, kawasan. 2 bidang, sektor. 3 math.: tembereng.
secty.	[secretary] sekertaris, panitera.
secular	ks. sekular, duniawi. s. education pendidikan sekuler.
secularize	kkt. 1 menerapkan pendidikan kepada hal-hal duniawi (bukan keagamaan) (education). 2 memindahkan kepada urusan kegiatan-kegiatan keduniawian (a monk).
secure	ks. 1 terjamin. 2 terkunci. 3 aman. 4 kokoh. -kkt. 1 mendapatkan, memperoleh (permission, a loan). 2 menjamin. 3 mengunci (a house). 4 melindungi (an area) (against terhadap). 5 menutup rapat-rapat (a bottle top).
security	kb. (j. -ties) 1 jaminan. 2 keamanan. 3 pelindung, perlindungan (with a dog). 4 tanggungan, jaminan. -securities j. surat-surat berharga.
sedan	kb. sedan. s. chair tandu, pelangkin.
sedate	ks. tenang, sabar, tidak ribut.
sedateness	kb. ketenangan (jiwa, hati, pikiran).
sedation	kb. kb. sedasi, pemberian obat penenang.
sedative	kb. obat penenang/penawar, obat pereda nyeri.
sedentary	ks. 1 yang menetap, duduk terus-terus (of a job). 2 tak berpindah-pindah (of pigeons).
sediment	kb. endapan, keladak.
sedimentation	kb. pengendapan.
sedition	kb. hasutan, pendurhakaan.
seditious	ks. durhaka, yang bersifat menghasut.
seduce	kkt. 1 menggoda, memperkosa (a woman). 2 membujuk, merayu.
seducer	kb. 1 kb. 1 penggoda. 2 pembujuk, perayu.
seduction	kb. 1 penggodaan. 2 (pem)-bujukan.
seductive	ks. yang menggairahkan/menggiurkan.
sedulous	ks. rajin sekali.
see	kb. 1 jabatan uskup atau paus. 2 keuskupan. 3 kepausan. -kkt. (saw, seen) 1 melihat (s.o. or s.t.). 2 menjumpai. 4 membaca. 5 membicarakan, pergi ke. 6 menemui, berbicara dengan. 7 memeriksa. 8 mengerti. 9 mengunjungi. 10 bertemu, berjumpa. 11 menjaga.
seed	kb. 1 bibit. 2 benih. 3 biji. -kkt. 1 menyemai bibit untuk (a lawn). 2 membuang biji (a watermelon, peach). 3 sport : menempatkan pada. seeded ks. yang telah ditempatkan pada termpat tertentu dalam urutan (player).
seedbed	kb. pe(r)semaian, pengipukan.
seedless	ks. tak berbiji (of grapes, grape-fruit).
seedling	kb. semaian, ipukan.
seedy	ks. 1 berbiji banyak (of fruit). 2 lusuh (of person, clothing).
seek	kkt. (sought) 1 mencari (a job, book). 2 meminta. 3 mencoba. -kki. dicari, diketemukan.
seem	kki. 1 rupa-rupanya, rasanya. 2 nampak. 3 kelihatannya. -seemingly kk. nampaknya, rupa-rupanya.
seemly	ks. patut, pantas. it's not s. for... tak pantas bagi....
seen	lih see.
seep	kki. merembes, meresap. the water seeped in through the floor air itu merembes menembus lantai itu.
seepage	kb. (air) rembesan, tirisan.
seer	kb. ahli peramal.
seersucker	kb. kain katun yang bergaris-garis datar dan berkerut.
seesaw	kb. 1 papan jungkat-jungkit, domplengan. 2 unggang0unggit. -kki 1 mengungkang-ungkit, jungkang-jungkit. 2 mundur maju (of a game).
seeth	kki. 1 mendidih, menggelegak (of water). 2 mendidih (with anger). 3 hiruk-piruk, ramai.
segment	kb. 1 bagian (of a lot). 2 golongan, daerah. 3 ruas (of a worm). 4 tembereng (of a circle). 5 ulas, pangsa (of an orange). -kkt. 1 mengiris (a fruit). 2 memotong (a circle).
segmental	ks. yang terdiri atas beberapa bagian.
segmentation	kb. pembagian menjadi ruas-ruas.
segregate	kkt. memisahkan, memencilkan.
segregation	kb. pemisahan.
segregationist	kb. penganjur pemisahan (menurut warna kulit).
seine	kb. pukat, pemayang.
seismic	ks. yang berkaitan dengan gempa bumi.
seismograph	kb. seismograf.
seismologist	kb. ahli gempa bumi, ahli ilmu gempa.
seismology	kb. ilmu gempa bumi.
seize	kkt. 1 menangkap, meraih (s.o. before he falls). 2 merampas (a purse). 3 menita, merampas (s.o's property). 4 menggunakan. 5 mence(ng)kam (s.o. by the throat).
seizure	kb. 1 perampasan, penyitaan, pembeslahan (of goods). 2 serangan (of heart). 3 perebutan (of power).
seldom	kk. jarang. he s. if ever goes out ia jarang sekali bepergian.
select	ks. yang terpilih, pilihan. a s. group sekumpulan yang terpilih. -kkt. memilih.
selection	kb. pilihan.
selective	ks. bersifat pemilih, dapat memilih.
selectivity	kb. 1 hal/kepandaian memilih. 2 kemampuan menjaring./menyaring (of tv, radio).
self	kb. (j. selves) diri. -kg. sendiri, dirinya (sendiri). self-addressed ks. yang beralamat sendiri (envelope). self- adjusting ks. dapat mengatur sendiri. self-appointed ks. diangkat sendiri. self-assertive ks. suka mementingkan/menonjolkan diri (sendiri).
selfish	ks. egois, (suka) meemntingkan diri sendiri. -selfishly kk. dengan mengingat kepentingan sendiri.
selfless	ks. tak mementingkan diri sendiri, sepi ing pamrih.
sell	(sold) 1 menjual (s.t.). 2 membuat diterima. 3 menyebabkan terjual (by tv advertising). 4 berdagang. -kki. menjual. -selling kb. berjualan, pekerjaan sebagai penjual.
seller	kb. penjual. seller's market keadaan pasaran yang menguntungkan sipenjual.
sellout	kb. 1 terjual habis (of a concert). 2 inf.: pengkhianatan (to the enemy).
selves	lih self.
sem.	1 [semitic] berkaitan dengan orang semit. 2 [seminary] seminari.
semantic	ks. yang berkaitan dengan arti kata.
semantics	kb. ilmu semantik.
semaphore	kb. 1 tiang sinyal yang dipergunakan sebagai tanda oleh kereta api. 2 pengiriman tanda-tanda dengan menggunakan bendera.
semblance	kb. persamaan, kemiripan (bentuk). he didn't have a s. of a chance sedikitpun ia tak mempunyai harapan.
semen	kb. (air) mani.
semester	kb. semester.
semi-invalid	kb. setengah cacat.
semiannual	ks. setengah-tahunan.
semiattached	kb. tersambung sebagian (of a house).
semiautomatic	ks. setengah otomatis.
semicentennial	kb. peringatan setengah abad. s. celebration perayaan setengah abad.
semicircle	kb. setengah lingkaran.
semicircular	ks. berbentuk setengah bulatan/lingkaran.
semicolon	kb. titik-koma.
semiconscious	ks. setengah sadar.
semidetached	ks. sebagian bersambung (house).
semifinal	kb. semi-final, ronde pertandingan satu tingkat sebelum finale. -ks. semi-final, setengah finale, demi-finale.
semiliterate	ks. setengah buta-huruf.
semimonthly	kb. (j. -lies) majalah setengah-bulanan. -ks. setengah-bulanan.
seminal	ks. 1 yang berkaitan dengan mani. s. fluid air mani. 2 mempunyai kemungkinan berkembang di masa depan.
seminar	kb. seminar. s. on biochemistry seminar mengenai ilmu biokimia.
seminary	kb. (j. -ries) 1 seminari. theological s. seminari teologi. 2 sekolah menengah.
semiofficial	ks. setengah resmi.
semiprivate	ks. 1 bersifat terbatas untuk umum. 2 setengah partikelir/swasta (misalnya sekolah) (room).
semiretired	ks. setengah pensiun.
semitic	ks. yang berkaitan dengan bangsa atau bahasa semit.
semitransparent	ks. setengah tembus-terang.
semivowel	kb. huruf atau bunyi semi-vokal.
semiweekly	kb. (j. -lies) majalah dua kali seminggu. -ks. dua kali seminggu.
sen.	1 [senate] senat, majelis tinggi (dalam dpr) as. 2 [senator) senator. 3 (senior) senior.
senate	kb. senat, dewan. s. (as) senat, majelis tinggi as.
senator	kb. 1 senator, anggota senat. 2 anggota majelis tinggi.
senatorial	ks. yang berkaitan dengan senator. s. committee panitia yang beranggotakan senator-senator, panitia senat.
send	kkt. 1 mengirim(kan) (a letter). 2 menyampaikan (greetings to salam kepada). 3 menurunkan. 4 mengeluarkan (clouds of smoke). 5 mengutus. 6 menyuruh. 7 melemparkan (a ball in a certain direction). 8 menembakkan (an arrow). 9 membuat.
sender	kb. 1 pengirim. 2 (radio) pemancar.
senile	ks. uzur, pikun. s. decay lemah ketuaan.
senility	kb. 1 keadaan uzur, keadaan lemah badan karena usia tua. 2 usia tua.
senior	kb. 1 murid kelas tiga (sma), mahasiswa tingkat iv, senior (in school). 2 orang yang lebih tua. -ks. 1 lebih tua. 2 lebih tinggi. 3 atas (an).
seniority	kb. (j. -ties) 1 kedudukan yang lebih tinggi. 2 masa kerja yang lebih lama.
sensation	kb. 1 sensasi. 2 kegemparan, kegegeran. 3 perasaan.
sensational	ks. menggemparkan, sensasionil (news, a play).
sensationalism	kb. sifat suka menimbulkan sensasi.
sense	kb. 1 pengertian. 2 guna. 3 perasaan. 4 rasa. 5 pendirian. 6 indera. 7 arti. -senses j. pikiran sehat.
senseless	ks. 1 pingsan (from a blow). 2 tolol, bodoh (idea). 3 tidak berperikemanusiaan, tak ada guna (killing).
senselessness	kb. 1 kesia-siaan (of war). 2 keadaan pingsan.
sensibility	kb. (j. -ties) perasaan, kesanggupan merasakan.
sensible	ks. 1 berpikiran sehat, bijaksana. 2 pantas. -sensibly kk. dengan pantas.
sensitive	ks. 1 peka. she's very s. ia sangat mudah tersinggung. rapuh hati.
sensitivity	kb. (j. -ties) 1 kepekaan (of a photo). 2 kehaluan perasaan. s. to colds kelemahan badan terhadap penyakit pilek.
sensitize	kkt. membuat peka. sensitized film pilem yang dibuat peka cahaya.
sensory	ks. yang berhubungan dengan pancaindera. s. organ alat pancaindera. s. perception tanggapan pancaindera.
sensual	ks. berhawa-nafsu. s. enjoyment kenikmatan hawa-nafsu.
sensuous	ks. yang berkaitan dengan pancaindera. s. delight kenikmatan.
sent	lih send.
sent.	[sentence] kalimat.
sentence	kb. 1 gram.: kalimat. 2 hukuman (in court). -kkt. menjatuhkan hukuman, memvonnis.
sententious	ks. singkat tapi berisi padat, singkat dan tegas.
sentiment	kb. perasaan, sentimen.
sentimental	ks. sentimentil. for s. reasons karena alasan-alasan sentimentil. to be s. about sentimentil tterhadap.
sentimentalist	kb. orang yang sentimentil, orang yang lekas terharu.
sentimentality	kb. (j. -ties) perasaan halus.
sentinel	kb. pengawal, prajurit penjaga.
sentry	kb. (j.-ries) pengawal, prajurit jaga. to stand s. berjaga. s. box gardu jaga, rumah jaga monyet.
separable	ks. yang dapat dipisahkan.
separate	kb. salinan (from a periodical). -ks. 1 terpisah. 2 tersendiri. -kkt. 1 memisahkan (milk). 2 menjarakkan (two boxers). -kki. 1 berpisah (of a couple). 2 putus (of a wire, rope). -separately kk. terpisah.
separation	kb. 1 pemisahan (of church and state). 2 perceraian (of a couple). 3 perpisahan. 4 kelepasan.
separatist	kb. separatis, orang yang memisahkan diri. -ks. separatis (tendency).
separator	kb. alat/mesin pemisah. milk s. alat pemisah susu.
sepia	kb., ks. coklat (tua).
sept, sept.	[september] (bulan) september.
september	kb. (bulan) september.
septic	ks. menyebabkan/mengakibatkan busuk/rusuk/infeksi. to become s. membusuk, menjadi infeksi.
septicemia	kb. keracunan darah.
septuagenarian	kb. orang yang berumur 70 tahun.
septum	kb. sekat (of the nose).
sepulcher	kb. kubur, makam, jirat, nisan, mesan.
sepulchral	ks. yang berkaitan dengan kubur.
sequel	kb. 1 sambungan (to a story). 2 akibat. her action had an unfortunate s. tindakannya itu berakibat buruk.
sequence	kb. 1 rangkaian. 2 urutan (of events). 3 rentetan.
sequester	kkt. 1 menyita (property). 2 mengasingkan. -sequestered ks. terasing. to lead a s. life hidup terasing (dari masyarakat ramai).
sequin	kb. perhiasan yang berkelip-kelip.
ser.	[series] seri, deretan.
serbo-croation	kb. 1 orang serbi-kroasia. 2 bahasa serbi-kroasia. -ks. yang berkaitan dengan serbi-kroasia.
serenade	kb. rayuan musik. -kkt., kki. merayu dengan musik.
serendipity	kb. kesanggupan untuk menemukan sesuatu keterangan dengan tak disengaja waktu mencari sesuatu yang lain.
serene	ks. 1 tenang (of a person). 2 tenteram (of the atmosphere, situation). -serenely kk. cerah, jernih, tenang, tenteram, terang dan indah.
serenity	kb. (j. -ties) 1 ketenangan. 2 ketentraman (of a situation).
serf	kb. hamba budak (pengolah tanah).
serge	kb. kain kepar (dari) sutera atau wol.
sergeant	kb. sersan. s. first class sersan satu. s. mayor sersan mayor.
sergt.	[sergeant] sersan.
serial	kb. 1 cerita bersambung, serial. 2 penerbitan bersambungan (library). s. number 1 mil.: nomor pokok. 2 nomor seri (on paper money). -serrially kk. berturut-turut.
serialize	kkt. menjadikan cerita bersambung.
series	kb. 1 rentetan (of lectures, fires). 2 seri. 3 rangkaian.
serious	ks. serius, berat (matter, problem). 2 sungguh-sungguh. 3 menguatirkan. 4 hebat (of an accident). 5 yang menyusahkan. serious-mined ks. bersifat sungguh-sungguh/tekun. -seriously kk. 1 sungguh-sungguh. 2 berat.
seriousness	kb. 1 kegentingan (of a situation). 2 kesungguhan (hati) (of a person).
sermon	kb. 1 khotbah. 2 nasehat, wejangan (by o's parents).
serpent	kb. ular, naga.
serpentine	ks. yang menyerupai ular. s. wall dinding yang berkeluk-keluk.
serrate	kkt. serrated edge pinggir yang bergerigi tajam (seperti gergaji).
serum	kb. serum (darah), air darah.
serv.	[service] layanan, dinas.
servant	kb. 1 [domestic] bujang, pelayan. s. girl babu, pelayan. 2 abdi. public s. abdi rakyat, pegawai pemerintah.
serve	kb. tenn.: giliran. to go for s. cari bola. -kkt. 1 menghidangkan, menyajikan. 2 menjalankan (a tour in the armed forces). 3 melayani. 4 menjalani. 5 melayani, meladeni (a customer). 6 mengabdi kepada. (o's country tanahair). 7 tenn.: (memulai) memukul).
server	kb. 1 tenn.: pemukul pertama. 2 juru sita (of a warrant). 3 (dish) wadah penghidang.
service	kb. 1 jasa. 2 dinas. 3 tugas. 4 (pe) layanan, serpis. 5 rel.: kebaktian. 6 peralatan. 7 jawatan. 8 angkatan. -services j. pekerjaan yang berguna. -servicing kb. pelayanan (of car, appliance).
serviceable	ks. yang berguna, yang dapat dipergunakan. to make s. membuat supaya terpakai.
serviceman	kb. (j. -men) 1 tukang reparasi. 2 mil.: anggota ab.
servile	ks. bersikap merendahkan diri.
servility	kb. (j. -ties) sikap sebagai budak, watak budak.
serving	kb. 1 porsi. one s. of rice satu porsi nasi. 2 penghidangan (of drinks).
servitude	kb. 1 perbudakan, perhambaan. 2 (penal) kerja-paksa.
sesame	kb. bijan, wijen.
sesquicentennial	kb. (peringatan) satu setengah abad.
sess.	[session] sidang, rapat.
session	kb. 1 sidang. to be in s. bersidang. 2 kursus. 3 pembahasan.
set	kb. 1 kumpulan. 2 suiran, letak rambut (of women's hair). 3 perlengkapan. 4 setelan. 5 (tv) pesawat. 6 tempat. 7 tenn.: set. 8 perangkat(an). 9 set, buku. 10 bidang, orang yang kepentingannya sama.
setback	kb. kemunduran. to suffer a s. mengalami kemerosotan.
settee	kb. bangku duduk.
setting	kb. 1 keadaan, letak (for a home). 2 (place) alat makan. 3 pasangan, ikatan (for a jewel). 4 poul.: pengeraman, telur yang dieramkan untuk menetaskannya. 5 latar, tatacara (of a play).
settle	kkt. 1 menenangkan (o's nerves, stomach). 2 membereskan (o's accounts). 3 menyelesaikan. 4 menyudahi (an argument). 5 menempati/mendiami. 6 menempatkan. 7 menjawab. 8 menentukan. 9 turun.
settlement	kb. 1 penyelesaian (of a matter, a strike). to reach a s. mencapai penyelesaian. 2 geog.: perkampungan.
settler	kb. penetap, penghuni tetap. the early settlers were courageous orang-orang yang mula-mula datang menetap sifatnya pemberani.
settling	kb. 1 pwenyelesaian (of a dispute). 2 hal menurun (of a house, foundation). 3 pengendapan (of liquid, sediment). 4 ketetapan (of marriage).
setup	kb. 1 susunan, aturan. 2 sl.: sesuatu yang mudah.
seven	kb. tujuh. to sail the s. seas mengarungi lautan yang luas.
sevenfold	ks.,kk. tujuhkali. to increase s. bertambah tujuhkali lipat.
seventeen	kb. tujuhbelas.
seventeenth	ks. yang ketujuhbelas. augusst 17th tujuhbelas agustus.
seventh	ks. yang ketujuh. s. heaven gembira sekali, puncak kegembiraan.
seventieth	ks. yang ketujuhpuluh.
seventy	kb. (j.-ties) tujuhpuluh.seventy-two tujuhpuluh dua.
sever	kkt. 1 memutuskan (connectious, relations). his thumb was severed jempolnya terputus. 2 memotong (a rope).
several	kb. beberapa orang. s. went beberapaorang pergi. -ks. beberapa.
severance	kb. 1 pemutusan (of connections, relations). s. pay uang pesangon. 2 pemotongan (of an arm).
severe	ks. 1 keras, hebat (storm). 2 berat. 3 keras, bengis. 4 sangat, sekali. 5 sederhana, bersahaja (style of dress). -severely kk. 1 berat. 2 sama sekali.
severity	kb. (j. -ties) 1 kerasnya, kekerasan, kehebatan. 2 kepelikan (of a problem). 3 kesederhanaan (of style, design). 4 kerasnya (of punishment).
sew	kkt. (sewed, sewn) menjahit (clothes). -kki. menjahit. -sewn ks. yang dijahit. -sewing kb. 1 jahit-menjahit. 2 jahitan.
sewage	kb. kotoran, pembuangan kotoran (melalui air).
sewer	kb. penjahit, tukang jahit.
sewerage	kb. 1 penyaluran kotoran. 2 kotoran. s. disposal pembuangan kotoran.
sewn	lih sew.
sex	kb. 1 perkelaminan, sex. 2 jenis kelamin.
sexagenarian	kb. orang yang berumur 60 tahun.
sexiness	kb. 1 daya penarik kelamin. 2 sifat daya penarik kelamin.
sexology	kb. ilmu perkelaminan.
sextant	kb. sekstan.
sextet	kb. 1 paduan suara yang terdiri dari enam orang. 2 musik untuk enam suara atau enam alat musik.
sexton	kb. pengurus/penjaga gereja.
sexual	ks. seksuil. s. characteristics ciri-ciri seksuil/kelamin. -sexually kk. secara seksuil.
sexy	ks. inf.: menggairahkan, menggiurkan.
sgt.	[sergeant] sersan.
sh(h)	kseru. husy.
shabbiness	kb. keburukan, kejorokan, kejembelan.
shabby	ks. 1 jorok, jembel (appearance). 2 busuk. -shabbily kk. buruk, lusuh.
shack	kb. pondok, gubuk. -kki. sl.: to s. up with tinggal dengan.
shackle	kb. 1 belenggu, kongkong. 2 alat penyangga (of car springs). -kkt. membelenggu, mengongkong.
shad	kb. semacam ikan laut.
shade	kb. 1 naung(an), tempat teduh. 2 window) tirai (jendela). 3 kere' (on porch). 4 corak. 5 perbedaan (of opinion). 6 lih lamp. -shading kb. pembuatan bayangan.
shadiness	kb. keadaan rindang.
shadow	kb. 1 bayangan, bayang-bayang. 2 (jumlah) sedikit. -kkt. 1 menaungi, membayangi. 2 membuntuti (s.o).
shadowbox	kki. bertinju melawan bayangan.
shadowy	ks. merupakan seperti bayangan.
shady	ks. 1 teduh, rindang. s. spot tempat yang teduh. 2 inf.: curang. s. deal transaksi yang curang.
shaft	kb. 1 tangkai, batang, patil (of a spear, axe). 2 lubang, terowongan (of a mine, elevator). 3 sorotan, berkas (of light). 4 (monument) tugu. 5 kata-kata (of satire or ridicule). 6 corong (of a mine).
shaggy	ks. 1 berbulu kusut (dog). 2 berbulu kasar (coat). 3 berewok (of hair, mustache).
shake	kb. 1 geleng(an) (of the head). 2 (hand-) jabatan tangan. 3 goncangan (from a quake). 4 kocokan. -shakes j. gemetar. -shaking kb. goncangan, getaran (of the ground).
shaken	lih shake.
shaker	kb. 1 (salt, papper) botol, tempat. 2 alat kocok, pengocok (for milk, cocktail).
shakeup	kb. inf.: perubahan yang drastis (dalam kebijaksanaan, kepegawaian).
shakiness	kb. keadaan goncangan, kegoyahan.
shaky	ks. 1 gemetar, goyang. 2 goyah (ground). -shakily kk. secara gemetar.
shale	kb. serpih.
shall	kkp. 1 akan. 2 boleh. 3 dapat. -shalt boleh. -should 1 akan. 2 sebaiknya.
shallow	kb. shallows j. tempat yang dangkal. -ks. dangkal (water).
shallowness	kb. kedangkalan.
shalt	lih shall.
sham	kb. pura-pura. -kkt. (shammed) berpura-pura. -kki. berpura-pura.
shaman	kb. dukun (sihir), cenayang.
shambles	kb., j. keadaan kacau/berantakan. the tornado left the house a s. angin puyuh itu menyebabakan rumah hancur porak-poranda.
shame	kb. rasa malu, arang di muka. -kkt. memalukan (s.o.).
shamefaced	ks. kemalu-maluan. -shamefacedly kk. dengan kemalu-maluan.
shameful	ks. memalukan. -shamefully kk. secara memalukan.
shameless	ks. tak tahu malu. -shamelessly kk. tanpa malu.
shammy	(j. -mies) lih chamois.
shampoo	kb. langir, pencuci rambut. -kkt. melangiri, mencuci rambut. -kki. berlangir.
shan't	[shall not] lih shall.
shanghai	kkt. inf.: menculik (dengan membuat tak sadar dengan obat-obat atau minuman keras).
shank	kb. tulang kering. to go on shank's mare berjalan kaki. s. of the day hari sore.
shanty	kb. (j. -ties) pondok (buruk), gubuk.
shantytown	kb. kota gubuk.
shape	kb. 1 bentuk. 2 potongan (of clothes, jewelry). 3 keadaan, kondisi. -kkt. 1 membentuk (s.t.). 2 menentukan (o's future). -kki. memperoleh bentuk tertentu.
shapeless	ks. tak berbentuk.
shapeliness	kb. keadaan berpotongan (baik).
shapely	ks. berbentuk indah, baik bentuknya, rupawan.
share	kb. 1 (plow-) mata bajak. 2 bagian. 3 saham, andil. -kkt. 1 bersama-sama mendiami (a room, apartment). 2 bersama-sama menanggung (expenses, responsibility). 4 memberikan.
sharecrop	kkt., kki. (sharecropped) bertani bagi-hasil.
sharecropper	kb. petani bagi-hasil.
shareholder	kb. pemegang saham. he's a large s. in ia seorang yang banyak mempunyai saham pada.
sharer	kb. seorang yang membagi
shark	kb. 1 ikan hiu/yu. 2 sl.: bridge : pemain. 3 lintah darat, penipu.
sharp	kb. mus.: kenaikan/kelebihan tinggi nada setengah tajam. sharp-eyed ks. 1 tajam penglihatan(nya). 2 cerdik. sharp-pointed ks. 1 runcing, berujung tajam (pencils). 2 mancung (shoes). -sharply kk. 1 dengan menyolok. 2 tajam. 3 secara/dengan pedas.
sharpen	kkt. 1 meruncingkan, merancung (a pencil). 2 mengasah (a blade). 3 mempertajam (o's wits). -kki. melengking (of o's voice).
sharpener	kb. (alat) pengasuh.
sharpie	kb. sl.: penipu.
sharpness	kb. 1 jelasnya/terangnya (of a photo). 2 nyaringnya (of a voice, tone). 3 tajamnya (of a turn in the road, of sight). 4 kecerahan (of weather). 5 rasa pedas (of a sauce).
sharpshooter	kb. penembak jitu.
shatter	kkt. 1 menghancurkan (a window, o's hopes). 2 memecahkan (the silence). -kki. hancur, pecah.
shatterproof	ks. tahan remuk, tahan pecah berpelantingan.
shave	kb. to get a s. bercukur. -kkt. (shaved, shaved atau shaven). 1 mencukur (s.o.). 2 mengetam (a door). 3 mengiris (vegetables, chocolate). -kki. bercukur. -shaven ks. gundul (head). -shaving kb. bercukur. -shavings j. serutan, tatal.
shaven	lih shave.
shaver	kb. 1 alat cukur. electric s. alat cukur listerik. 2 inf.: anak kecil (lelaki).
shavetail	kb. letnan dua (yang baru).
shawl	kb. syal, selendang.
she	kb. perempuan. -kg. ia, dia (perempuan). she-goat kambing betina.
she'd	1 [she had] sudah, telah. 2 [she would] akan.
she'll	1 [she shall] ia akan. 2 [she will] ia mau.
she's	1[she is] akan. 2 [she has] sudah, telah.
sheaf	sheaf
shear	kb. shears j. gunting besar. -kkt. (sheared, sheared atau shorn). mencukur (sheep). -shearing kb. pencukuran (of sheep).
sheath	kb. 1 sarung (for sword). 2 bot.: pelepah (daun). 3 baju ketat (dress).
sheathe	kkt. menyarungkan. -sheathing kb. bahan pelapis, lapisan (for walls).
sheaves	lih sheaf.
shebang	kb. 1 sl.: perusahaan. he controls the whole s. ia menguasai seluruh perusahaan itu. 2 sl.: peristiwa, pesta.
shed	kb. bangsal, lumbung, gudang. -kkt. 1 mencucurkan, menitikkan (tears). 2 menumpahkan (blood). 3 membuka, melepaskan (o's coat). 4 berganti bulu (featers). 5 tahan. 6 memberi. 7 memancarkan (a soft light). 8 menggugurkan, melepaskan (leaves).
