gae, gaek	(coll.) old.
gaet	hook, snare. meng-gaet 1 snatch, hook. 2 rake in. 3 tickle with fingers to catch s.o.'s attention.
gaga	see gogo 1.
gagah	1 strong. 2 brawny, muscular. 3 handsome, dashing. 4 heroic, brave, dauntless.
gagai	meng-gagai climb a tree by embracing the trunk.
gagak	raven, crow.
gagal	fail.
gagang	1 handle. 2 stem, stalk, spadix.
gagap	1. stammer, stutter. 2. meng-gagap feel, grope.
gagas	have an idea.
gagasan	1 idea. 2 concept.
gagau	1. meng-gagau grope. 2. ber-gagau-gagau-an scream uncontrollably.
gagu	1 mute, dumb. 2 empty-minded, void of ideas.
gaguk	see gagap 1.
gahar	meng-gahar scrub, scour.
gahara	(lit.) of royal descent.
gahari	moderate.
gaharu	k.o. tree eaglewood, the rotted xylem of which yields fragrant resinous material.
gaib	1 mysterious. 2 invisible, hidden, inscrutable (meaning, etc.). 3 disappear, vanish (of gods, etc.) 4 belonging to the invisible (divine or supernatural) sphere. 5 in absence.
gaing	(naut.) sheer.
gairah,gairat	passion, strong desire.
gait	meng-gait 1 pull, book, pluck (fruit, etc. with a pole). 2 wheedle money, etc. from s.o.). 3 swipe, steal, purloin.
gajah	1 elephant. gajah-mada 1) the prime minister of majapahit. 2) name of a university in yogyakarta. 2. (che.) bishop.
gaji	wage, salary.
gajih	(java) fatty portions of meat.
gajuh	cashew.
gajul	scoundrel, rascal. ber-gajul 1 hang around engaging in petty criminal activities. 2 act like a scoundrel.
gak	see nggak.
gakang	(ga'ang) see gaang.
gala	1. resin, pitch. 2 caulking. 3 a resin-collecting bee. gala-gala putty. 2. gala-yudha (mil.) field test. 3. main-gala-asin k.o. children's game. 4. see segala.
galah	1. 1) punting pole. 2) spear. 2. see gala 3.
galak	1 fierce, vicious. 2 sharp and mean. 3 impudent, forward.
galaksi	galaxy.
galang	girder, supporting beam.
galant	gallant.
galantin	galantine, k.o. meatloaf.
galar	1 k.o. mat made of bamboo pounded flat. 2 board, two-by-four.
galas	1 carrying pole. 2 goods carried on a shoulder pole. 2 peddle merchandise (carried in containers suspended from carrying poles).
galasi	(jakarta) k.o. poisonous spider.
galat	see ralat.
galau	hubbub, confusion.
galbani	meng-galbani galvanize.
galengan	(java) small dike in rice field.
galenika	k.o. patent medicine.
galgal	hurried and rude (in activity, behavior, etc.).
gali	1. meng-gali 1) dig ( hole, well, mine, grave). 2) dig up (potatoes, etc.), excavate, unearth, exhume. 3) delve. 4) unearth, discover. 2. [gabungan anak liar] ( sl.) 1) gang of street toughs. 2) racketeers.
galib	normal.
galing	see ikal.
galing-galing	k.o. wild climbing vine.
galir	1 loose (of screws, key, ring, etc.). 2 fluent, glib, articulate. 3 agile, nimble, spry.
galon	gallon.
galungan	balinese celebration, lasting 10 days and occurring once every 210 days according to the wuku calendar.
galur	1 furrow, groove. 2 channel.
galuran	probing back into s.t.
galvanisasi	meng-galvanisasi-kan galvanize.
gama	(gajah mada) gajah mada university in yogyakarta.
gamak	meng-gamak-gamak 1 take s.t. in hand to feel size or estimate its weight. 2 estimate, make a guess. 3 put o.'s hand threateningly on the hilt of a dagger.
gamalisasi	planting of gamal trees to eliminate elephant grass.
gamam	see gamang.
gaman	weapon. ber-gaman armed.
gamang	1 nervouse, afraid. 2 feel dizzy from heights.
gamat	sea cucumber, sea slug.
gamawan	male student at gajah mada university, yogyakarta.
gamawati	female tudent at gajah mada university, yogyakarta.
gamb.	[gambar] illustration, picture.
gambang	traditional instrument similar to xylophone. gambang-keromong 1 small popular chinese-indonesian orchestra. 2 jakarta gamelan.
gambangan	yoke.
gambar	1 picture, drawing. 2 sketch.
gambas	k.o. squash.
gambir	1 gambier, ingredient used in betel chewing, tanning and dyeing. 2 the climbing plant that produces gambier.
gamblang	(java) 1 clear, understandable.2 explicit, mincing no words.
gamblok	ng-gamblok 1 be attached to, hold on to. 2 join.
gambuh	(java) 1 a make dancer. 2 k.o. dance.
gambus	1 k.o. six-stringed, plucked instrument of arabic origin, us. accompanied by a drum. 2 band with such an instrument or a harmonium and with other instruments plaing arabian songs.
gambut	1 peat moss. 2 turf.
gambyong	(java) k.o. woman's dance. ng-gambyong perform this dance
game	(gim) 1 expression signalling end of a game. 2 (sl.) dead.
gamelan	gamelan orchestra.
gamik	see gamit.
gamis	k.o. arab-style shirt.
gamit	ber-gamit(an) 1 nudge, atap s.o. on the shoulder, arm. 2 attract s.o.'s attention.
gampang	easy.
gampar	stike, slap.
gamparan	1 slap, stroke. 2 wooden clog, flapping slipper.
gamping	limestone.
gamuh	k.o. water jar.
gan	see juragan.
gana-gini	see gono-gini.
ganang	see gunung.
ganas	savage, ferocious, vicious. 2 malignant (tumor).
gancang	quick, spray, alert.
gancaran	(java) prose.
ganco, gancu	1 pole with a hook (e.g. to pluck fruit from trees). 2 boat hook. 3 pickax.
ganda	1. fold. 2. 1) opponent of unequal strength. 2) (sport) handicap.
gandal	gandal-an, peng-gandal obstache, hindrance.
gandapita	k.o. cake.
gandapura	k.o. tree whose fragrant leaves are used for medicinal purposes and whose seeds smell like musk.
gandar	1. 1) lever, arm of scales. 2) axle of wheel. 3) carrying pole. 2. drive a vehicle.
gandaria,gandariah	ko. tree bearing edible fruit, used for medicinal purposes.
gandarukam	k.o. tree that provides resin used for caulking, soap, etc.
gandarusa	various k.o. small trees the leaves of which are used for medicinal purposes.
gandaruwa	see gendruwo.
gandasuli	k.o. medicinal herb.
gandel	clapper (bell).
ganden	see gandin.
gandeng	ber-gandeng 1 side by side, arm in arm. 2 coupled.
ganderuwo	see gendruwo.
gandes	(java) graceful, charming, elegant.
gandik	1 golden ornament worn on forehead by bride. 2 ornament on top of a kris. 3 milling stone.
gandin	large mallet.
ganding	see gandeng.
gandol	see gandul.
gandos	k.o. cookie made of rice flour and coconut.
gandrung	1 infatuated, in love, crazy about. 2 devoted to a cause.
gandu	k.o. flat black seed as marble.
ganduh	ber-, meng- barter, exchange by providing s.t. extra in the exchance.
gandul	ber-gandul-an hang down (of several things).
gandum	1 wheat. 2 wheat flour.
gandung	outrigger.
gandungan	see gadungan.
ganesa	ganesha, hindu elephant god.
gang	1. 1) alley, narrow street. 2) corridor, passageway. 2. gang (of thieves, etc.).
ganggang	1. algae, seaweed. 2. space between two objects. 3. ber-gangang 1) warm o.s. by a fire. 2) warm things on a fire.
ganggu	meng-ganggu 1 disturb. 2 disturb, intrude on, interfere with. 3 annoy, molest.
ganggut	meng-ganggut pull, tug.
gangsa	1. brass. 2. k.o. meat dish. meng-gangsa fry with little oil. 3. see angsa.
gangsal	see gasal.
gangsang	see gasang.
gangsar	see gangsir.
gangsing	see gasing.
gangsir	(java) mole cricket. meng-gangsir undermine, dig a tunnel, furrow. peng-gangsir s.t. that burrows.
ganja	1 hemp plant. 2 hashish, marijuana. peng-ganja drug addict.
ganjak	ber-ganjak budge, move a bit.
ganjal	1 a wedge. 2 a prop, support.
ganjar	reward.
ganjaran	1 reward. 2 just deserts, punishment, retribution.
ganjat	1 have a cramp (in muscles, etc.). 2 tangled (of thread, etc.).
ganjel	see ganjal.
ganjen	(coll.) coquettish.
ganjil	1 uneven, odd (of numbers). 2 queer, odd, abnormal.
ganjur	1. k.o. lance or pike. meng-ganjur-i spear s.t. 2. k.o. rice borer. 3. ber-ganjur withdraw, pull back.
gantang	measure of rice equivalent to 3.125 kg, around o. quart.
gantar	stake, post.
gantel	1. (java) meng-gantel-i hang from. 2. stick.
ganteng	handsome, dashing.
gantet	(java, jakarta) stick.
ganthol	see gantol.
ganti	1 substitute, replacement. 2 change (name, clothes, etc.). 3 over (of radio operators).
gantol	(java) meng-gantol catch with a large hook. gantol-an good-sized hook to sieze with.
gantole	hang glider.
gantung	meng-gantung 1 hang (a person) 2 hang up (clothes). 3 adjourn, suspend (a legal case) 4 be suspended.
ganyah	meng-ganyah 1 polish (with sandpaper, etc.). 2 rub or massage vigorously, scrub. 3 strike hard (with a fist).
ganyang	meng-ganyang 1 eat raw, devour. 2 smash, crush. 3 eliminate, wipe out.
ganyar	hard (of uncooked tubers).
ganyong	(java, sunda) k.o. edible tuber.
ganyut	see ganyar.
gaok	(java) 1 k.o. bird, crow. 2 cawing sound. meng-gaok caw.
gap	1 sound of slapping on a table. 2 sound of heartbeat.
gapa,gapah	1. skillful, adroit, agile. 2. gapah see gopoh.
gapai	ber-an, meng-(2) 1 reach for, extend the hand for,grasp after. 2 wave (o.'s hand) to. 3 achieve, attain.
gapak	see gapa.
gapik	see gopoh.
gapil	meng-gapil interfere in.
gapit	pincers, tweezers, clamp.
gaple	dominoes.
gaplek	dried cassava.
gaplok	(java) meng-gaplok slap s.o. on the back.
gapmni	[gabubgab pengusaha makanan - minuman] association of food and drink producers.
gapu	meng-gapu reach, extend to.
gapura	gate, gateway, portal.
gara-gara	1 (java) scene in traditional wayang depicting turbulence and war. 2 turbulence, commotion (in war or of nature). 3 natural phenomenon (earthquake, typhoon, etc.). regarded as an omen (us, bad). 4 just be cause (of).
garage	[garase] see garasi.
garah	1. frighten away, chase away (birds, etc.). 2. garah-garah joking, jesting.
garam	1 salt. 2 a mineral salt. 3 experience, effectiveness (in idioms).
garan	(java) handle.
garandir	meng-garandir guarantee.
garang	1) fierce, cruel, ferocious. 2) vivid (of colors). 3) very strong. 4) angry.
garangan	mongoose.
garansi	guarantee, warrant.
garap	meng-garap work on.
garas	1. shin. 2. meng-garas eat, gobble up.
garasi	garage.
garau	hoarse.
garba, garbha	(biol.) embryo.
garbis	(java) k.o. round, yellow and black melon.
garda	guard.
gardan	(auto.) differential gear.
garden,gardin	see gorden.
gardu	1 guardhouse. 2 bus shelter. 3 (mil.) depot, dump, magazine. 4 (tech.). relay station.
garebek	(java) o. of the three major muslim religious festivals.
gareng	(java) k.o. cicada that appears at end of rainy season. gareng son of semar in java shadow play.
gari	handcuffs. meng-gari handcuff, shackle, manacle.
garib	strange, peculiar, exotic.
garing	1 dry and crispy, crunchy. 2 cool (of a relationship).
garis	1 line. 2 (sport) finish line. 3 frontier, border. 4 (sport) boundaries, bounds.
garisah	instinct.
garit	1. scratch. 2. meng-garit move.
garneren,garnering	[harneren,harnering] (coll.0 cake icing or decoration.
garnisun	(mil.) garrison.
garong	robber.
garpu	fork.
garu	1. harrow. 2. see gaharu.
garuda	1 mythical bird, mounted by god vishnu. 2 bird in official seal of rerpublic of indonesia.
garuk	round up.
garung	1. meng-garung 1 grow, roar. 2 cry or weep loudly. 2 see garong.
garut	meng-garut abrade, chafe.
garwa	/garwo/ (honorific, java) spouse.
gas	1 gas. 2 vapor from gasoline.
gasak	1 fight. 2 hit.
gasal	(math.) uneven, odd (of a number).
gasang	lustful, lecherous, lascivious.
gasing	a top. ber-gasing spin a top.
gasket	gasket.
gasolin	gasoline.
gasung	sandbar.
gatal	1 itch. 2 eager for s.t. (money, etc., but esp. sex). 1 itchiness. 2 irritation.
gatot	(java) sliced dried cassava boiled with coconut milk.
gatra	phrase (in a sentence or in music).
gatuk	(java) match, meet, coincide.
gatutkaca	son of bima, o. of the pendawa brothers in the java wayang.
gaul	ber-gaul associate.
gaun	gown, wedding dress.
gaung	1. echo, reverberation. 2. hole, ravine.
gawai	see gawe.
gawal	mistake, error.
gawang	1 gate. 2 (sport) goal posts. 3 (sport) hurdles. gawang-gawang-an wicket.
gawar	warning sign (us. by means of ropes).
gawat	1 critical, serious, grave. 2 dangerous, risky. 3 bad, terrible.
gawe	(jakarta, java) work.
gawir	(sunda) escarpment.
gaya	1 energy, force. 2 style, form, manner. 3 musical note, melody.
gayal	1 elastic. 2 tough of meat.
gayam	k.o. semicultivated inocarpus tree with pulpy fruits eaten cooked.
gayang	staggering, reeling (from dizziness, drunkenness, etc.).
gayang-gayang	a rack.
gayem	(java) meng-gayem(i) chew the cud.
gayeng	(java) 1 pleasant, warm, cordial (attitude). 2 cheerful, interesting (conversation).
gayuh	1. hang low (of fruit on tree or bush). 2. aspiration, ideal, objective. meng-gayuh achieve.
gayung	1 water dipper, scoop. 2. attack(with sword or blow).
gayut	ber-gayut hang, swing.
gb.	(gambar) illustration.
gbhn	[garis-garis besar haluan negara] (pol.0 broad outlines of the nation's direction.
gbr.	see gb.
gebah	meng-gebah chase away, chase out.
gebang	(java) tall thornless jungle palm with large leaves.
gebar	see kain.
geber	1. meng-geber vibrate (of an engine). 2. meng-geber give too much of s.t.
gebes	meng-gebes-kan move s.t.
geblak	(java) ng-geblak fall backward.
geblas	(java) meng-geblas go away hurriedly.
geblek	see goblok.
geblok	(java) 1 bolt of cloth. 2 wad of money.
gebok	bolt of cloth.
gebos	1. meng-gebos scold, snap at, sanarl at. 2. (java) meng-gebos suddenly let off smoke.
gebrak	sound of a door slamming, board crashing to floor, etc.
gebrakan	1 (karate) blow, chop. 2 blow, slap (on table, etc.).
gebres	(java) sneeze.
gebu	meng-gebu-gebu 1 flare up (of fire, revolt). 2 rage. 3 be tense and excited with enthusiasm, worked up for action.
gebuk	meng-gebuk beat (a drum). meng-gebuk-i pummel, beat up.
gebyah	(java) meng-gebyah-uyah consider all to be the same, make no distinction.
gebyak	(java) meng-gebyak perform, stage.
gebyar	(java) sparkle, shine, glitter.
gebyur	(java) meng-gebyur splash a large amount of water on s.o. or s.t. gebyur-an water splashed out.
gecak	see gecek.
gecar	trembling, fright. meng-gecar shudder, tremle (from fear).
gecek	(java) meng-gecek 1 crush, smash (i.e. food to soften it, etc.). 2 catch, seize, grasp.
gedabah	triangle-shaped gold hair ornament.
gedang	1. large, big. meng-gedang-kan enlarge, increase, expand. 2. (sunda) papaya.
gede	(coll.) big, large. ke-gede-an too big. peng-gede (sl.) big shot.
gedebak	gedebak-gedebuk/gedebur 1 sound of s.t. heavy having fallen. 2 sound of footsteps on a floor. meng-gedebuk-kan stamp s.t. down hard.
gedebar-gedebur	sound of beating or throbbing, beat or throb.
gedeblak-gedebluk	sound of wrestling and fighting.
gedebok	1. (java) trunk of a banana plant, esp. as a place to arrange wayang puppets. 2. see gedebuk.
gedebrak-gedebruk	loud sound of s.t. heavy falling, very loud stamping of the feet.
gedebuk	sound of heavy footsteps. ber-gedebuk with a thud. (ber)-gedebuk-an make a pounding or thudding noise.
gedebum	see gedebuk.
gedebung	square of cloth formed into a pouch often for betel leaves and tobacco.
gedebur	see gedebar-gedebur.
gedek	panel of woven or plaited bamboo (for house walls, etc.).
gedempak	tambourine.
gedempol	fat, obese.
gedeng	(java) sheaf (of rice).
gedobros	(java) ng- talk nonsense.
gedok	meng-gedok weave. gedok-an primitive handloom.
gedombrongan	(coll.) too large (of clothes).
gedoncak	ber-gedoncak beat (of heart).
gedong	fancy house, mansion.
gedongan	having or living in a large, stone house.
gedor	meng-gedor 1 pound on. 2 break in to plunder.
gedruk	(java) meng-gedruk stamp. gedruk-an stamping (of feet).
gedubrak	(java) meng-gedubrak make a sudden popping or crashing noise.
gedubrang	see gedubrak.
gedumbreng	sound of jangling or clanking (e.g. of cans banging against e.o.). gedubrang-an keep making this sound.
gedumel	see kedumel.
gedung	building (us. of brick concrete), edifice. gedung-bertingkat multistoried building. gedung-instansi 1 public building. 2 building owned by a firm.
geduyut	ber-geduyut droop, bend (from heavy branches, etc.).
gegabah	rash, reckless, hasty.
gegak	see gegap 1.
gegaman	hand weapon.
gegaokan	(java) caw.
gegap	gegap-gempita uproarious, noisy, clamorous.
gegar	shaking, swaying. ber-gegar-an tremble, shake, rumble (plurally).
gegares	stuff, gorge o.s.
gegas	lots of movement and activity. ber-gegas-an hurry.
gegat	1. k.o. insect, silverfish. 2 see kegat.
gegau	ter-gegau starled, wake up with a start.
gegep	pliers, tweezers.
geger	1 commotion, tumult. 2 be in a tumult.
gegetuk	see getuk 1.
gegetun	surprised, dumbfounded.
geguyon	joke, make a joke.
gejala	1 symptom, indication. 2 tendency. peng-gejala-an process of be coming conspicuous.
gejolak	1 flaming, fire. 2 fluctuation (in prices).
gejos	sound of sizzling (when water is poured over hot coals, etc.).
gejug	(java) meng-gejug kick in fighting (in martial arts, dance). gejug-an kick, blow with the feet.
gejuju	meng-gejuju build up, pile up (of clouds).
gelabak	see geletak.
gelabur	meng-gelabur plunge into water.
geladah	see geledah.
geladak	1. (naut.) deck. 2. 1) mongrel dog. 2) criminal.
geladi	rehearsal.
geladir	1 mucus, phlegm. 2 slime.
gelagah	wild sugarcane.
gelagak	see gelegak.
gelagapan	1 stutter, stammer. 2 confused, flustered, upsed. 3 losing direction. 4 make gasping noises when drowning.
gelagar	ber-gelagar-an thunder (of cannons).
gelagat	1 sign, indication. 2 symptom. 3 attitude. 4 habits.
gelagepan	see gelagapan.
gelak	1 laughter. 2 laugh, chortle.
gelakak	hearty laugh.
gelam	k.o.melaleuca tree and its bark which is used for caulking.
gelama	1. k.o. sea fish. 2. mucus, phlegm.
gelamai	sweet made of pounded sticky rice, coconut, and sugar. meng-gelamai prepare this sweet.
gelambir	wattle of fowl, jowls, or other watterlike skinfold in animals. ber-(an), meng-gelambir hang down like jowls.
gelandang	(sport) halfback.
gelandangan	vagrant, homeless drifter.
gelang	bracelet. gelang-gelang tapeworm. per-gelang-an circle.
gelanggang	1 circular area in which an event takes place : arena, forum, pit, ring. 2 a round area which forms the backround for s.t.
gelangsar	meng-gelangsar slide, slip up.
gelantar	meng-gelantar bleach, dry in the sun.
gelanting,gelantung	ber-gelantung hang down, dangle, steady o.s. by holding onto s.t. above.
gelantur	meng-gelantur flow forth, come forth.
gelap	1 dark. 2 unclear, obscure. 3 secret, illicit, clandestine(organization). peng-gelap embezzler.
gelapai	meng-gelapai fight feebly (of cocks).
gelar	1. 1) title. 2) academic title, degree. 3) alias. 2. meng-gelar spread out. gelar-an carpet, mat to sit on.
gelas	glass (for drinking). meng-gelas coat kite string with ground glass.
gelatak	1. meng-gelatak tickle. 2. meng-gelatak-i hunt or search through (pockets, drawers, etc.0.
gelatik	k.o. bird that eats rice crops, java finch.
gelayaran	stagger.
gelayut	see gayut.
gelebap	sound of an object falling, plop.
gelebar	ber-, ter flap (of sail, shirt, tail, etc.). meng-gelebar plop o.s. down.
geleber,geleberan	hang loosely, hang in folds (of skin, clothing).
gelebuk	sound of an object falling.
gelebur	meng-gelebur plunge, jump into (a fire, etc.).
gelebyar	ber-fly around.
gelecek,gelecik	meng-gelecek skid, slip, slide.
geledah	meng-geledah search (a building), frisk (a person), ransack.
geledang	meng-geledang extend the arms (as if to ward or hold off s.t. or s.o.).
geledek	thunder, lightning.
geleding	meng-geleding twist, warp (of wood, etc.).
geledur	have folds (of fat around the abdomen).
gelegak	ber-, meng- 1 buble, effervesce, fizz, seethe. 2 wheeze. meng-gelegak-kan bring to a boil, make s.t. seethe or wheeze.
gelegapan	see gelagapan.
gelegar	1. (floor) beam, girder, joint. 2. thundering, rumbling, sound of cannon.
gelegata	itchy rash, prickly heat.
gelek	1. meng-gelek 1 roll over. 2 roll. 3 run over, crush as in mortar. 4 dodge, get out of the way. 2. (sl.) marijuana.
gelekak	meng-peel (of paint, scabs, etc.).
gelekek	meng-gelekek giggle, snicker.
gelemat	(naut.) forecastle.
gelemberan	wattle of fowl.
gelembung	1 bubble. 2 (anat.) vesicle. 3 swollen. ber-, meng-gelembung be inflated.
gelembur	ripple.
gelempang	see gelimpah.
gelemprang	ber-gelemprang high-pitched, piercing (of sound).
gelendong	s.t. to wind s.t. around : bobbin, spool, coil, reel.
gelendot	meng-gelendot pull to attract attention.
geleng	move from side to side (of o.'s head) geleng-an a shake of the head.
gelenggang	see gelinggang.
gelentang	ber-gelentang roll over.
gelentar	see geletar.
gelenyar	meng-gelenyar tingle.
gelepak	sag, collapse (of bridge, etc.).
gelepar	fluttering.
gelepek	hang loosely, hang limply (of flag, etc.).
gelepok	/gelepot/ muddy, muddied.
gelepung	sound of heavy object hitting water.
gelepur	flapping, fluttering (of dying or fighting fowl).
geler	see gilir.
geleser	meng-geleser 1 begin to turn, begin movement. 2 flutter, move agitatedly.
geleta	long-necked jug.
geletak	flounder, flutter. meng-geletak sprawl.
geletar	ber-, meng-geletar 1 shiver, tremble. 2 beat (of o.'s heart).
geletik	meng-geletik 1 move agitatedly, twitch, squirm. 2 make tick-tock sound (of watch or clock). 3 throb, beat (of o.'s heart).
geleting	meng-tinkle (as of ice in a glass).
geletis	meng-geletis twitch, squirm.
geletuk	chattering (of teeth).
geli	1. 1) amused, tickled. 2) ticklish. 3) set o.'s teeth on edge, give o. the creeps. 2. see buah.
geliang,geliang-geliut	writhe, wriggle. ber-geliang wriggle, squirm.
geliat	geliat-geliut writhe, wriggle.
gelibir	see gelimbir.
gelicik	meng-gelicik-kan avoid, evade. ter-gelicik skid, slip.
geliga	see guliga.
geligi	see gigi.
geligir	geligir-hidung bridge of nose.
geligis	meng-geligis 1 tremble, quiver, shudder, shake. 2 chatter (of teeth).
geligit	meng-geligit bite repeatedly.
gelimang	ber-gelimang be soiled, smeared, covered with s.t. wet. gelimang-an shallow pools of liquid, mud, etc.
gelimbir	hang loosely, hang in folds. meng-gelimbir dangle, be pendulous. gelimbir-an sagging.
gelimpah, gelimpang	ber-gelimpah-an be sprawled face up all over.
gelinang	meng-gelinang form in the corners of the eyes (of tears).
gelincir	meng-gelincir slip, skid.
gelincuh	ter-gelincuh stumble.
gelinding	wheel.
gelindingan	caster.
gelinggam	1 red lead. 2 red dye, red paint.
gelinggaman	shudder, get the creeps.
gelinggang	k.o. shrub, used to treat ringworm.
gelingsir	ber-, meng-gelingsir 1 slide or slip down while revolving. 2 descend, go down (of the sun). 3 shift or move downward or forward.
gelinjang	meng-gelinjang 1 jump up and down. 2 wriggle with pleasure.
gelintang	ter-gelintang sprawled.
gelintin	ber-gelinting 1 sticky. 2 thick, concentrated.
gelinting	meng-gelinting 1 roll (cigarette, etc.). 2 writhe, squirm.
gelintir	1 pellet. 2 counter used with small pelletlike objects. 3 counter used with persons. 4 a general all-purpose counter.
gelis	(sunda) lovely, pretty.
gelisah	1 nervous, on edge, restless. 2 worried, concerned.
gelisir	meng-gelisir slide s.t. a short distance.
gelita	see gulita.
gelitar	meng-gelitar struggle, move about to free o.s.
gelitik	1 tickle, tickling. 2 stimulus, incitement, inducement.
geliut	ber-geliut writhe, squirm.
gelo	(java) be disappointed and therefore be hurt and angry.
gelo,gelok	1 out of o.'s mind, crzy. 2 unmannered, foolish.
gelobok	meng-gelobok make a sound like a bottle being filled with water.
gelocak	see gelojak.
gelodar	1. meng-gelodar squirm, writhe. 2. turbid from mud.
gelogok	1. swig (of whiskey), gulp (of water). meng-gelogok 1) gulp down. 2) seethe, boil. 3) spill a large quantity. 2. a threat.
gelohok	ter-gelohok opened wide.
gelojak	ber-, ter-gelojak slap, wash against (of waves against side of boat).
gelojoh	1 gluttonous. 2 greedy.
gelokak	see gelopak.
gelomang	see gelumang.
gelombang	1 a long unbroken wave or swell. 2 phase, facet.
gelompar	meng-gelombar leap or jump up.
gelondang	(ber)-gelondang-an make a resounding sound (e.g. an empty can).
gelondong	roll, bunch.
geloneng	small gong.
gelonggong	ber-gelonggong eat through, nibble at.
gelongsor	see gelosor.
gelonjak	jumping up and down. meng-gelonjang arise.
gelontor	meng-gelontor 1 spray with water in order to remove s.t. 2 drink a great deal.
gelopak	meng-gelopak peel off (of bark, paint, etc.).
gelora	1. 1) seething, tempestuousness, turbulence. 2) enthusiasm, violent passion. ber-, 2. [gelanggang olahraga] sport stadium.
gelosang	meng-gelosang hurry up, speed s.o. up.
gelosok	meng-gelosok rub hard, scrub vigorously.
gelosor	ber-gelosor slip. meng-gelosor slide down.
gelotak	meng-gelotak split a coconut shell.
gelotrak	rattle. meng-gelotrak rattle (of chains).
geluduk	deep, far-off thunder. ber-geluduk thunder, rumble.
geluga	red lead.
gelugur	k.o. forest tree with yellow edible fruits similar to mangosteen but sour.
gelugut	meng-gelugut shiver from cold, chatter (of teeth).
geluh	loam.
geluk	coconut shell.
gelulur	meng-gelulur 1 slide down, fall. 2 slip down (of trousers).
gelumang	muddied, wet with s.t. dirty.
gelumbang	see gelombang.
geluncur	see gelincir.
gelundung	1. ber-gelundung-an roll downward (of several things). 2. see gelondong.
gelung	1 coil (of rope, etc.), bun of hair. 2 curve, turn.
gelungsur	see gelosor.
geluntung	(ber)geluntung-an laze around in bed.
geluntur	meng-geluntur glide, slide, ride smoothly along.
gelup	fall out, drop out (of teeth).
gelupur	see gelepur.
gelusak	meng-gelusak trouble, throw *thoughts, etc.)into turnmoil.
gelut	1 wrestle. 2 romp, play in rough-and-tumble fashion. 3 quarrel.
gelutuk	see geletuk.
geluyur	see keluyur.
gema	wcho, reverberate.
gemaca	plaited bamboo for walls and ceiling.
gemah-ripah	(java) very prosperous.
gemak	1. meng-gemak-gemak handle, finger. 2. k.o. wild quail.
gemal	bunch (of twigs, paddy), sheaf. meng-gemal 1 put together in sheaf or bunch. 2 hold, grasp.
gemala	magic stone, probably bezoar.
geman	afraid, frightened. peng-gemani coward.
gemang	1. thick, cylinder-shaped (long, etc.). 2. k.o. fish.
gemap	ter-gemap astounded, dumbfounded.
gemar	be fond of, delight in.
gemas	1 annoyed, put out, irritated. 2 passionate, with heat. 3 be moved emotionally to do s.t. physical from anger, love, etc.
gemawan	clouds moving rapidly by in sky.
gembala	1 shepherd, herdsman. 2 (rel.) shepherd (of the flock). meng-gembala-(i ) tend, look a fter.
gembang	pudgy.
gembar-gembor	ranting. meng-gembar-gembor-kan propagandize, tout, shout about.
gembel	see jembel.
gembereng	see gembreng.
gembili	see kembili.
gembira	1 glad, happy. 2 cheerful, gay.
gembleng	ber-, ter-gembleng united, welded into o. meng-gembleng unite. peng-gembleng-an unification.
gemblok	meng-gemblok-i cling to.
gembok	padlock.
gembol	meng-gembol carry (in baf, pocket, piece of cloth). gembol-an s.t. carried (in bag, etc.).
gembong	leader, brains, prominent figure.
gembor	1. see gembar-gembor. 2. watering can.
gembos	deflated.
gembreng	k.o. flat knobless gong.
gembrot	(java) big-bellied, paunchy.
gembul	1. always hungry, never satisfied. 2. full, fat.
gembung	1 swollen, distended, puffed (of stomach, cheek, etc.). 2 stuffed, filled.
gembur	loose (of soil). 2 crumbly (of bread).
gemelai	see gemulai.
gemelegar	see gelegar 2.
gemelentam	sound of booming cannon fire.
gemeletak	shiver, chatter (of teeth).
gemeletap	sound of tapping (of fingers on table or glass pane, etc.).
gemeletuk	see geletuk.
gemelintang	full of stars.
gemelugut	1 shake, shiver (from cold). 2 shudder.
gementar	see gemetar.
gemercak	splatter, splashing.
gemercik	see gemericik.
gemerencang	sound of clanging.
gemerencik	sound of splattering.
gemerencing	see gemerincing.
gemerencung	see gemerencang.
gemeresik	1 sound of rustling (of leaves). 2 sound of paper being crumpled.
gemeretak	sound of chattering teeth.
gemeretuk	/gemeretup/ sound of rattling or clanging.
gemericik	/gemerincik/ sound of water flowing in a small stream.
gemerincing	sound of clinking or tinkling (e.g. glass breaking, jingling money, etc.).
gemerlap	shining, gleaming, sparkling brightly.
gemerocok	see gemercak.
gemertak,gemertakan	sound of a crack or rattle.
gemertuk,gemertup	see geletuk.
gemerusuk	rustle.
gemerutuk	see geletuk.
gemes	see gemas.
gemetar	tremble. gemetar-an trembling, tremor.
gemi	see ikan.
gemik	meng-gemik signal with the finger.
gemilang	brilliant, shining, bright.
gemilap	see gemerlap, gilap. ke-gemilap-an glitter.
geminasi	(ling.) gemination.
geming	ber-geming keep quiet, be motionless.
geminte	/kheminte/ (coll.) municipality.
gempa	gempa-bumi earthquake. ber-gempa shake, jolt.
gempal	1. sturdy, plump (of build). 2. see gumpal.
gempar	uproar, commotion. ke-gempar-an tumult, stir.
gempel	adhere, fuse.
gempet,gempit	meng-gempet push into a corner.
gempil	(java) chipped,damaged. gempila-an chip, splinter, sliver.
gempita	loud. meng-gempita be noisy, loud.
gempul-gempul	panting, out of breath.
gempur	1 attack and destroy. 2 demolish (an argument, idea, etc.). 3 demolish.
gempuran	attack, assault, charge, onslaught.
gemuk	1 fat, corpulent, obese. 2 fat, grease. 3 rich (of oil). 4 fertilizer.
gemulai	1 supple, pliant. 2 swaying (of leaves in wind, etc.).
gemulung	rolling (of waves).
gemuruh	1 thundering, cannonading. 2 camorous, tumultuous.
genah	(java) 1 proper. 2 straightened out, settled.
genang	ber-, meng-, ter- filling a place and not flowing (water). meng-genangi inundate, whelm s.t. genang-an puddle, flooded area (caused by water backup, etc.).
genap	1exactly enough, whole. 2 even (numbers). se-genap all, entire.
gencar	unceasing, incessant, unbroken.
gencat	1 stopped, suspended. 2 stunted (in growth). ter-gencat 1 halted, stopped. 2 oppressed. gencat-an cessation.
gencer	see gencar.
gencet	meng-gencet 1 (jakarta) squeeze, press. 2 urge, press. 3 (jakarta) crush. 4 suppress, crush.
gencetan	1 physical or psychological pressure. 2 suppression.
gendak	(jakarta, java) mistress, concubine.
gendala	hindrance, obstacle.
gendang	1. 1) k.o. drum. 2) mosque drum. 2. a roll (of paper).
gendeng	(java) dumb, stupid.
gender	k.o. metallophone with keys suspended on thongs or cords over sounding tubes, a gamelan instrument.
genderang	k.o. large drum.
genderuwo	see gendruwo.
gendi	see kendi.
gending	(java) musical composition for gamelan.
gendir	see gender.
gendong	meng-gendong carry (esp. children) on the small of the back or the hip, supported by the waist and o. arm, often with the help of a cloth sling, carry (a child) astraddle.
gendruwo	(java) malevolent (male) spirit.
genduk	(java) 1 girl. 2 term of address for girls, esp. as nduk for little girls or for waitress or maid.
gendut	1 corpulent, potbellied. 2 (coll.) pregnant. 3 (coll.) very profitable.
gene	gene.
genealogi	genealogy.
genealogisasi	generalization.
genelalogis	genealogistical.
generalisir	meng-generalize.
generasi	generation.
generatif	(ling.) generative.
generator	generator.
genetika	genetics.
genggam	handful. meng-genggam clutch, hold in o.'s grasp. genggam-an 1 s.t. held in the hand, a handful. 2 grasp, grip, clutch.
genggang	1. 1) ajar, slightly open. 2) fissure, split. ber-, ter- be ajar (of a door, etc.). 2. gingham.
genggong	1. 1) bamboo jew's harp. 2) harmonica. 2. (small) house surrounded by water.
gengsi	1. (lit.) collateral relative. 2. 1) prestige .2) (sl.) put on airs.
gengsot	k.o. dance. ng-gengsot dance such a dance.
genial	genial.
genialitas	geniality.
genit	firtatious, vain.
genitif,genitip	(ling.) genitive.
genjah	early-ripening (of certain rice or fruit varieties).
genjang	1 askew. 2 (math.) rhomboid, parallelogram.
genjer	k.o. edible riverine plant.
genjer-genjer	song associated with indonesian communist party.
genjik	(vul.) an imprecation : you pig !
genjot	meng-genjot 1 operate a pedal or treadle. 2 do s.t. all at once, push s.t. to the limits. 3 (mil.) attack (en masse).
genjur	stiff (of hair).
gensi	see gengsi 2.
genta	bell (in churches, worn by cattle, etc.). ber-genta ring out.
gentar	1 vibrate (of plucked string), quiver. 2 tremble (with fear), fear.
gentas	1 pinched off (with thumbnail), broken off (of stem of flower). 2 finished.
gentat	(lit.) dented.
gentayangan	meander, roam, ramble.
gentel	pill, pellet.
genteng	roof-tile. per-gentengan-an imbrication, overlapping.
gentik	see getik.
genting	1. (lit.) 1) narrow, thin, slender in the middle. 2) frayed, worn thin. 3) critical, tense. 2. see genteng.
gentong	large earthenware bowl for water.
gentus	(jakarta) surly, offensive (of speech, words).
genyot	awry, askew.
geodesi	geodesy.
geofisik	geophysical.
geofisika	geophysics.
geofisikawan	geophysicist.
geografi	geography.
geografis	geographycal.
geokimia	geochemistry.
geol	(sunda) ber-, meng-geol sway, swing.
geologi	geology.
geologis	geological.
geologiwan	geologist.
geometri,geometrika	geometry.
geometris	geometrical.
geopolitik	geopolitics.
geopolitis	geopolitical.
geotermis	geothermic.
gepak,gepak	1. see kepak 1. 2.(jakarta) kick.
gepar	see gelepar.
gepeng	flat and rather thin, us. of s.t. not flat (a cake that fails to rise, a malformed head, a plate rather than a soup bowl, etc.).
geplak	1. (java, jakarta) k.o. sweet cake. 2. meng-geplak strike with the back of the hand.
gepok	bundle, sheaf. gepok-an bundle, sheaf, wad.
geprak	meng-geprak hit with banging sound (us. the head).
gepuk	1. (m) fat, obese. 2. meng-gepuk 1) beat, pound. 2) crack (with hammer).
ger	see also entries with gr- ger.
ger-ger	1 sound of boisterous laughter. 2 sound of snoring.
gera	meng-gera frighten, threaten (by starling actions).
gerabah	earthenware vessels.
gerabak	meng-gerabak trickle, flow (of tears).
gerabak-gerubuk	1 sound of repeated, various thumping noises (of heavy footsteps, falling chairs, futniture being moved). 2 do s.t. hurriedly or without care or regard for others.
gerabang	1 large rip. 2 gaping hole (in wall).
geradakan	1 uneven, coarse (surface, etc.). 2 rough (action, handling, etc.).
geragai	k.o. hook for catching crocodiles.
geragap	meng-geragap be nervous and uncontrolled (of speech). geragap-an hace difficulty speaking (from nervousness, fear, atc.).
geragas	(java) ng-geragas gluttonous.
geragau	1. meng-gerafgau claw at. 2. see udang.
geragot	meng-geragot damage s.t. slightly by nibbling or gnawing at it.
gerah	1. 1) stifflingly hot, sultry. 2) (coll.) sick. 2. see geruh 1.
geraham	molar.
gerai	meng-gerai dig, excavate. 2. (lit.) small stand or platform. 3. meng-, ter be loose (of hair).
gerak	1 movement. 2 twitch, jerk (of eyelid, shoulder, etc., often regarded as an omen). peng-gerakan activation.
geram	1. 1) infuriated. 2 (lit.) passionate.
geramang	k.o. long-legged ant.
gerami	see gurami.
geranat	see granat.
gerang	tooth blackener.
gerang-an	can it be ?, an expression of wondering or double.
geranggang	(java) bamboo spear.
gerantam	sound of cannon, explosion, etc.
gerantang	1 tumult, din, racket. 2 snarl, growl.
geranyam	1. meng-geranyam have a tingling sensation (from striking o.'s funny bone, etc.). 2. (m) meng-geranyang come up in waves (e.g. heat off a tin roof).
gerapai	meng-gerapai grope.
gerasakan	rough (of a surface).
gerat	meng0gerat-kan gnash.
geratak	(jakarta) meng-geratak search, look for (everywhere).
geratih	(m) canter.
gerayang	1. meng-gerayang 1) craw (of insects, snakes, etc.). 2) scratch the head). 2. (jakarta) meng-gerayang grope, esp. probe stealthily (in order to steal).
gerbak	meng-gerbak pervade (of odors).
gerbang	1. disheveled (of hair). 2. gate, esp. ceremonial arches.
gerbangkertasusila	[gersik-jombang-kertosono- surabaya-sidoarjo-lamgongan] metropolitan surabaya area.
gerbas-gerbus	sound of rustling.
gerbong	railway coach.
gercik	see gemericik.
gerdak	sound of s.t. hard falling suddenly.
gerdam	sound of loud slamming. meng-gerdam fall with loud noise (as of heavy object hitting floor).
gerdum	sound of loud thud.
gerebak-gerebek	1 come up (in large number) on s.o. unawares. 2 raid s.t. 3 (jakarta) gang up on s.o.
gerecak	sound of fizzing.
gerecok	meng-gerecok annoy, bother, nag.
gereformeers,gereformir	reformed (church), calvinist protestant sect.
geregetan	tense from restraining pent-up emotions.
gereh	(java) dried salted fish of any kind except enchovy.
gereja	1 church. 2 (coll.) church services.
gerejani	ecclesiastical.
gerejawan	churchman, an ecclesiastical.
gerejawi	ecclesiastical.
gerek	drill. meng-gerek 1 drill (a hole), perforate. 2 bore (of a rodent).
gerelap	see gelap.
geremeng	vibration.
gerendel	(m) see gerendel.
gerendeng	meng-gerendeng strike a threatening posture (e.g. bull about to attack).
gerentang	see gerantam.
gerenyam	see geranyam.
gerenyau	impertinent, saucy.
gerenyeng,gerenying	1 display the teeth (of dog, mongkey, etc.). 2 grin broadly.
gerenyet,gerenyit	1 muscle spasm, twitching (of mucles). 2 sound of squeaking.
gerenyot,gerenyut	1 with the corners of the mouth pulled up or down. 2 sneering, grimacing
gerepes	1. meng-gerepes fidget, fiddle (with o.'s fingers). 2. bergerepes uneven, rough (of a surface, etc.).
gereseh-peseh	see kareseh-peseh.
geresek	sound of rustling.
geret	meng-geret 1 scratch, scrape. 2 screech, squeak. geret-an matches, lighter.
geretak,geretek	meng-geretek 1crackle. 2 gnash o.'s teeth.
geretang	(m) meng-geretang adopt a fighting posture.
gergaji	saw.
gergajul	(jakarta) scoundrel, blackguard.
gergasi	giant.
gerham	see geraham.
gerhana	1. eclipse. 2. in difficulty.
geriap	meng-geriap become small (of drooping eyelids, fading lamps).
geriatri	/geriatria/ geriatrics.
geriatrik	geriatric.
gericau	sound of repetitive twittering or chattering (e.g. birds, geese, monkeys, etc.).
geridik	meng-geridik-kan (bulu roma) make the hair stand on end.
geridip	meng-geridip blink.
gerigi	serration, a serries of notches.
gerigik	k.o. bamboo water-scoop, with a handle.
gerigis	ber-gerigis serrated, cogged (file, etc.).
gerigit	meng-gerigit gnaw at.
gerik	see gerak.
gerilya	guerrilla. ber-gerilya wage guerrilla warfare.
gerilyawan	male guerrilla fighter.
gerilyawati	female guerrilla fighter.
gerim	k.o. coarse flannel.
gerimis	drizzle.
gerincing	sound of thinkling. meng-gerincing-kan jingle s.t. (keys, etc.).
gerinda	grindstone, emery wheel. meng-gerinda hone s.t.
gerindin	(m) suffer from shivers (esp. a horse disease).
gerinding	k.o. jew's harp.
gering	1 (java, jakarta) ill, esp. of animals. 2 (lit.) ill (of royalty). peng-gering 1 sickly. 2 potion to cause illness.
geringsing	1. k.o. batik pattern. 2. see gerising.
gerinjal	see ginjal.
gerinjam	1. whetstone for filling teeth. 2. ear scoop (for clearing outer earduct).
gerinting	k.o. grass.
gerinyau	meng-gerinyau feel itchy.
gerinyit	see gerenyot.
gerip	slate pencil.
geripir	(coll.) court clerk.
gerisik	sound of rustling.
gerising	distort o.'s face (from pain).
gerit	1. sound of scratch (e.g. chalk across black-board). ber-, meng- gerit screech (from scraping), squeak (of chair on floor). 2. meng-gerit nibble, gnaw.
gerit-gerit	k.o. vine yielding k.o. latex.
gerita	see gurita 1.
gerlap	see kerlip 1.
gerlip	see kerlip 1.
germo	1 pimp, procurer, panderer. 2 brothel keeper. per-germo-an matters pertaining to pandering.
germut	meng-germut-i crowd, swarm around.
gero-gero	(java) wail.
geroak	have a large, gaping tear, esp. in clothing.
gerobak	1 cart, wagon. 2 (r.r.) car.
gerobok	1. 1) (jakarta) k.o. bamboo cupboard for food storage. 2) (lit.) large clothes wardrobe. 2. meng-gerobok bubble, gurgle.
gerocok	sound of falling water. ber-gerocok-an foam (of fountain).
gerodak	sound of clattering (stone rolling on floor, stamping of feet, etc.).
gerogi	1 somewhat afraid. 2 embarrassed. 3 dazed, dizzy.
gerogoh	meng-gerogoh(i) grab at, grope.
gerogol	(lit.) palisades.
gerogot	meng-gerogot-i 1 (jakarta) gnaw on (of rats, etc.), chew at. 2 undermine (a plan or duty). 3 embezzle, steal little by little.
gerohok	hollow, empty.
gerombol	assemble, collect.
gerombolan	1 group, bunch, cluster. 2 gang, band (of thieves, etc.).
gerong	1 (jakarta) hole or cavity in the earth. 2 (java) sunken (of eyes).
geronggang	1. k.o. tree yielding house timber. 2. geronggang, geronggong 1) cavity (in tree, etc.), 2) be hollow.
gerontang	sound of erratic chattering or clattering (falling cans, etc.).
gerontologi	/gerontologia/ gerontology.
geronyot	1 throb with pain. 2 twitch.
geropes	see gerupis.
geropyak	(java) sound of a crash. ber-geropyak thump, thud (of tree falling, etc.).
geropyok	meng-geropyok (java) 1 stage a raid, give chase. 2 round up.
geros	1. (jakarta) meng-geros snore. 2. see gros 1.
gerosok	1. sound of rustling (e.g. dry leaves when walked over). 2. meng-gerosok-gerosok wade.
gerowot	see gerogot.
gerpol	[gerilya politik] political guerrilla.
gerr	sound of laughter, snoring, purring of a cat.
gersah,gersak	sound of crackling (e.g. dried twigs, leaves, etc.).
gersang	1 dry, barren (of hair, land, etc.). 2 coarse (of hair).
gersik	k.o. coarse sand.
gertak	1 snarl, snapping. 2 threaten.
gertakan	1 snarling,snapping 2 threat , intimidation 3 spurring (of a horse).
gertap	sound of repeated tapping.
gertik	meng-gertik make a grating noise.
geru	(lit.) meng-geru roar (of tiger, etc.).
gerubuk	see gerabak.
geruduk	(java) meng-geruduk attack en masse.
gerugul	see gerogol.
gerugut	grooved, corrugated.
geruh	misfortune, bad luck .
geruit	see keruit.
geruk	sound of object scraping scross hard surface.
gerumbul	density. meng-gerumbul be gathered in a place.
gerumit	meng-gerumit perform fine, meticulous work.
gerumpung	mutilated, deformed (nose).
gerumuk	meng-gerumuk sit hunched up.
gerumut	swarm.
gerun	overwhelming fear (on seeing a serious car accident, etc.).
gerundang	(m) tadpole.
gerundel	meng-gerundel complain, pout.
gerung	sound of roaring.
gerunggung	k.o. tree.
gerunjal	meng-gerunjal 1 jolt. 2 appear suddenly. 3 cause jolts.
gerup	the portion of the loom in which the comb is fixed.
gerupis	tinker at, putter at (o.'s work).
gerus	shell used to polish cloth.
gerut	1 sound of scratching. 2 scraping, scratching.
gerutan	1 scratch. 2 claw.
gerutu	1. rough, coarse (of texture). 2. say s.t. in complaint.
gerutuan	complain, gripe.
gerutup,gerutus	sound of rattling explosion (of machine gun, firecrackers, etc.).
geruyak	meng-geruyak shake, make s.t. turbulent.
gesa	ber-, (ber)gesa-gesa in a hurry, in haste.
gesek	rub, scrape.
gesekan	1 rubbing, friction. 2 stringed instrument.
gesel,geser	(ling.) fricative.
gesit	1 nimble, adroit, agile. 2 skillful.
gesper	clasp, buckle. meng-gesper-kan buckle (belt, etc.).
gestapu	[gerakan september tiga puluh] september 30th movement, the 1965 attemp to seize control of the gvt.
getah	1 sap, latex, resin. 2 (biol.) gland secretion.
getak-getuk	sound of knocking or pounding (e.g. butcher's cleaver on cutting block).
getang	cover of rthin material (paper, cloth, skin) tightly drawn over an opening.
getap	1. broken. meng-getap grate, crunch. 2. getap ,getapan 1 quick-tempereted. 2 easily shocked.
getar	1 tremble. 2 (ling.) trill.
getaran	1 vibration, quiver, shiver. 2 (ling.) trill. 3 (med.) pulsation. 4 frequency.
getas	1. 1) brittle (of wood, etc.). 2) easily heartbroken, oversensitive. 2. (jakarta) clear, distinct (change, etc.).
getek	1. (jakarta) small raft. 2. see gitik.
getik	meng-getik 1 tap lightly, flick (with finger). 2 nip between o,'s fingers. getik-an a pinch, a nip.
getil	se-getil a pinch of s.t.
getir	1. bitter. 2. see getil.
getis	1 brittle. 2 frail (of health).
getok	sound of pounding.
getokan	stick to hit with.
getol	diligent, industrious, harworking.
getrok	sound of flailing (e.g. palm fronds). meng-getrok strike repeatedly (to remove contenst of can, jar, etc.).
getu	meng-getu crush with fingernail.
getuk	1. (java) k.o. sweet steamed loaf of pounded cassava. 2. see getok.
getun	ke-getun-an surprise, astonishment.
geulis	/gelis/ see gelis.
gewang	1. mother-of-pearl. 2. see giwang.
geyong	(jakarta) large-buttocked.
geyong-geyong	(java) dangle.
gh-	see also entries with g-.
ghaib	see sembahyang, gaib.
gi	(coll.) see pergi.
gia	[garuda indonesian airways] the indonesian national airline.
giam	k.o. hardwood tree.
giat	energetic, active.
gibas	1. see kibas. 2. see kambing.
gidig,gidik	ber-gidig shudder, shiver (e.g. due to gruesome situation).
gigau	see igau.
gigi	1 tooth. 2. toothlike object. 3 cog, gear. 4 edge or extremity.
gigih	1. persevering. 2. half-cooked rice. 3. see gigil.
gigil,gigir	meng-gigir shiver, tremble.
gigir-gunung	(java) mountain ridge, range of hills.
gigis	(java) see kikis.
gigit	bite s.t.
gila	1. 1) insane, crazy. 2) obsessed, infatuated. 2. meng-i, meng-kan (m) look after, take care for s.o.
gila - gilaan	1) foolhardy, foolish. 2) frantic, like mad. 3) exessive, beyond reason.
gilang-cemerlang	glittering and bright.
gilang-gemilang	bright and brilliant.
gilap	meng-gilap lustrous, shining (of s.t. polished).
gilas	meng-gilas 1 crush, pulverize. 2 run over. 3 overrun, cross over.
giles	see gilas.
gili	(m) meng-gili-gili 1 tickle. 2 incite, egg on, needle.
gili-gili	1 bund, earthen dike. 2 sidewalk.
gilik	1. meng-gilik roll over s.t. to crush it. 2. see gili.
giling	meng-giling 1 roll (cigarette, steel). 2 mill, grind (wheat, coffee, pepper, etc.). 3 flatten (s.t. with a roller).
gilir	1 alternate, pass through cycles. 2 take turns.
giliran	1 turn, shift. 2 serve (in tennis).
gim	1. gold thread. 2. 1) the gymnasium of colonial period offering latin and greek courses. 2) attend such a school. 3. see game. (coll.).
gimana	(coll.) see bagaimana.
gimnastik	gymnastics.
gimpal	locket, pendant.
gin	gin.
ginang-ginang	sticky rice sweetmeat.
gincu	lipstick.
ginekolog	gynecologist.
ginekologi	gynecology.
gingsir	see gelingsir.
gini	(coll.) see begini. se-gini this much.
ginjal,ginjel	kidney.
giok	(china0 jade.
gips	1 gypsum. 2 plaster cast (on sprain or fracture).
gir	gear wheel, cogwheel (of car, bicycle, etc.).
girang	glad, happy.
giras	k.o. coarse linen.
girik	1 id card. 2 chit, voucher. 3 title of land ownership (containing land measurements). 4 schedule of rounds by guards.
girik-girik	areca nut crusher.
giring	see temu 1.
giring-giring	1. bell (on bicycle, clothing, etc.). 2. plants used for fertilizer.
giringan	giringan
giris	(java) fel fear and horror.
giro	(fin.) 1 clearing, clearing account. 2 credit transfer. 3 check for deposit only.
giro-pos	1 postal money transfer. 2 postal clearing.
giroskop	gyroscope.
gisar	1. see kisar. 2. see gesel.
gisik	(java) beach.
gisil	see gesel.
gita	(java) hymn, song.
gitar	guitar. ber-gitar play the guitar.
gitaris	guitarist.
gites	(java) meng-gites crush lice between tips of a.'s fingernails.
gitik	(vul., sl.) meng-gitik have sex with a woman.
gitu	(coll.) see begitu. gitu-gitu so-so, all the same. se-gitu that much. gitu-an that sort of (bad, dirty) thing.
giuk	(naut.) guy.
giur	meng-giur-kan 1 arouse sexual excitement. 2 arouse interest, temp.
giwang	ear stud.
gizi	nutrient.
gk	[gaya kuda] horsepower.
gl-	see also entries with gel-.
gl.	[gelar] title.
gladi	rehearsal.
gladiol	/gladiole/ gladiolus.
glasiasi	(geol.) glaciation.
glasir	see glazur.
glaukoma	glaucoma.
glazur	1 glazing (of tile, etc.). 2 tooth enamel. 3 cake frosting.
glek-glek-glek	sound of gulping down liquids.
glendem	/glenggem/ 1. sound of s.t. heavy rolling slowly (wheels of train, etc.). 2. glenggem (java) eat s.t. or put s.t. in o.'s pocket quietly without letting anyone know to avoid sharing it.
gletser	glacier.
glikosa	see glukosa.
gliserin	glycerine.
global	1 global, overall. 2 broad.
glondongan	(coll.) unprocessed timber.
