release	kb. pembebasan, kelepasan, pelepasan (from jail). 2 pengeluaran (of a new book). 3 pemberhentian, pengunduran (of employees). 4 surat bebas. -kkt. 1 melepaskan (on bail). 2 membebaskan, mengeluarkan (from prison). 3 menyiarkan (news). 4 mengendurkan.
relegate	kkt. 1 membuat, memindahkan, mengasingkan (s.t. to the junkpile). 2 menurunkan (s.o. to a lower rank).
relent	kki. menjadi lunak dalam perasaan, mengalah, menjadi belas kasihan.
relentless	ks. tak menaruh kasihan, keras hati. to go in r. pursuit of s.o. menguber-uber/memburu-buru seseorang tanpa belaskasihan.
relevance	kb. perlunya, hubungan, pertalian, sangkut-pautnya.
relevant	ks. bersangkut-paut, revelan. r. factors factor-factor yang bersangkut-paut.
reliability	kb. 1 hal dapat dipercaya (of a person). 2 hal tahan uji (of a product).
reliable	ks. dapat dipercaya/diandalkan (of a person, a firm, product). -reliably kk. yang dapat dipercaya. it was r. reported that... telah ada laporan yang dapat dipercaya bahwa...
reliance	kb. 1 kepercayaan. 2 hal menggantungkan nasibnya (on o's father).
reliant	ks. percaya.
relic	kb. 1 barang peninggalan. 2 peninggalan. he's a r. of the past ia merupakan seorang (tokoh) peninggalan zaman yang lampau. 3 barang milik orang keramat.
relied	lih rely.
relief	kb. 1 keringanan, pembebasan (from tax, work, pressure). 2 pertolongan. 3 kelegaan. 4 (bas-)gambar-timbul.
relies	lih rely.
relieve	kkt. 1 membebas(tugas)kan (s.o. of his job). 2 mengurangi (pain). 3 mengganti (the guard). 4 sl.: mencopet, mencopot , merampas (s.o. of his wallet). 5 menghilangkan. 6 meringankan (a burden).
religion	kb. agama. work is almost a r. with him baginya kerja hampir sama dengan agama.
religious	ks. 1 yang berhubungan dengan agama, beragama, beriman. r. instruction pelajaran agama. 2 saleh. a r. person seorang yang sangat saleh. -religiously kk. dengan tekun, dengan setia. she exercises r. ia berlatih dengan tekun.
relinquish	kkt. melepaskan.
relish	kb. 1 (pickles) makanan perangsang. 2 suka hati. -kkt. menikmati, menyukai (food, warm weather).
relive	kkt. mengenangkan/mengalami lagi (the good old days).
reload	kkt., kki. 1 mengisi kembali/lagi (a gun). 2 memuati lagi (a truck).
relocate	kkt. menampung (refugees). -kki. menetap lagi (of a factory or firm).
relocation	kb. penampungan. r. center tempat penampungan.
reluctance	kb. keseganan, keengganan. to show r. menunjukkan keseganan.
reluctant	ks. segan (hati), enggan. to be r. to call the police enggan memanggil polisi. -reluctantly kk. dengan rasa malas.
rely	kki. (relied) to r. on 1 mempercayakan (s.o.'s honesty). 2 menyandarkan diri pada, mengandalkan (s.o). he relies on me ia menyandarkan nasibnya padaku.
remain	kb. remains j. 1 sisa, bekas (of food). 2 (mortal) jenazah. -kki. 1 tinggal (after school). 2 tetap. -remaining ks. sisa(nya). the r. portion sisa porsi itu.
remainder	kb. sisa, restan (of a roast). to stay home the r. of the day tinggal di rumah selama sisa hari itu.
remake	kkt. membuat (sekali) lagi.
remand	kkt. mengirim kembali, menyerahkan (to jail, to s.o's custody).
remark	kb. 1 ucapan, kata-kata. 2 (unpleasant) teguran. -kkt. berkata. she remarked that... ia berkata bahwa.... -kki. to r. on memuji.
remarkable	ks. 1 luar biasa. r. progress kemajuan luar biasa. 2 hebat, baik sekali. r. piece of work hasil karya yang hebat. -remarkably kk. sungguh.
remarries	lih remarry.
remarry	kkt., kki. (remarried) kawin lagi.
remedial	ks. yang berhubungan dengan perbaikan. r. measures usaha-usaha/tindakan-tindakan perbaikan. r. reading perbaikan membaca.
remedies	lih remedy.
remedy	kb. (j. -dies) obat (for colds). household r. obat yang lazim dipakai di rumah, cara pengobatan di rumah. -kkt. (remedied) 1 memperbaiki (o's mistakes). 2 menolong.
remember	kkt. 1 mengingat. 2 menyampaikan salam.
remembrance	kb. ingatan, kenangan. do this in r. of me lakukanlah ini sebagai kenangan kepadaku.
remind	kkt. mengingatkan. r. me to stop at the store ingartkan aku supaya mampir di toko.
reminder	kb. 1 surat peringatan. to mail out reminders mengirimkan surat-surat peringatan. 2 tandamata.
reminisce	kki. mengenangkan. to r. about o's ypunger days mengenangkan masa-masa mudanya.
reminiscence	kb. kenang-kenangan. book of reminiscences buku kenang-kenangan.
reminiscent	ks. r. of mengingatkan kepada.
remiss	ks. lalai, lengah. to be r. in accepting an offer lalai menerima tawaran.
remission	kb. 1 pengampunan (of sins). 2 permaafan. 3 doleansi (of taxes).
remit	kkt. (remitted) 1 mengirimkan (a check). 2 mengampuni (sins). 3 membatalkan (a debt).
remittance	kb. 1 (uang ) pembayaran. 2 pengiriman uang.
remnant	kb. sisa, bekas.
remodel	kkt. mengubah bentuk, membentuk lagi ( a building).
remonstrance	kb. bantahan, keluhan.
remonstrate	kki. to r. with s.o. memrotes dengan seseorang, membantah seseorang.
remorse	kb. penyesalan yang dalam.
remorseful	ks. penuh rasa penyesalan, menyesal sekali.
remorseless	ks. kejam, tanpa belas kasihan, tanpa merasa menyesal, tanpa penyesalan.
remote	ks. 1 terpencil. 2. tipis. 3 jauh. -remotely kk. sedikit. to be r. related ada hubungan famili sedikit.
remoteness	kb. 1 keadaan terpencil (from an area). 2 jauhnya (of a relationship).
removable	ks. dapat dipindahkan/dikeluarkan/dipecat.
removal	kb. 1 pembewrsihan, penghilangan (of grease spots, of snow). 2 pemindahan (to another location). 3 pemusnahan, penghapusan (of evidence). 4 pemecatan (from office). 5 (hal) melepaskan (of a tire). 6 pembuangan, pemotongan (of appendix).
remove	kb. jauhnya, derajat. -kkt. 1 mengangkat (dishes from a table). 2 melepas(kan) (shoes, jacket). 3 menghilangkan (spots, stains from clothes, an objecktion, suspicion). 4 memberhentikan, memecat (from office). 5 memindahkan. 6 mengeluarkan. 7 membersihkan
remover	kb. penghilang, pembersih. spot r. penghilang noda. nail polish r. penghapus cat kuku.
remunerate	kkt. membayar, memberi gaji, mengupahi.
remuneration	kb. 1 pemberian upah. 2 upah, gaji.
remunerative	ks. yang memberi hasil banyak, menguntungkan.
renaissance	kb. kebangunan kembali.
renal	ks. yang berkaitan dengan ginjal. r. gland kelenjar ginjal.
renascence	kb. kebangunan kembali, kelahiran baru.
renascent	ks. yang bangun/hidup/bangkit kembali.
rend	kkt. (rent) 1 mengoyak-ngoyak (an animal). 2 membelah (a tree by lightning). a cry rent the air jeritan (yang) memecah udara.
render	kkt. 1 menyumbangkan (a service). 2 membuat. 3 membawakan (a song). 4 memberikan (an accounting). 5 menterjemahkan (s.t. into english). 6 mengubah (fat into lard).
rendezvous	kb. 1 pertemuan (in outer space). 2 tempat berkumpul (of a family). 3 randevu, saling bertemu. -kki. mengadakan pertemuan (di tempat tertentu), mengadakan rendevu.
rendition	kb. 1 cara membawakan (of a song or poem). 2 cara menterjemahkan, terjemahan (into engkish).
renegade	kb. orang murtad/pengkhianat, (pem) belot.
renege	kki. mengingkari, tak menetapi.
renew	kkt. 1 memperbarui (a subscription, o's efforts, a contract). 2 mengulangi, memulai lagi (o's acquaintance with s.o.).
renewable	ks. 1 dapat diperpanjang waktunya (of a subscription, visa). 2 dapat diperbarui.
renewal	kb. 1 pembaharuan, perpanjangan (of a visa, subcription). 2 ulangan, permulaan lagi (of an acquaintanceship).
renounce	kkt. 1 meninggalkan (worldly gain). 2 turun takhta (a throne). to r. a new ordinance menolak peraturan baru.
renovate	kkt. memperbaharui, membaharui.
renovation	kb. pembaharuan.
renovator	kb. orang yang ahli memperbaharui seseuatu, pembaharu.
renown	kb. kemasyhuran. to win r. as... mendapat kemasyhuran sebagai...
renowned	ks. terkenal, termasyhur.
rent	lih rend.
rental	kb. 1 persewaan. car r. persewaan mobil. 2 (uang) sewa.
renter	kb. penyewa.
rentfree	ks., kk. tanpa persewaan.
renunciation	kb. 1 penolakan (of material things, of the world). 2 pembuangan (of o's rights to the throne).
reopen	kkt. membuka lagi/kembali (of a store, legal case).
reorder	kkt. memesan lagi, mengulang pesanan.
reorganization	kb. reorganisasi.
reorganize	kkt. mereorganisasi.
reorientation	kb. reorientasi.
rep.	1 [report] laporan. 2 [representative] wakil. 3 [republic] republik.
repaid	lih repay.
repair	kb. reparasi, perbaikan (of a machine). -kkt. 1 memperbaiki, mereparasi, membetulkan. 2 kembali, mengundurkan diri, pergi.
repairer	kb. tukang reparasi.
repairman	kb. (j. -men) tukang reparasi.
reparable	ks. dapat diperbaiki.
reparation	kb. penggantian rugi. to make r. mengadakan perbaikan, memperbaiki. -reparations j. pampasan.
repartee	kb. jawaban yang kena/tepat.
repast	kb. jamuan makan.
repatriate	kkt. mengembalikan, memulangkan, mengirim pulang.
repatriation	kb. pemulangan, pengiriman kembali (of prisoners).
repay	kkt. (repaid) 1 membayar kembali (a loan). 2 membalas (an insult). 3 mengganti, mengganjar (s.o. for his trouble).
repayment	kb. pembayaran kembali.
repeal	kb. pencabutan (of a law). -kkt. mencabut (a law).
repeat	kb. ulangan. r. performance pertunjukan ulangan. -kkt. 1 mengulangi (a grade). 2 menceritakan (what one has heard). 3 ikut mengucapkan. -repeated ks. berulang-ulang, berulang-kali. -repeatedly kk. berkali-kali, berulang-ulang.
repeater	kb. pengulang. 2 (rifle) mauser.
repel	kkt. (repelled) 1 memukul mundur (the enemy). 2 menolak.
repellent	kb. penolak, penangkis. insect r. penolak serangga. -ks. menjijikkan.
repent	kkt. menyesali (o's sins). -kki. bertobat, menyatakan penyesalan.
repentance	kb. penyesalan, tobat.
repentant	ks. penuh penyesalan.
repercussion	kb. 1 reaksi, akibat. 2 tolakan kebelakang (of a shell).
repertoire	kb. daftar lagu-lagu, judul-judul sandiwara, opera dsb yang akan disajikan oleh pemain musik, perkumpulan sandiwara, penyanyi dsb.
repertory	kb. (j. -ries) 1 perbendaharaan lagu-lagu. 2 macam pertunjukan. r. theater perkumpulan sandiwara. 3 repertoire.
repetition	kb. (peng)ulangan.
repetitious	ks. berisi ulangan, berulang-ulang. his speech was r. pidatonya diulang isinya.
repetitive	ks. berulang. history is r. sejarah itu berulang.
rephrase	kkt. mengatakan dengan cara lain.
replace	kkt. 1 mengganti(kan) (books). she will be difficult to r. akan sukar mencari gantinya. 2 menaruh kembali, menempatkan lagi.
replaceable	ks. dapat diganti.
replacement	kb. 1 penggantian (of s.t.). 2 pengganti. -replacements j. tenaga-tenaga pengganti.
replant	kkt. menanamkan lagi. -replanting kb. menanam kembali. rubber r. menanam kembali tanaman karet.
replay	kb. sport : ulangan permainan/pertandingan. -kkt. memainkan lagi, mengulangi permainan.
replenish	kkt. mengisi/melengkapi lagi.
replenishment	kb. perlengkapan, penambahan.
replete	ks. penuh (with dengan).
replica	kb. tiruan.
replied	lih reply.
replies	lih reply.
reply	kb. (j. replies) 1 jawaban, sahutan. 2 balasan. -kki. (replied) menjawab, menyahut.
report	kb. 1 laporan. 2 letusan (of a gun, grenade). 3 desas-desus. -kkt. 1 melaporkan (s.o. or s.t.). -kki. melapor. -reporting kb. pemberitaan, pelaporan.
reportedly	kk. menurut laporan.
reporter	kb. 1 wartawan, jurnalis. 2 pelapor (for a conference).
repose	kb. 1 istirahat. 2 tidur. 3 ketenangan. -kki. 1 beristirahat, berbaring (of a person). 2 terletak (on a shelf).
repository	kb. (j. -ries) tempat penyimpan(an), gudang.
reprehensible	ks. patut dicela. r. in the extreme sangat patut dicela.
represent	kkt. 1 mewakili (an organization). 2 menggambarkan. 3 memainkan peran (an animal). 4 melambangkan, mewakili. 5 menunjukkan.
representation	kb. 1 gambaran. 2 perwakilan (on a board, in congress).
representative	kb. 1 wakil (of a group, of o's country). 2 anggauta majelis rendah (di as). -ks. bersifat mewakili.
repress	kkt. 1 menindas (a revolt). 2 menahan (a smile, sneeze). 3 menekan (a desire).
repression	kb. 1 penindasan (of a group). 2 penahanan (of a smile). 3 penekanan (of a desire).
repressive	ks. bersifat menekan/menindas, represif. to take r. measures melakukan tindakan-tindakan penindasan.
reprieve	kb. penangguhan hukuman (mati). -kkt. menangguhkan hukuman (mati).
reprimand	kb. teguran, cerca(an). -kkt. menegur, mengomeli, mencercai.
reprint	kb. cetakan ulang(an). -kkt. mencetak kembali.
reprisal	kb. pembalasan (dendam), tindakan balasan (against terhadap.
reproach	kb. comelan, celaan. -kkt. 1 mencela. 2 menyalahkan. to r. o.s. menyalahkan diri.
reproachful	ks. penuh celaan.
reprobate	kb. bangsat, bajingan.
reproduce	kkt. 1 meniru (a painting). 2 memperanakkan (living things). 3 memancarkan kembali (sound, music).
reproduction	kb. 1 barang tiruan (of a painting, of antiques). 2 perkembang-biakan (of o's kind). 3 reproduksi.
reproductive	ks. berdaya membiak. r. organs alat-alat tubuh yang bersifat membiakkan/menghasilkan keturunan.
reproof	kb. teguran, celaan.
reprove	kkt. memarahi.
reptile	kb. binatang melata.
repubican	kb. anggota partai republiken. -ks. republiken. r. from of government pemerintahan berbentuk republik.
republic	kb. republik.
republish	kk. menerbitkan lagi.
repudiate	kkt. 1 tak (mau) mengakui (o's child, a debt). 2 menanggalkan (o's citizenship).
repudiation	kb. 1 penanggalan. 2 penyangkalan, penolakan (of a debt). 2 tidak mengakui seorang anak sendiri (of a child).
repugnance	kb. kejijikan. to feel a r. for s.t. tidak suka pada sesuatu.
repugnant	ks. menjijikkan (to bagi).
repulse	kkt. 1 memukul mundur (an attack). 2 menolak (advances).
repulsive	ks. menjijikkan. she is physically r. secara badaniah ia menjijikkan.
reputable	ks. mempunyai nama baik. r. firm perusahaan yang mempunyai nama baik.
reputation	kb. reputasi, nama. to have a good r. mempunyai nama baik.
repute	kb.repputasi, nama baik. she's a woman of ill r. ia seorang yang namanya buruk.
reputed	ks. dianggap. she is r. to be wealthy menurut anggapan orang ia kaya. -reputedly kk. kata orang.
request	kb. permintaan, permohonan. -kkt. 1 meminta(kan) (a vacation, an increase in pay). 2 memohon(kan).
requiem	kb. doa (seringkali berbentuk musik) untuk orang mati dan diadakan dengan upacara di gereja.
require	kkt. 1 memerlukan, membutuhkan (a lot of work, much money). 2 mengharuskan. 3 mewajibkan. 4 menghendaki. 5 memaksa. -kki. dibutuhkan, diperlukan. -required ks. wajib.
requirement	kb. 1 syarat. 2 keperluan.
requisite	kb. 1 keperluan. 2 syarat. -ks. 1 diharuskan, diwajibkan. 2 dibutuhkan.
requisition	kb. daftar permintaan (for supplies). -kkt. mil.: mengambil-alih.
reran	lih rerun.
reroute	kkt. mengubah rute/perjalanan, menyalurkan (lewat jalan lain).
rerun	kb. pertunjukan ulangan (of a tv program). -kkt. (reran, rerun) memutar kan lagi.
rescuer	kb. penolong, penyelamat.
research	kb. riset, penelitian, penyelidikan. scientific r. penelitian ilmiah. -kkt. meneliti, menyelidiki.
researcher	kb. penelitian, penyelidik, petugas riset, periset.
resemblance	kvb. kemiripan, keseruan, persamaan. to bear a strong r. r. to banyak sekali menyerupai.
resemble	kkt. menyerupai, mirip. they r. o. another rupa mereka serupa.
resent	kkt. 1 marah. 2 benci akan, merasa tersinggung karena (an insinuation).
resentful	ks. benci, marah (of kepada).
resentment	kb. kemarahan, dendam, kebencian, kesebalan. to cherish a secret r. against s.o. diam-diam mempeunyai perasaan tidak suka pada seseorang.
reservation	kb. 1 pesanan tempat. to make a plane r. memesan tempat di pesawat terbang. 2 daerah penampungan (for indians). 3 syarat, keberatan.
reserve	kb. cadangan. r. bank bank cadangan. 2 kelakuan/sikap hati-hati. -the reserves j. tentara/pasukan cadangan. -kkt. 1 memesan (a seat). 2 menyediakan. 3 mencadangkan (a place, seat).
reserved	ks. 1 pendiam, tak ramah, suka menyendiri (of a person). 2 dipesan. r. seat tempat duduk yang dipesan.
reservoir	kb. 1 waduk/kolam air, waduk tandon air, lubuk penyimpanan. 2 gudang (of knowledge pengetahuan).
reset	kkt. (reset) memasang lagi (a bone, diamond).
resettle	kkt. memberikan tempat menetap yang baru. 2 menampung, metransmigrasikan ke daerah baru (refugees). -kki. pindah tempat-tinggal.
resettlement	kb. transmigrasi, perpindahan tempat-tinggal.
resevist	kb. (pasukan) cadangan.
reshuffle	kb. 1 mengocok kembali (kartu), pengocokan kembali, perubahan susunan (of cards). 2 perubahan susunan (of a cabinet).
reside	kki. 1 bertempat-tinggal, berumah. 2 terletak. his sucsess resides in his wife's help suksesnya itu terletak pada bantuan isterinya.
residence	kb. 1 tempat tinggal. 2 tempat kediaman.
residency	kb. (j. -cies) 1 adm.: keresidenan. 2 tempat kediaman.
resident	kb. 1 penduduk. he was a r. of solo ia dulu tinggal di solo. 2 adm.: residen. -ks. to be r. in tinggal.
residential	ks. kediaman. r. area daerah kediaman.
residual	kb. sisa, peninggalan. -ks. yang ketinggalan. the r. effects of polio akibat-akibat lumpuh kanak-kanak.
residue	kb. 1 residu (of oil). 2 sisa (of an estate).
resign	kkt. 1 berhenti (from a position). 2 meletakkan.
resignation	kb. 1 pengunduran diri, permintaan berhenti. 2 tawakkal, pasrah, penyerahan diri (kepada tuhan).
resilience	kb. 1 gaya pegas, daya kenyal (of a rubber ball). 2 kegembiraan.
resiliency	kb. = resilience.
resilient	ks. 1 berpegas (of rubber). 2 ulet, tabah (of a person).
resin	kb. damar.
resist	kkt. 1 menentang, melawan (change, progress, s.o.'s advances). 2 menahan (rust). 3 menolak (help). -kki. melawan. it's best not to r. sebaiknya jangan melawan.
resistance	kb. 1 perlawanan (to terhadap). 2 kekuatan melawan (to a disease). 3 daya tahan (of steel).
resistant	ks. bersifat melawan/menantang. to be r. to new ideas melawan ide-ide baru.
resistor	kb. (peng)hambat.
resole	kb. mensol lagi.
resolute	ks. 1 pasti. r. determination ketetapan hati yang pasti. 2 tegas. to speak in a r. tone bicara dengan nada tegas. -resolutely kk. dengan tegas.
resoluteness	kb. ketetapan/keteguhan hati.
resolution	kb. 1 resolusi. 2 pemecahan (of a problem). 3 ketetapan hati (on new year). he suffers from a lack of r. ia menderita karena tidak tegas.
resolve	kb. ketetapan hati. -kkt. 1 memecahkan (a problem). 2 memutuskan (to do s.t.). 3 memisahkan, memecahkan (a compound into its parts). 4 berubah.
resonance	kb. kb. gema, gaung.
resonant	ks. 1 resonan, bergema, turut bergetar (of voice). 2 bergaung.
resonator	kb. resonator.
resort	kb. 1 tempat beristirahat, tempat untuk tetirah. summer r. tempat pesiar untuk musim panas. 2 usaha. -kki. 1 terpaksa. 2 mengambil jalan.
resound	kki. bergema, menggema, menggaung. -resounding ks. 1 yang bergema. 2 gemilang. 3 total. -resoundingly kk. secara menyolok sekali, secara meyakinkan.
resource	kb. 1 sumber penghasilan. 2 sumber. 3 akal.
resourceful	ks. banyak akal.
resourcefulness	kb. kepanjangan akal daya.
resp.	1 [respective] masing-masing. 2 [respectively] berturut-turut.
respect	kb. 1 rasa hormat. 2 kehormatan. 3 respek. 4 hal. -respects j. kunjungan kehormatan kepada. -kkt. menghormati (o.s.). 2 mematuhi. -respected ks. 1 yang dihormati. 2 mulia (group). -respecting kd. mengenai.
respectability	kb. (j. -ties) kehormatan, kemuliaan. a man of character and r. seorang lelaki yang berwatak baik dan terhormat.
respectable	ks. 1 terhormat. 2 cukup baik. -respectably kk. sopan.
respecter	kb. yang mengindahkan orang lain. death is no r. of persons kematian tidak kenal pilih kasih.
respectful	ks. hormat. to ber. towards hormat kepada, menghormati. -respectfully kk. dengan hormat.
respective	ks. masing-masing. -respectively kk. berturut-turut.
respiration	kb. pernapasan.
respirator	kb. alat pernapasan.
respiratory	ks. yang berhubungan dengan pernapasan. r. disease penyakit pernapasan. r. organs alat-alat pernapasan.
respite	kb. beristirahat. 2 berhenti. to get a r. mendapat kelonggaran.
resplendent	ks. gilang-gemilang, gemerlapan. to appear r. in an evening gown nampak gilang-gemilang memakai gaun malam.
respond	kki. 1 menjawab, membalas (to a letter). 2 menanggapi, menyahuti. 3 memberi reaksi, menanggapi (to treatment). 4 mudah dikendalikan dengan alat-alat yang ada didalamnya (to the controls). 5 berbunyi.
respondent	kb. yang dituntut (dalam perkara perceraian).
response	kb. 1 jawaban, balasan. in r. to sebagai jawaban atas. 2 (reaktion) tanggapan, reaksi (to terhadap).
responsibility	kb. (j. -ties) pertanggungan jawab, tanggung jawab. the r. fell on him tanggung-jawabnya terletak padanya.
responsible	ks. bertanggung jawab. r. boy anak lelaki yang bertanggung-jawab.
responsive	ks. 1 mau mendengarkan. r. to suggestions mau mendengarkan saran. 2 rel.: bergantian, bergiliran. r. readiing bacaan bergantian (dalam kebaktian gereja).
rest	kb. 1 istirahat. 2 tidur. 3 sisa (of the food). 4 mus: saat berhenti. 5 sandaran (for the back). 6 (respite) ketenangan. 7 lain-lainnya. -kkt. 1 meletakkan (o's head). 2 menentramkan. 3 menyandarkan (a ladder against). 4 mengistirahatkan (o's eyes).
restate	kkt. mengulangi, mengemukakan kembali. to r. a theory menyatakan kembali suatu teori.
restatement	kb. uraian dengan cara lain, uraian baru.
restaurant	kb. restoran, rumah makan. r. business perusahaan restoran, perestoranan.
restful	ks. 1 penuh istirahat/ketenangan. to have a r. night a) melewati malam yang penuh ketenangan (of an ill person). b) tidur dengan tenangnya semalam-malaman. 2 tenang/tentram (spot). 3 menenangkan (to the eyes). 4 menyegarkan/menenangkan (nap).
resthouse	kb. pasanggrahan, rumah (ber)istirahat.
restitution	kb. 1 penggantian rugi, restitusi. to make r. for ... memberikan pengganti kerugian bagi... 2 pemulihan.
restive	ks. 1 gelisah. the crowd became r. orang banyak itu menjadi gelisah. 2 tak sabar. he's a r. individual ia bukan orang yang sabar.
restless	ks. gelisah, resah. to have a r. night tidur gelisah saja. the audience was getting r. hadirin mulai gelisah.
restlessness	kb. keresahan, kegelisahan.
restoration	kb. 1 perbaikan, restorasi (of a building). 2 pemulihan, pemugaran (of security, of a ruler).
restorative	kb. obat yang menyembuhkan/menguatkan/menyegarkan. -ks. yang menguatkan, menyembuhkan, menyegarkan.
restore	kkt. 1 memperbaiki (a house or building). 2 memulihkan (order). 3 mengembalikan (to the throne).
restorer	kb. (tukang) yang memperbaiki, pembikin betul.
restrain	kkt. mengendalikan, menahan (o's curiosity, a crowd). -restrained ks. dengan tenang. r. anger kemarahan yang tertahan (ditahan). restraining order perintah (untuk) menahan.
restraint	kb. pengekangan, pengendalian. r. of trade pengekangan perdagangan.
restrict	kkt. 1 membatasi. 2 melarang (s.o. from leaving). -restricted ks. 1 terbatas. r. material bahan yang terbatas. 2 terlarang (of an area).
restriction	kb. 1 restriksi, pembatasan (as to topic). without r. tanpa dibatasi/kecuali. 2 pelarangan (on a person or group).
restrictive	ks. bersifat membatasi. r. measure tindakan yang membatasi.
result	kb. 1 hasil. 2 akibat. -kki. berakibat, berakhir, berkesudahan. to r. in 1 mengakibatkan, menghasilkan (a heart attack). 2 berakhirkan, berakibat dengan.
resultant	ks. yang diakibatkan/dihasilkan.
resume	kkt. 1 mulai lagi (play). r. speed kembalikan kecepatan (kedalam keadaan normal/biasa). 2 melanjutkan (a speech). 3 duduk kembali (o's seat). 4 mendapat kembali (possession). -kki. mulai lagi.
resume, resume`	kb. ikhtisar, ringkasan.
resumption	kb. 1 pembukaan lagi, penerusan (of negotiations, relations). 2 permulaan lagi. r. of the meeting took place rapat itu dimulai lagi.
resurface	kkt. melapisi lagi (a road).
resurgence	kb. kebangkitan, munculnya/timbulnya lagi.
resurgent	ks. yang bengkit kembali.
resurrect	kkt. 1 menghidupkan kembali (a person). 2 mengeluarkan lagi (an object from the attic).
resurrection	kb. kebangkitan.
resuscitate	kkt. menyadarkan.
resuscitation	kb. hal menyadarkan.
ret.	[retired] pensiun(an), purnawirawan, wredatama.
retail	kb. eceran. to sell at r. menjual eceran. -kkt., kki. memberi harga eceran. r. dealer pedagang eceran. r. price harga eceran, harga ketengan.
retailer	kb. pengecer, pengeteng, pedagang/penjual eceran. -retailers j. kaum pengecer/pengeteng.
retain	kkt. 1 menahan (heat). 2 menahan, menguasai (o's wealth). 3 menyewa, menggaji (a lawyer). 4 memelihara . 5 menyimpan (the stub of a ticket, o's food). 6 tetap memakai (s.o's services). 7 tetap menguasai (control). retaining wall dinding penopang/penguat.
retainer	kb. 1 (servant). bujang, pembantu, pelayan. 2 biaya, gaji, upah. to pay s.o. a r. membayar persekot uang jasa kepada seseorang. 3 alat penahan (for straightening teeth).
retake	kb. (hasil) pemotretan kembali. -kkt. merebut kembali (a town, hill).
retaliate	kki. membalas (dendam).
retaliation	kb. pembalasan (dendam).
retaliatory	ks. yang bersifat pembalasan. r. measures tindakan-tindakan pembalasan.
retard	kkt. memperlambat. -retarded ks. 1 dungu, terbelakang. 2 lambat.
retardation	kb. perlambatan, penghambatan.
retch	kki. muntah-muntah.
retd.	[returned] dikembalikan.
retention	kb. 1 (memory) ingatan. 2 penyimpanan (of stub). 3 hak tetap memiliki (of property).
retentive	ks. bersifat menyimpan. r. memory ingatan yang kuat.
rethink	kkt. memikirkan kembali.
reticence	kb. sikap berdiam diri, sikap tutup mulut, sikap bungkam.
reticent	ks. 1 segan (about untuk). 2 pendiam). that child is r. anak itu pendiam. 3 diam-diam (with dengan), ragu-ragu, malu-malu (with untuk). she is r. with me ia diam-diam dengan saya.
retina	kb. selaput jala.
retinue	kb. rombongan.
retire	kkt. 1 memberhentikan (s.o.). 2 membayarkan (a bond, loan). -kki. 1 pergi tidur. 2 mengundurkan diri (from o's job). 3 mundur (of troops). 4 bertempat tinggal setelah pensiun (to di). -retired ks. 1 pensiunan, purnakaryawan. 2 mil.: purnawirawan.
retirement	kb. 1 pengunduran diri. to come out of r. keluar dari pengunduran diri. 2 pemencilan diri, pertapaan.
retool	kkt. memperlengkapi kembali (faberik).
retort	kb. 1 jawaban. 2 chem.: tabung kimia(wi), labu distilasi. -kki. menjawab dengan pedas.
retouch	kkt. phot.: meretus, mengubah sedikit (untuk memperbaiki).
retrace	kkt. menyelidik kembali (a route). to r. o's steps mengikuti jejak, mencari jejak kembali.
retract	kkt. 1 menarik kembali (a statement, the tongue, an animal's claws). 2 menarik masuk (the landing gear). 3 mencabut (kembali) a confession).
retractable	ks. dapat ditarik masuk. r. landing gear roda-roda pendarat yang dapat ditarik masuk.
retraction	kb. penarikan kembali (of a statement).
retread	kb. ban pulkanisiran. -kkt. 1 mempulkanisir (a tire). 2 melatih (a workman).
retreat	kb. 1 mundurnya (of troops). 2 tempat pengasingan diri. 3 tanda mundur. -kki. mundur.
retrench	kki. mengadakan penghematan, menghemat.
retrenchment	kb. pengurangan (of orders, expenses).
retrial	kb. law : pengadilan ulangan yang kedua.
retribution	kb. balas jasa, ganti rugi.
retrieval	kb. hal mendapatkan kembali. information r. pencarian keterangan.
retrieve	kkt. mendapat kembali. to r. s.o. from rain menolong/menyelamatkan seseorang dari kebangkrutan.
retriever	kb. orang/binatang yang dapat mendapatkan kembali barang-barang yang hilang.
retroactive	ks. berlaku surut (to sampai).
retroflex	ks. terkedik. phon.: r. stop konsonan eksplosif terkedik.
retrograde	ks. yang mundur/memburuk. -kki. mundur, memburuk.
retrogress	kki. mundur.
retrogression	kb. kemunduran.
retrogressive	ks. mundur, merosot.
retrospect	kb. tinjauan kembali.
retrospection	kb. kenangan kembali, retrospeksi.
retrospective	ks. yang berhubungan dengan waktu dahulu, retrospektip.
return	kb. 1 kembalinya. 2 hasil. 3 keuntungan, laba (for o's money on o's investment). 4 kedatangan kembali, pemulangan. 5 (tax) formulir pajak penghasilan. -ks. kembali. -kkt. 1 mengembalikan (a book, compliment). 2 membalas (s.o's love).
returnable	ks. yang dapat dikembalikan.
returnee	kb. orang yang kembali.
reunification	kb. penyatuan kembali.
reunion	kb. reuni.
reunite	kkt. menyatukan kembali (a family, country).
rev	kb. inf.: putaran. -kkt. (revved) memutar (on engine).
rev.	1[review] pertimbangan buku: pemeriksaan parade militer. 2 [reviced] telah diperbaiki, telah ditinjau kembali. 3 [revision] revisi, peninjauan kembali.
revamp	kkt. merubah.
reveal	kkt. 1 menyatakan (o's age). 2 menampakkan. 3 membuka (a secret, o's purpose). 4 mengungkapkan (the facts). -revealing ks. 1 yang membuka pikiran (news, lecture). 2 yang menampakkan bagian badan yang terlarang (dress).
reveille	kb. (terompet) bangun pagi.
revel	kb. kesuka-riaan. -kki. to r. in bersuka-ria dengan gemar akan.
revelation	kb. 1 pembukaan rahasia. 2 wahyu. bibble : revelations wahyu.
reveler	kb. orang yang bersuka-ria.
revelry	kb. (j. -ries) kesuka-riaan yang gaduh.
revenge	kb. pembalasan dendam. to take r. against s.o. melakukan pembalasan dendam terhadap seseorang. -kkt. membalas dendam (o.s., o's humiliation) (on terhadap).
revenue	kb. 1 hasil, penghasilan, pendapatan. 2 pajak. internal r. service jawatan pajak. r. stamp banderol, bea meterai.
reverberate	kki. bergema, bergaung, berkumandang, mengumandang.
reverberation	kb. gaung, gema.
revere	kkt. memuja-muja, menta'zimkan.
reverence	kb. ta'zim, penghormatan. his r. yang terhormat (untuk pendeta).
reverend	kb. pendeta. the r. james doe yang terhormat (pendeta) james doe.
reverent	ks. hormat, ta'zim.
reverie	kb. lamunan, angan-angan.
reversal	kb. 1 pembalikan, pemutaran (of form, attitude). 2 kekalahan. 3 nasib sial, rugi, tak beruntung (in business).
reverse	kb. 1 kebalikan. 2 (business or military) kemunduran, kemalangan. 3 sebalik. 4 auto.: persneling mundur. -ks. sebalik(nya). -kkt. 1 membalik (the order of s.t.). 2 membalikkan (o's testimony). 3 memutar-balikkan (o's decision). 4 memutar (o's car).
reversible	ks. yang dapat dibalik. r. raincoat jashujan yang dapat dipakai terbalik/luar-dalam.
reversion	kb. pengembalian, kembalinya. r. to type pengembalian ke sifat-jenis (yang semula).
revert	kki. kembali pada. his property reverted to the state hak miliknya kembali pada negara.
review	kb. 1 tinjauan. 2 timbangan buku, resensi. 3 mil.: defile. 4 pemeriksaan (of an honor guard). 5 majalah.
reviewer	kb. pemberi resensi buku, peninjau buku, penulis resensi buku.
revile	kkt. mencerca, mencaci-maki.
revise	kkt. 1 meninjau kembali, merobah (o's opinion, the curriculum). 2 memperbaiki, merevisi (a manuscript).
revision	kb. revisi, perbaikan.
revisionist	kb. seorang revisionis.
revival	kb. 1 kebangkitan kembali (of a piece of music). 2 rel.: kebangkitan. 3 kebangunan baru, kebangkitan kembali (of the classic style).
revive	revive
revocation	kb. penarikan kembali, pencabutan, pembatalan (of a law).
revoke	kkt. 1 menarik kembali (an offer). 2 mencabut (a license, law).
revolt	kb. pemberontakan. -kki. 1 memberontak (against terhadap). 2 berrevolusi. 3 bangkit (against menentang). -revolting ks. memuakkan, menjijikkan.
revolution	kb. 1 putaran, balingan (of a motor). 2 revolusi. 3 perkisaran (of a planet). 4 perubahan (in scientific fields). 5 pusingan (of the earth).
revolutionary	kb. (j. -ries) orang yang revolusioner. -ks. revolusioner.
revolutionist	kb. seorang revolusioner.
revolutionize	kkt. merevolusionerkan, merombak (keadaan). mengubah dengan cepat.
revolve	kkt. memutar(kan) (a door, a wheel). -kki. 1 berputar, berkisar,berpusar (around mengelilingi) (of a decision). 2 beredar (of the moon) (around sekeliling). -revolving ks. 1 berputar. 2 beredar.
revolver	kb. pestol, repolper.
revue	kb. sandiwara modern ; pertunjukan tari-tarian, nyanyian-nyanyian, lelucon dsb.
revulsion	kb. 1 perubahan (of feeling). 2 reaksi mendadak.
reward	kb. 1 ganjaran, hadiah. 2 upah, pahala. 3 hukuman. -kkt. 1 mengganjar. 2 memberikan penghargaan (for gallantry). 3 menghadiahi, menghadiahkan. 4 membalas. -rewarding ks. menguntungkan, bermanfaat, berguna.
rework	kkt. mengerjakan/mengolah lagi.
rewrite	kb. karangan yang ditulis kembali. -kkt. (rewrote, rewritten) menulis kembali.
rewritten	lih rewrite
rewrote	rewrote
rhapsody	kb. (j. -dies) 1 mus.: rapsodi. 2 kegembiraan. to go into rhapsodies over menjadi sangat gembira karena.
rhetoric	kb. 1 retorik. 2 kepandaian berbicara/berpidato.
rhetorical	ks. retoris. r. style gaya retoris. r. question pertanyaan yang tak perlu dijawab.
rheumatic	kb. kb. penderita encok. -ks. rumatik, sengal. r. fever demam rematik.
rheumatism	kb. encok, sengal.
rhinitis	kb. radang selaput lendir hidung.
rhino	kb. inf.: badak.
rhinoceros	kb. badak.
rhinolaryngology	kb. ilmu penyakit hidung dan tenggorokan.
rhododendron	kb. sejenis tumbuh-tumbuhan.
rhomboid	kb. paralelogram, jajaran genjang.
rhombus	kb. belah ketupat.
rhubarb	kb. 1 (plant) semacam kelembak. 2 sl.: pertengkaran.
rhyme	kb. sajak. nursery r. sajak kanak-kanak. without r. or reason tanpa sebab. -kki. bersajak.
rhythm	kb. irama.
rhythmic	ks. berirama, r. movement gerak berirama.
rib	kb. 1 tulang rusuk, iga. 2 bingkai (of umbrella). 3 tulang (of aleaf). 4 gading-gading (of ship's frame). -kkt. (ribbed) inf.: menggoda, memperolok -olokkan. -ribbing kb. olok-olokan, godaan.
ribald	ks. carut, cabul, kasar.
ribbon	kb. pita. typewriter r. pita mesin tulis.
rice	kb. 1 padi (in the field). 2 gabah (unulled, unhusked). 3 beras (hulled, husked). 4 nasi (cooked).
rich	kb. the r. j. kaum kaya, yang kaya. -riches j. kekayaan. -ks. 1 kaya. 2 subur (of soil). 3 menggemukkan (of food). 4 berharga. 5 penuh (of tone). 6 beraneka ragam (of color). 7 banyak campuran . -richly kk. 1 secara mewah. 2 pantas sekali.
richness	kb. 1 kesempurnaan (of tone). 2 kesuburan (of soil). 3 rasa lemak pada makanan, banyaknya lemak dalam makanan (of food).
rickets	kb. rakhitis, penyakit inggeris.
rickety	ks. goyang, reyot (of a piece of furniture).
ricksha	kb. angkong, langc(i)a.
ricochet	kb. pengambulan. -kki. mengambul (off dari), memantul (off pada).
rid	kkt. (rid atau ridded) membersihakan. 2 melemparkan. 3 mengisarkan.
riddance	kb. 1 pembersihan, pembuangan. 2 pembebasan (from dari).
ridden	lih ride.
riddle	kb. teka-teki, cangkriman, tebakan. to talk in riddles bicara berbelit-belit. to ask a r. berteka-teki. -kkt. melubang-lubangi (a wall with bullets).
ride	kb. perjalanan dengan mobil). -kkt. (rode, ridden) 1 naik. 2 menunggang (an animal). 3 bersepeda, naik sepeda (a bicycle). 4 inf.: menggoda. -riding kb. berkuda. r. horse kuda tunggang.
rider	kb. 1 penunggang (of horse, bicycle). 2 pengendara (in a car). 3 pasal tambahan (in a contract).
ridge	kb. 1 punggung bukit. 2 bubungan, rabung, perabungan (of a roof). 3 (mountain) pegunungan. 4 daerah. meteor.: low pressure r. daerah tekanan rendah (pada peta cuaca).
ridicule	kb. tertawaan,ejekan. -kkt. 1 menertawakan, mengejek.
ridiculous	ks. menertawakan, edan, menggelikan.
ridiculousness	kb. sifat tak masuk akal, keanehan, keganjilan, ketidakwajaran.
rif	kkt. (riffed). memberhentikan (dari pekerjaan).
rife	ks. 1 penuh. r. with rumors penuh dengan desas-desus. 2 tersebar luas, banyak. small pox is r. in that area cacar air tersebar luas di daerah itu.
riffraff	kb. orang-orang hina dina/jembel, kaum urakan.
rifle	kb. senapan(g), bedil. -kkt. merampok (a drawer, house). r. range lapangan latihan menembak.
rifleman	kb. (j. -men) penembak dengan senapan.
rift	kb. celah, renggang (in the clouds). 2 keretakan (between two people).
rig	kb. 1 inf.: truk. 2 alat-alat pembor. 3 tali-temali (of a sailing vessel). 4 (equipment) perlengkapan. -kkt. (rigged) 1 memasang (a sailing vessel). 2 memperlengkapi (s.t. with). 3 melakukan dengan curang (a race, game). -rigging kb. tali-temali.
rigamarole	kb. = rigmarole.
right	kb. 1 kanan. 2 hak. 3 keadilan. 4 kebenaran. -rights j. hak-hak. -ks. 1 kanan. 2 yang sebenarnya. 3 tepat. 4 benar, betul. 5 benar, tepat, betul. 6 cocok, benar. 7 baik. 8 sehat. -rightly kk. sudah pada tempatnya, sudah sepantasnya.
righteous	ks. 1 berbudi, budiman. 2 yang pada tempatnya. -righteously kk. secara adil, sepantasnya, selayaknya.
righteousness	kb. kebajikan, kebenaran, keadilan.
rightful	ks. 1 syah. r. owner pemilik yang syah. 2 berhak. o's r. duty hak kewajibannya. -rightfully kk. menjadi hak, menurut hak/keadilan.
rightist	ks. berhaluan kanan, konserpatip. r. group golongan kanan.
rightness	kb. kebenaran, keadilan (of o's cause).
rigid	ks. 1 kaku (of a body). 2 keras (discipline, rules). 3 berat, sukar (examination). 4 kejur, keras kaku (of bristle, hair, fiber). -rigidly kk. teguh, keras.
rigidity	kb. (j. -ties) 1 kekakuan (of thinking, of a body). 2 ketegaran, kekerasan (of discipline, rules).
rigmarole	kb. kata-kata hampa, omong kosong, cakap angin.
rigor	kb. 1 kekerasan (of physical exercise, of a law). 2 kekakuan. r. mortis kekauan mayat. 3 kekerasan (of a winter).
rigorous	ks. 1 keras. 2 dengan teliti, setepat-tepatnya.
rile	kkt. inf.: 1 (anger) menggusarkan. 2 (annoy) mengganggu.
rill	kb. 1 sungai kecil, anak sungai. 2 lembah yang panjang lagi sempit (pada bulan).
rim	kb. 1 pelek, lingkaran (of a wheel). 2 bibir (of a cup). 2 pinggir(an) (of a canyon). -kkt. (rimmed) melingkari, mengelilingi.
rime	kb. 1 embun beku. 2 = rhyme.
rind	kb. kulit (buah). watermelon r. kulit buah semangka.
ring	kb. cincin. 2 komplotan. 3 jaringan. 4 box.: gelanggang. 5 lingkaran. 6 dering. 7 gelang-gelang/lingkaran tahunan (in a tree). 8 denting (of a glass). 9 nada. 10 box.: gelanggang tinju. -kkt. (rang, rung) 1 membunyikan (a bell). 2 memukul (an alarm).
ringer	kb. 1 (bell-) tukang lonceng. 2 sl.; orang yang amat mirip dengan. he's a dead r. for my friend ia sangat menyerupai sahabatku. 3 sl.: pemain gadungan/palsu.
ringing	kb. bunyi dering (of bells). ks. yang berbunyi (seperti bel), nyaring.
ringleader	kb. pemimpin gerombolan, biangkeladi.
ringlet	kb. ikal kecil.
ringside	kb. pinggir gelanggang. to have a r. seat mendapat tempat duduk di tepi gelanggang.
ringworm	kb. kurap, kadas. 2 (discase) penyakit kurap.
rink	kb. lapangan luncur es, gelanggang es.
rinse	kb. bilasan. -kkt. 1 membilas (clothes). 2 mencuci (dishes). 3 berkumur (the mouth). -rinsing kb. (pem)bilasan.
riot	kb. kerusuhan, huru hara, keributan, kerisauan. -kki. berbuat rusuh, melakukan huru-hara (against terhadap). -rioting kb. pengacauan, mengacau, berbuat rusuh.
rioter	kb. perusuh, pengacau, pemberontak.
riotous	ks. 1 liar. to lead a r. life hidup liar, hidup tak keruan. 2 bersifat pengacau.
rip	kb. 1 robekan, sobekan (in s.t.). 2 renggutan. -kkt. (ripped) menyobek.
ripe	ks. 1 matang (grain). 2 masak (fruit). 3 siap (for a revolution).
ripen	kkt. mematangkan, memasakkan. -kki. menjadi masak/matang.
ripple	kb. 1 riak. 2 reaksi, suara. -kki. berdesir.
riproaring	ks. bergembira-ria.
ripsnorter	kb. sesuatu yang luar-biasa hebatnya (of a storm).
ripsnorting	ks. sl.: ribut, rusuh.
riptide	kb. air pasang-surut yang saling bertubrukan.
rise	kb. 1 kenaikan. 2 naiknya (of a river, ballon). 3 tanjakan, ketinggian (of a hill). 4 berkembangnya. 5 reaksi. -rising kb. naik. 2 yang bertambah tinggi (of temperature).
risen	lih rise.
riser	kb. 1 orang yang bangun tidur. i'm not an early r. aku tak suka bangun pagi. 2 anak tangga.
risibility	kb. (j. -ties) rasa ingin tertawa. to tickle o's risibilities membangkitkan keinginannya tertawa.
risk	kb. 1 risiko. 2 kemungkinan rugi. -kkt. mengambil risiko.
risky	risky
risque'	ks. agak bersifat cabul, nyerempet kecabulan, condong kepada kecabulan.
rite	kb. upacara, tatacara.
ritual	kb. upacara agama. church r. susunan upacara gereja/kegerejaan. r. dance tari keagamaan.
ritualistic	ks. taat kepada tatacara keagamaan.
ritzy	ks. sl.: mentereng (apartment).
riv.	[river] sungai.
rival	kb. saingan. they are rivals for mereka saling bersaingan untuk. -kkt. 1 menyaingi, menandingi. 2 menyamar (others in s.t.).
rivalry	kb. (j. -ries) persaingan, pertandingan.
river	kb. sungai, kali, batang air. r. basin daerah pengairan sungai, daerah aliran sebuah sungai dan cabang-cabangnya.
riverbank	kb. tepi/pinggir sungai.
riverbed	kb. palung (sungai).
riverside	kb. pinggiran/tepi sungai.
rivet	kb. paku sumbat/keling. -kkt. 1 mengeling (beams together). 2 mamaku, menumpu, memancangkan.
riveter	kb. (ahli) pengeling.
rivulet	kb. anak air/sungai.
rm.	[room] kamar.
roach	kb. coro, lipas. kecuak.
road	kb. 1 jalan. 2 keadaan. road-tested ks. telah dicoba (di jalan).
roadbed	kb. rr.: alas jalan.
roadblock	kb. pengadang jalan.
roadhouse	kb. restoran di pinggir jalan diluar kota.
roadside	kb. tepi/pinggir jalan.
roadstead	kb. pangkalan laut.
roadster	kb. mobil terbuka untuk dua orang.
roadway	kb. jalan (untuk) kendaraan.
roadwork	kb. 1 perbaikan jalan. 2 sport : latihan berlari sepanjang jalan.
roam	kkt. menjelajahi. to r. the earth menjelajahi bumi. kki. mengembara, berkelana. to r. arround the world mengembara mengelilingi dunia.
roan	ks. dauk.
roar	kb. deru (of wind). 2 suara meraung (of a giant). 3 aum, raung (of a lion, tiger). 4 uak (of a bull). 5 bunyi yang gemuruh (of a waterfall). -roaring kb. 1 auman (of a lion). 2 raungan (of sirens). 3 uakan (of a bull). 4 guruh-gemuruh (of cannons).
roast	kb. 1 daging panggang (sapi, daging babi). 2 makan diluar rumah sambil memanggang daging. -kkt. 1 memanggang (meat). 2 membakar, merendang (coffee). 3 inf.: memarahi (s.o. for his error). -kki. terpanggang.
roaster	kb. 1 (pan) alat pemanggang. 2 ayam panggangan.
rob	kkt. (robbed) 1 merampok, merampas, menyamun. she was robbed of her jewels ia dirampok permata-permatanya.
robber	kb. perampok, penyamun, pembegal
robbery	kb. (j. -ries) perampokan, penyamunan, pembegalan.
robe	kb. jubah. (bath-) jubah mandi. judge's r. jubah hakim.
robin	kb. semacam burung murai.
robot	kb. robot, manusia mesin.
robust	ks. tegap, sehat dan kuat, berdegap.
rock	kb. 1 batu. 2 sl.: mus.: musik ngak - ngik-nguk. -kkt. 1 mengayun-ayun (a baby). rock-bottom ks. paling rendah. rock-bound ks. berbatu karang.
rocker	kb. kursi goyang. sl.: to be off o's r. gila, sinting, agak abnormal.
rocket	kb. roket, panah api, cerawat. r. booster pendorong roket. -kkt. meluncurkan. -kki. 1 meluncur. 2 maju dengan cepat.
rocketry	kb. peroketan.
rockslide	kb. longsoran batu.
rocky	ks. inf.: 1 berbatu-batu (of a road). 2 goyang, pusing. i feel r. this morning aku merasa pusing pagi ini.
rod	kb. 1 tangkai, batang. 2 sambuk. 3 balok. 4 rod (ukuran = 5.02 meter).
rode	lih ride.
rodent	kb. binatang mengerat/kerikit, hewan pengerat.
rodeo	kb. rodeo, pertunjukan ketrampilan sambil menunggang kuda, menjerat sapi dsb.
roe	kb. 1 (animal) rusa kecil. 2 (fish) telur-telur ikan.
roentgenologist	kb. ahli sinar rontgen/x.
roentgenology	kb. ilmu sinar rontgen/ x.
roger	kseru. sl.: baiklah, jadilah.
rogue	kb. 1 bangsat, bajingan. 2 anak nakal.
roguish	ks. 1 anak, lucu. 2 jahat, seperti bajingan.
rok	[republic of korea] korea selatan.
role, role	kb. peran(an). to play o's role memainkan perannya. 2 tugas. his r. is to... tugasnya adalah untuk....
roll	kb. 1 gulung, rol. 2 gulungan. 3 goncangan, bantingan (of a ship). 4 (bread) roti kadet. 5 suara gemuruh (of drums). 6 daftar (nama). -kkt. 1 menggulung (bandages, string). 2 menggelinding (a hoop). 3 menggulingkan (a barrel). menggelindingkan.
rollaway	kb. tempat tidur lipatan yang dapat disimpan bila tidak dipakai, ranjang lipat.
roller	kb. 1 bingkai penggulung (for shades). 2 alat-alat penggulung, kawat-kawat gulung (for putting up o's hair). 3 geinding (on furniture). 4 rol mesin tulis. 5 gulungan ombak (on a beach). 6 mesin giling-gilas.
rollicking	ks. bergembira-ria, bersuka-ria.
rolling	kb. (meng)gelinding(nya) (of a ball). ks. 1 berbukit-bukit (country). 2 berombak-ombak, melandai (fields). 3 yang berombak (besar) (sea).
roly-poly	ks. bulat-gendut, pendek-gemuk.
rom.	1 [roman] orang rumawi, yang berhubungan dengan roma. 2 [romance] bahasa-bahasa rumawi. 3 [romanic] bahasa-bahasa rumawi. 4 [romanian] a) orang rumania. b) yang berhubungan dengan negeri rumania. c) bahasa rumania. 5 [romans] orang rum.
rom. cath.	[roman catholic] rum katolik.
roman	kb. orang (dari) roma. -ks. rum, rumawi.
romance	kb. 1 (cerita) roman. 2 percintaan. the r. resulted in marriage percintaan itu berakibat perkawinan. 3 menariknya (of travel). -kki. melamun.
romanian	kb. = roumanian.
romanic	ks. yang berhubungan dengan rumawi. r. languages bahasa-bahaa rumawi (seperti bahasa perancis, bahasa itali dll).
romantic	kb. seorang romantis. -ks. romantis. to play r. roles membawakan peran-peran yang romantis. r. music musik romantis.
romanticize	kkt. meromantiskan.
rome	kb. roma.
romp	kb. 1 permainan. 2 bermain-main dengan riang-gembira (through the woods). -kki. bermain-main (lari kian kemari), berkejar-kejaran.
rompers	kb., j. baju/pakaian main anak-anak kecil.
roof	kb. 1 atap. 2 langit-langit (of the mouth, of a coal mine). -kkt. mengatapi. -roofed ks. beratap. -roofing kb. 1 (bahan) atap. 2 pengatapan.
roofless	ks. tak berumah, tak bertempat tinggal, tunawisma.
rooftop	kb. bubungan atap, nok.
rook	kb. 1 chess : benteng, gajah, tir. 2 (burung) gagak.
rookie	kb. 1 prajurit baru. 2 calon.
room	kb. 1 kamar, bilik. 2 tempat, ruang. 3 kesempatan. -kki. tinggal.
roomer	kb. penyewa kamar, penumpang rumah. to take in roomers menerima penyewa-penyewa kamar.
roomette	kb. kabin tidur (pada gerbong tidur kereta api).
roomful	kb. sekamar penuh.
roominess	kb. lapangnya, kelapangan, besarnya ruang, luas ruangan.
roommate	kb. kawan sekamar.
roomy	ks. lapang, luas. r house rumah yang lapang.
roost	kb. tenggeran. inf.: to rule the r. berkuasa. -kki. bertengger.
rooster	kb. ayam jantan/jago.
root	kb. 1 akar (of aplant, tooth). 2 sumber. 3 asal kata, kata dasar (of a word). 4 akar pangkat. -rooted ks. berakar. deeply r. berurat-berakar.
rooter	kb. 1 simpatisan (at aports events). 2 binatang penggangsir.
rootless	ks. tak menentu, tanpa ketentuan. to lead a r. existence menjalani hidup yang tak menentu.
rope	kb. 1 tali. 2 jerat. 3 untai. -kkt. 1 menjerat (cattle). 2 mengikat.
rosary	kb. (j. -ries) tasbih.
rose	kb. bunga mawar, ros. rose-colored ks. agak merah, merah jambu.
rosebud	kb. kuntum/kuncup bunga mawar.
rosebush	kb. rumpun pohon bunga mawar.
rosin	kb. gala.
roster	kb. daftar nama.
rostrum	kb. mimbar. to take the r. naik keatas mimbar.
rosy	ks. 1 berwarna merah. 2 yang menyenangkan. to have a r. future mempunyai hari depan yang menyenangkan.
rot	kb. dis.: penyakit yang busuk. 2 kebusukan. 3 (tommy-)omongkosong, bual kosong. -kkt. (rotted) membusukkan. -kki. membusuk.
rotary	kb. (j. -ries) (traffic) putaran, bundaran. -ks. berputar. r. engine mesin putar.
rotate	kkt. 1 menggilirkan (a post, job). 2 memutarkan (a wheel). 3 menukar-nukar (crops). --kki. 1 berputar (of a wheel). 2 berpindah tangan (the deanship). -rotating ks. yang berputar. r. body badan/tubuh yang berputar.
rotation	kb. 1 pergiliran (of group, of deanship). 2 perputaran (of the earth). 3 putaran.
rotational	ks. mengenai pemutaran.
rotc, r.o.t.c.	kb. [reserve officers' training corps] korps latihan/pendidikan perwira cadangan.
rote	kb. dihafalkan tanpa berpikir. to learn everything by r. mempelajari setiap hal diluar kepala.
rotisserie	kb. alat panggang listrik.
rotogravure	kb. cetak benam, rotogravure.
rotor	kb. baling-baling, rotor.
rotten	ks. 1 busuk (of food, air). 2 curang. 3 bangar, busuk sekali. 4 buruk. 5 tidak enak.
rottenness	kb. 1 kebusukan. 2 kebobrokan.
rotund	ks. bulat-gemuk, bundar-gemuk.
rotunda	kb. gedfung bundar.
rouge	kb. pemerah muka, gincu pipi. -kkt. memerahi pipi.
rough	kb. 1 golf : rough, rumput yang tinggi. 2 keadaan kasar. -ks. 1 berat (of a sea crossing, flight, math course). 3 kasar, kesat (of skin, wood). 4 buruk (of weather). 5 kasar. 6 dalam garis-garis besar. -roughly kk. 1 secara kasar(nya). 2 kira-kira.
roughage	kb. 1 bagian yang kasar dari makanan. 2 bahan yang kasar.
roughhouse	kb. inf.: bergelut-gelutan, bergelut dengan kasar, permainan kasar. -kki. inf.: bermain gelut, bergelut dengan kasar.
roughneck	kb. orang yang kasar (sifatnya).
roughness	kb. kekasaran, kekesatan.
roughshod	ks. kasar, tanpa mengindahkan. to ride r. over s.o. memperlakukan seseorang dengan kasar, tidak memperindahkan seseorang.
roulette	kb. rulet, (permainan) rolet.
roumanian	kb. 1 orang rumania. 2 bahasa rumania. -ks. yang berhubungan dengan rumania.
round	kb. 1 sport : ronde, babak. 2 ronda, patroli. 3 rentetan. 4 anak tangga (of a ladder). 5 berondongan, tembakan bersama. 6 potong (of beef, veal). 7 ronde (of golf). 8 rentetan, giliran (of drinks).
round-shouldered	ks. berbahu tegap. round-the-clock ks. siang-malam. -rounded ks. 1 yang dibulatkan. 2 montok. -roundly kk. sama sekali (defeated).
roundabout	roundabout
roundhouse	roundhouse
roundup	kb. 1 pengumpulan (of cattle). 2 pertemuan (of friends).
roundworm	kb. cacing gelang.
rouse	kkt. 1 membangunkan (s.o. from sleep). 2 membangkitkan, merangsang (s.o. to reply, the masses). -rousing ks. meriah (welcome).
roustabout	kb. buruh pelabuhan.
rout	kb. gerakan mundur dalam keadaan kacau-balau. -kkt. 1 mengalahkan secara total, mengusir, menghancurkan (the enemy). 2 memaksa membangunkan (s.o. out of bed).
route	kb. 1 rute, lin (of streetcar, bus). 2 trayek. 3 jalan. -kkt. 1 mengarahkan perjalanan (via melalui). 2 mengirimkan melalui (a memo).
routine	kb. rutin, kebiasaan sehari-hari.
rove	kkt. menjelajahi (the sea). -kki. mengembara, berkelana. roving ks. keliling. r. ambassador duta besar keliling.
rover	kb. 1 pengembara, kelana. 2 (pirate) penyamun laut(an), bajak laut.
row	kb. 1 jajaran, baris. 2 deret(an), leretan. 3 perdayungan, mengayuh, mendayung. -kkt. mendayung, mengayuh (a boat). -kki. mendayung. -rowing kb. mendayung.
rowboat	kb. perahu dayung.
rowdy	kb. (j. -dies) orang yang suka bergaduh. -ks. kasar dan suka bergaduh.
rower	kb. pendayung, pengayuh.
royal	ks. 1 raja. 2 kerajaan. 3 megah. -royally kk. secara meriah. we were entertained r. kami dihibur secara meriah.
royalty	kb. (j. -ties) 1 raja, keluarga raja. to be treated like r. diperlakukan sebagai seorang raja. 2 (fee) honorarium.
rpt.	[report] laporan.
rt.	[right] kanan.
rt. hon.	[right honorable] yang amat terhormat.
rt. rev.	[right reverend] gelar kehormatan bagi pendeta.
rte.	[route] rute, arah, jalan.
rub	kb. 1 gosokan (of a cloth on s.t.). 2 kesukaran. -kkt. (rubbed) 1 menggosok (o's hands with s.t.). 2 menggosok-gosokkan (o's hands together, two stones together). -kki. 1 menggosok. 2 bergesek (against pada).
rubber	kb. 1 karet. natural r. karet alam. 2 cloth.: sepatu karet. 3 bridge : rober. r. stamp 1 setempel karet, cap. 2 orang atau sekelompok orang yang menyetujui sesuatu.
rubberized	ks. berlapis karet (of a diving suit).
rubberneck	kb. sl.: penonton yang kurang adab. -kki. memandang dengan memanjangkan/mengulurkan leher.
rubbery	ks. elastis, sebagai karet.
rubbish	kb. 1 sampah, kotoran, rosokan. 2 omong-kosong. to talk r. membual, berbicara omong-kosong.
rubble	kb. kb. (re)runtuhan, puing.
rubdown	kb. pijitan, urutan.
rube	kb. (orang) udik.
rubicon	kb. to cross the r. mengambil keputusan.
rubric	kb. rubrik.
ruby	kb. (j. -bies) batu delima. -ks. merah delima.
rucksack	kb. ransel
ruckus	kb. kehebohan, keirbutan. to cause a r. menimbulkan kehebohan.
rudder	kb. kemudi.
ruddy	ks. merah(sehat). r. complexion wajah yang sehat kemerah-merahan.
rude	ks. 1 tidak sopan, kasar (to, towards terhadap). 2 kasar, primitip, bersahaja (tools, implements). -rudely kk. kasar.
rudeness	kb. 1 ketidaksopanan, kekasaran (of a person). 2 kekasaran (of an object).
rudiment	kb. 1 dasar. 2 permulaan.
rudimentary	ks. 1 bersifat elementer. 2 belum sempurna.
rue	kkt. menyesal, menyesalkan.
rueful	ks. sedih, menyedihkan, bersesal hati.
ruffian	kb. bajingan, bangsat.
ruffle	kb. 1 kerut (in a skirt). 2 bunyi derang (of a drum). -kkt. 1 mengganggu, membuat bingung (a person). 2 memberi kerut-kerut (a skirt). 3 menggelepai-gelepaikan. -kki. berkibar (of a flag).
rug	kb. permadani, babut.
rugged	ks. 1 tidak datar. 2 kasar dan berat (of work). 3 keras tabiatnya. 4 berat, sukar (of an exam). 5 kasar (of complexion). 6 kasar/keras (features). 7 tidak rata tanahnya (landscape).
ruggedness	kb. 1 ketidakdataran, ketidakrataan (of terrain). 2 kekerasan, kekasaran.
ruin	kb. 1 kejatuhan. 2 reruntuhan (of a building). 3 puing. 4 kehancuran. -kkt. 1 merusak(clothes). 2 merusak, memburuk-burukkan (o's reputation). 3 menggagalkan (a party, picnic). 4 memusnahkan (a building). 5 menghancurkan, menjatuhkan. 6 mengganggu.
ruination	kb. kehancuran, kejatuhan. that will be the r. of him itu akan menyebabkan kejatuhannya.
ruinous	ks. 1 membinasajkan, menghancurkan (war). 2 menghabiskan segala harta-benda (expenses).
rule	kb. 1 peraturan. 2 kebiasaan. 3 kekuasaan. 4 kaidah. 5 belebas, mistar. -kkt. 1 menguasai (s.o.). 2 memerintah (a country). 3 mengepalai (an office). 4 menguasai, mengendalikan (o's possions). 5 memutuskan. 6 menggarisi. --ruling kb. putusan.
ruler	kb. 1 (chief) raja, penguasa. 2 mistar, belebas, penggaris, garisan.
rum	kb. sejenis minuman keras yang dibuat dari tebu.
rumanian	= roumanian.
rumba	kb. sejenis tarian/dansa.
rumble	kb. 1 gemuruh (of thunder). 2 bunyi gerabak-gerubuk (of a cart). 3 sl.: kegaduhan, pertengkaran, kehebohan. -kki. 1 bergemuruh (of thunder, a volcano). 2 berderu, menderum (of a vehicle). -rumbling kb. 1 suara gaduh (among the people). 2 keroncongan.
ruminant	kb. (binatang) pemamah biak.
ruminate	kki. 1 memamah biak (of cattle). 2 merenung(kan) (on the past).
rummage	kb. 1 barang rombengan. 2 penggeledahan (through the attic). -kki. 1 menggeledah (through a drawer). 2 menggerayangi, mengubrak-abrik (in/through pockets).
rummy	kb. semacam permainan kartu.
rumor	kb. desas-desus, kabar angin, selentingan. -kkt. it is rumored that... didesas-desuskan bahwa...
rumormonger	kb. pembuat desas-desus.
rump	kb. pantat (of an animal). r. roast daging pantat panggang.
rumple	kkt. 1 mengusutkan, mengumalkan (hair, skirt, trousers). 2 meremas (a sheet of paper). -kki. mengusut. -rumpled ks. kumal, kusut. r. clothes pakaian yang kusut.
rumpus	kb. huru hara, ribut, kehebohan. to raise a r. membikin ribut, ramai sekali.
run	kb. 1 lari. 2 lubang (karena tisikan lepas) (in hose). 3 perjalanan. 4 giliran bermain. 5 pengambilan uang secara beramai-ramai. 6 tempat bergerak. 7 kawanan. 8 menari-narikan jarinya. 9 banyaknya. 10 oplah, jumlah penerbitan. 11 kandang.
run-down	ks. 1 tak terpelihara (of a house). 2 aus, susut (of shoes). 3 lesu, letih (of a person).
run-in	kb. pertengkaran, bentrokan. run-of-the mill ks. biasa saja. run-through kb. ulangan (of a role).
runaround	kb. inf.: dalih/alasan yang bukan-bukan/yang tidak diberi jawaban, keputusan yang memuaskan.
runaway	kb. 1 seorang pelarian. 2 yang enteng. the game was a r. pertandingan itu enteng.
rundown	kb. inf.: 1 laporan. 2 ikhtisar.
rung	1 anak tangga/janjang (of a ladder). 2 anak kursi (of a chair). lih ring.
runner	kb. 1 pelari. 2 (messenger) pesuruh. 3 tapak, rel (on a sled). 4 alas (for table). 5 sulur (of plants). runner-up kb. nomor dua.
runny	ks. basah. r. nose ingusan.
runt	kb. yang kerdil, katik.
runway	kb. landasan kapal terbang.
rupture	kb. med.: burut. 2 putusnya, perputusan, perpecahan (in relations). -kkt. memecahkan (o's appendix). -kki. pecah.
rural	ks. pedusunan, pedesaan, pedalaman. to live in a r. area tinggal di daerah pedalaman/pedesaan.
rus.	(russian) yang berkaitan dengan rusia.
ruse	kb. tipu muslihat, kelicikan.
rush	kb. 1 kesibukan, kerepotan. 2 desakan, keramaian (of the crowds). 3 menyerang, menyerbu (a position). 4 membuat buru-buru. 5 mendorong. -rushing kb. kesibukan.
rusk	kb. semacam roti.
russ.	1[russia] rusia. 2 [russian] orang rusia ; bahasa rusia.
russia	kb. rusia.
russian	kb. 1 orang rusia/rus. 2 bahasa rusia. -ks. yang berkaiatan dengan rusia.
rust	kb. karat, tahi besi. -kkt. membuat berkarat. -kki. 1 berkarat. 2 tidak terpelihara, kurang baik, kelupaan. rust-colored ks. berwarna kuning-tua/cokelat/merah-cokelat.
rustic	ks. pedusunan. 2 kasar. 3 kedusun-dusunan (of manner of speaking).
rustiness	kb. 1 kekaratan, keadaan berkarat (of machinery). 2 (out of practice) kekakuan.
rustle	kb. desir, desau (of leaves). -kkt. 1 menggersik (paper). 2 inf.: mencuri (cattle). -kki. berdesir, berdesau, menggerisik (of leaves). -rustling kb. 1 gersik/gersak (of paper). 2 mencuri (of cattle).
rustler	kb. pencuri.
rustproof	ks. tahan karat.
rusty	ks. 1 berkarat (of a nail). 2 lupa, kaku (of piano playing).
rut	kb. 1 bekas roda (in a road). 2 masa berkelamin (of certain animals). 3 kebiasaan).
ruthless	ks. zalim, kejam, bengis. he is absolutely r. ia betul-betul zalim.
ruthlessness	kb. kezaliman, kekejaman.
rx	kb. resep dokter.
ry	[railway] perusahaan kereta api.
rye	kb. gandum (hitam). r. bread roti/gandum (hitam).
s	[south] selatan. 2 [southern] sebelah selatan].
s, s	kb. huruf kesembilanbelas dari abjad inggris.
s.	1 [series] seri. 2 [shiling(s)] shiling. 3 [singular] tunggal. 4 [substantive] kata benda. 5 [second] detik.
s. am.	[south america] amerika selatan.
s.a.	1[south africa] afrika selatan. 2 [south america] amerika selatan. 3 [sex appeal] daya tarik seks/ kelamin.
s.c.	1[south carolina] negarabagian a.s. 2 [signal corps] korps komunikasi. 3 [supreme court] mahkamah agung.
s.d.	1 [south dakota] negara bagian as. 2 [doctor of science] doktor ilmu pengetahuan.
s.dak	[south dakota] negaarabagian as.
s.doc.	[senate document] dokumen senat (as).
s.j.d.	[doctor of furidical science] doktor ilmu hukum.
s.o.b.	kb. vulg.: bajingan.
s.p.	[shore patrol] polisi militer al.
s.p.c.a.	[society for the prevention of cruelty to animals] himpunan penyayang binatang.
s.r.o.	[standing room only] tempat untuk berdiri (saja).
s.res.	[senat resolution] resolusi senat.
s.s.	1 [steamship] kapal api. 2 [straits settlements] semenanjung malaka.
s/s	[steamship] kapal api.
s/sgt	[staff sergeant] sersan kepala/staf.
sabbath	kb. (hari sabat. to keep the s. mentaati hari istirahat.
sabbatical	kb. cuti panjang atau besar untuk istirahat, studi atau bepergian. s. leave/year cuti panjang.
saber	kb. pedang, mandau. s. rattling pameran kekuatan senjata, ancaman menyerang.
sable	kb. 1 semacam musang kecil. 2 kulit berbulu dari musang kecil.
sabotage	kb. sabotage, sabot. -kkt. menyabot, menyabotir, merusakkan.
saboteur	kb. penyabot.
sac	kb. kantong, pundi-pundi.
saccharine(e)	kb. sakharin, sakarin. -ks. manis sekali.
sachet	kb. 1 bedak wangi. 2 pundi-pundi bedak.
sack	kb. karung, goni. s. of flour karung tepung. -sacking kb. 1 kain karung. 2 perampokan, penggarongan ( of a town).
sackcloth	kb. kain karung. in s. and ashes tobat.
sackful	kb. sekarung penuh.
sacrament	kb. sakramen. to receive the s. menerima sakramen (pengampunan misalnya).
sacramental	ks. menurut sakramen.
sacred	ks. keramat, suci, kudus, muhar(r)-am. s. ground tanah suci.
sacrifice	kb. 1 pengorbanan (of o's freedom). 2 korban (on the altar). -kkt. 1 mengorabnkan (o's health). 2 menjadi korban (an animal). -kki. berkorban.
sacrificial	ks. berkorban. s. rites upacara-upacara (ber)korban.
sacrilege	kb. pelanggaran terhadap hal-hal yang dianggap keramat.
sacrilegious	ks. yang melanggar kesucian, a-susila.
sacroiliac	kb. penyambungan tulang kelangkang dan tulang usus.
sacrosanct	ks. amat suci/keramat.
sad	ks. (sadder, saddest) 1 sedih. 2 emnyedihkan.
sadden	kkt. menyedihkan, membuat sedih.
saddle	kb. 1 pelana (on a horse). s. horse kuda tunggangan. 2 tempat duduk, sadel (on bicyle). -kkt. 1 memasang pelana, memelanai (a horse). 2 membebani, memberati.
sadism	kb. sadisme, keinginan yang abnormal untuk berbuat kejam.
sadist	kb. sadis.
sadistic	ks. sadistis, amat kejam/mengerikan.
sadly	kk. amat sayang. he is s. mistaken ia keliru sekali.
sadness	kb. kesedihan, kepiluan, kesayuan.
safari	kb. ekspedisi berburu.
safe	kb. peti besi. -ks. 1 aman. 2 tidak berbahaya. 3 selamat. 4 hati-hati (of a driver). 5 kuat, dapat dipercaya (of a bridge). 6 tepat. -safely kk. dengan selamat/aman.
safecracker	kb. pembongkaran peti besi.
safecracking	kb. pembongkaran peti besi.
safeguard	kb. 1 usaha perlindungan (against terhadap). 2 usaha penjagaan. -kkt. melindungi, menjaga (o's health, valuables).
