attentive	ks. penuh perhatian. he was a. to what she said ia penuh perhatian terhadap apa yang dikatakannya.
attentively	kk. dengan penuh perhatian.
attenuate	kkt. menipiskan, menguruskan, melemahkan.
attest	kkt. membuktikan, memperlihatkan. -kki. menegaskan, menyokong.
attestation	kb. pengesahan.
attested	attested
attestor	kb. penyokong kebenaran.
attic	kb. loteng.
attire	kb. pakaian. -kkt. berpakaian, mengenakan pakaian. she was attired in her best dress ia mengenakan bajunya yang paling baik.
attitude	kb. 1 sikap. she struck an a. of utter disbelief ia mengambil sikap tidak percaya sama sekali. 2 pendirian. 3 letak. the a. of the space ship was changed letak kapal ruang angkasa itu sudah berubah.
attorney	kb. pengacara. to consult an a. minta pertimbangan seorang pengacara.
attract	kkt. menarik. he's trying to a. your attention ia mencoba menarik perhatianmu.
attraction	kb. 1 atraksi. 2 daya tarik. 3 acara.
attractive	ks. menarik, cantik, molek.
attributable	ks. diakibatkan oleh.his ilness is a. to the heat penyakitnya diakibatkan oleh panas.
attribute	kb. 1 sifat.2 perlengkapan, benda yg khusus berh. dng pangkat, kedudukan, lambang.-kkt. 1 mempertalikan. 2 menghubungkan.
attributive	ks. atributip, kata sifat yang terletak langsung didepan atau dibelakang kata bendanya, umpamanya: the book, "a large one," is on the table one adalah atributip. "morning" dalam morning star adalah atributip.
attrition	kb. 1 erosi, aus. 2 pengurangan.
attune	kkt., kki. membiasakan, menyesuaikan diri pada. he is attuned to the noise ia sudah biasa dengan keributan itu.
atty.	(attorney) pengacara.
atty. gen	(attorney general) jaksa agung.
atypical	ks. tidak khas, tidak teratur, tidak normal.
auburn	ks. pirang, perang. auburn-haired berambut pirang.
auction	kb. lelang, pelelangan -kkt. melelang. to a. of melelang habis.
auctioneer	kb. juru lelang.
audacious	ks. berani.
audacity	kb. (j. -ties) keberanian. she had the a. to tell me to go home ia berani menyuruh saya pulang.
audibility	kb. kemampuan didengar.
audible	ks. terdengar, kedengaran, dapat didengar.
audience	kb. 1 (para) hadirin, penonton, pendengar. the a. seemed enthusiastic para hadirin kelihatannya antusias.
audio	kb. penerimaan bunyi, pendengaran. audio-visual ks. audio-visuil. a. -visual aids alat-alat peraga(an).
audit	kb. pemeriksaan keuangan. -kkt. 1 memeriksa (keuangan). 2 belajar sebagai pendengar.
auditing	kb. memeriksa (keuangan).
audition	kb. percobaan, teristimewa bagi penyanyi atau pemain musik. -kki. melakukan percobaan.
auditor	kb. 1 akuntan. 2 pendengar.
auditorium	kb. suatu ruang besar untuk pertunjukan musik dan sandiwara, ruang kuliah, aula.
auditory	ks. yang berhubungan dengan pendengaran.
aug.	(august) agustus.
auger	kb. bor, gurdi, gerek, kayu.
augment	kkt. memperbesar, memperbanyak, menambah. he augmented his income whit a night job dia memperbesar penghasilannya dengan bekerja malam.
augmentation	kb. tambahan.
augur	kki. meramalkan. this augurs well for the future ini memberi harapan baik.
augury	kb.(j. -ries) ilmu nujum, pertanda.
august	ks. penuh kebesaran. his a. presence was immediately noted kehadirannya yang penuh kebesaran itu segera menarik perhatian. an a. body rapat yang mulia. kb. (bulan) agustus.
aunt	kb. bibi, tante.
auntie	kb. inf.: bibi, tante.
aura	kb. pancaran, lingkaran cahaya. an a. of kindness surrounded the hostess. pancaran keramahan meliputi nyonya rumah.
aural	ks. yangberhubungan dengan penfengaran atau telinga.
aureole	kb. lingkaran cahaya yang kelihatan bersinar dari kepala seorang yang suci.
aureomycin	kb. aureomysin (obat antibiotik).
auricle	kb. 1 daun telinga. 2 serambi jantung
aurora	kb. fajar, sinar waktu fajar. a. borealis cahaya di langit bagian utara.
auspice	kb. 1 bantuan. he went to burma under the auspices of his university ia pergi ke birma dengan bantuan universitasnya. 2 pertanda yang baik, perlindungan.
auspicious	ks. menguntungkan. it was an a. occasion itu adalah kesempatan yang menguntungkan.
austere	ks. keras, tegang, cermat. my favorite professor was an a. man profesor kesayangan saya adalah seorang yang keras.
austerity	kb. (j. -ties) ketegangan, kekerasan, kecermatan. a. program rencana penghematan.
australia	kb. australi(a).
australian	kb. orang australi. -ks. sesuatu yang berasal dari atau berhubungan dengan australi.
austria	kb. austria.
austrian	kb. seorang austria. -ks. sesuatu yang berasal dari atau berhubungan dengan austria.
austronesian	ks. 1 sesuatu yang berasal dari atau berhubungan dengan austronesia. 2 rumpun bahasa austronesia.
autarchy	kb. (j. -chies) autarki.
authentic	ks. asli. a. handwriting tulisan tangan asli.
authenticate	kkt. membuktikan (bahwa sesuatu asli atau benar). it is difficult to a. the handwriting sukar untuk membuktilan keaslian tulisan itu.
authentication	kb. pembuktian keaslian sesuatu.
authenticity	kb. kaslian, kebenaran. the a. of this document is beyond question keaslian dokumen ini tidak disangsikan lagi.
author	kb. pengarang, penulis. -kkt. mengarang.
authoress	kb. pengarang/penulis wanita.
authoritarian	ks. otoriter, menganut paham kepatuhan mutlak kepada seseorang. atau badan. he's an a. individual dia seorang yang bersifat otoriter.
authoritarianism	kb. sifat otoriter, paham mematuhi seseorang atau badan secara mutlak.
authoritative	ks. 1 berwenang. a. source sumber yang berwenang. 2 dengan cara memerintah. to speak in an a. manner berbicara dengan cara memerintah.
authority	kb. (j. -ties) 1 wibawa. 2 hak untuk bertindak 3 ahli. 4 wewenang. 5 sumber. -the authorities j. 1 yang berkuasa. 2 para ahli.
authorization	kb. otorisasi, hak. do you have the a. to sign this order? apakah saudara mempunyai hak untuk menandatangani perintah ini?.
authorize	kkt. 1 memberi kuasa/hak. 2 mengesahkan.
authorized	ks. di (ab) sahkan.
authorship	kb. kepengarangan.
auto	kb. mobil, oto. a. mechanic montir mobil.
autobiographer	kb. penulis riwayat hidup sendiri.
autobiographical	ks. yang berhubungan dengan riwayat hidup sendiri. the story is a. cerita itu merupakan riwayatnya sendiri.
autobiography	kb. (j. -phies) riwayat hidup yang ditulis sendiri.
autochthonous	ks. asli, berasal dari tempat asli.
autocracy	kb. (j. -cies) otokrasi.
autocrat	kb. atokrat.
autocratic	ks. yang bersifat otokrasi.
autodidact	kb. otodidak.
autodidactic	ks. secara mendidik diri sendiri.
autograph	kb. 1 tanda tangan seseorang. 2 tulisan sendiri seorang tertentu. -kkt. menandatangani, menulisi dengan tulisan sendiri.
automat	kb. otomat, mesin berisi makanan, minuman, rokok dan lainnya yang dapat dikeluarkan dengan mengisi uang logam.
automate	kkt. menotomatiskan, mengotomatkan. to a. a library menjadikan perpustakaan digerakkan dengan cara otomatis.
automatic	ks. otomatis. a. drive setir otomatis.
automatically	kk. 1 secara otomatis. 2 dengan sendirinya.
automation	kb. otomatisasi. a. has been introduced into this factory dalam pabrik ini otomatisasi telah mulai dilaksanakan.
automaton	kb. orang/hewan yang bergerak secara otomatis.
automobile	kb. mobil, oto.
automomous	ks. swatantra. a. region daerah swatantra.
automotive	ks. yang berhubungan dengan mobil. a. engineer ahli mobil. in the a. field dalam bidang permobilan.
autonomy	kb. (j. -mies) otonomi.
autonym	kb. nama asli seorang pengarang.
autopsy	kb. (j. -sies) bedah/pemeriksaan mayat, autopsi(a).
autosuggestion	kb. otosugesti, sugesti pada diri sendiri yang mengakibatkan perubahan-perubahan rohani dan jasmani.
autotoxin	kb. racun yang timbul dalam badan
autotruck	kb. (motor) truk, prahoto.
autumn	kb. musim gugur/rontok/runtuh.
autumnal	ks. yang berhubungan dengan musim gugur.
auxiliar	kb. (j. -ries) alat pembantu. -auxiliaries j. pasukan asing yang membantu dalam peperangan. -ks. 1 (pem)bantu. 2 pembantu, penolong.
avail	kb.guna, faedah. -kkt. membantu, berfaedah bagi. to a. o. s. of mengambil manfaat, memakai kesempatan.
availability	kb. (j. -ties) adanya, tersedianya, terdapatnya. the a. of a good school is an important factor adanya sekolah yang baik merupakan faktor yang penting.
available	ks. 1 yang ada, tersedia, didapatkan. every a. seat was taken tiap-tiap kursi yang ada telah ditempati. 2 dapat. will you be a. to go with me? dapatkah engkau pergi dengan saya?
avalanche	kb. 1 salju/es longsor. 2 tanah/batu longsor. he was subjected to an a. of questions ia dihujani pertanyaan - pertanyaan.
avant-garde	kb., ks. golongan perintis/pelopor, terutama dalam seni.
avarice	kb. 1 ketamakan, keserakahan. 2 kekikiran.
avaricious	ks. 1 tamak, serakah. 2 kikir.
avenge	kkt. menuntut bela, membalas dendam.
avenger	kb. penuntut balas.
avenging	avenging
avenue	kb. 1 jalan raya/besar. 2 kesempatan. many avenues are open to him banyak kesempatan terbuka baginya.
aver	kkt. (averred) menyatakan dengan tegas, menegaskan. he averred that he was innocent ia menyatakan dengan tegas, bahwa ia tidak bersalah.
average	kb. pukul rata. on an/the a. rata-rata. -ks. rata-rata, sedang, biasa, pukul rata. to a. out 1 menjadi berimbang/seimbang. 2 membagikan pukul rata.
averse	ks. menolak, menentang. he's not a. to a drink ia tidak menolak untuk minum (minuman keras).
aversion	kb. 1 keengganan, keseganan. 2 sesuatu yang tidak disukai.
avert	kkt. 1 menghindarkan, mencegah. 2 memalingjkan muka/pandangan.
avg.	(average) pukul rata, rata-rata.
aviarist	kb. orang yang memelihara burung sejumlah besar.
aviary	kb. (j. -ries) kandang burung yang besar.
aviation	kb. penerbangan. a. medicine (ilmu) kedokteran penerbangan.
aviator	kb. penerbang, pilot.
aviatrix	kb. penerbang wanita.
aviculture	kb. peternakan burung.
avid	ks. 1 keranjingan, gemar sekali.2 ingin sekali mendapat.
avidity	kb. keinginan/kegemaran yg besar utk mendapat/ memiliki/ mencapai s.s.t.
avifauna	kb. dunia burung di suatu daerah.
avocado	kb. buah a (d) pokat.
avocation	kb. kegemaran, sambil.
avoid	kkt1. menghindari, menghindarkan. 2 menjauhi.
avoidable	ks. dpt dihindarkan/ dielakkan.
avoirdupois	kb. ukuran berat.
avow	kkt. mengakui.
avowal	kb. pengakuan. he made an a. of his guilt ia memberikan pengakuan atas kesalahannya.
avowed	avowed
avuncular	ks. dari/seperti paman.
await	kkt. 1 menunggu, menantikan. 2 menunggukan.
awake	ks. bangun.he is not a. ia tidak bangun.
awaked	--kkt.(awoke atau awaked) membangunkan. -kki. bangun.
awaken	kkt. 1 membangunkan. 2 membangkitkan. -kki. bangun.
awakening	kb. (ter)bangun, kesadaran.
award	kb. 1 hadiah. 2 pemberian. -kkt. 1 menghadiahkan, menyerahkan. 2 menyerahkan.
aware	ks. 1 tahu, sadar, insaf. 2 mengetahui, sadar akan.
awash	kk. terapung-apung, diliputi ombak, terendam air. the deck was a. geladak kapal itu terendam air.
away	ks. jauh. -kk. 1 jauh. it's too far a. for you to go tempat itu terlalu jauh letaknya untuk kamu. 2 dengan sibuk. she sat and sewed a. dia duduk dan dengan sibuk menjahit.
awe	kb. perasaan terpesona/kagum. -kkt. membuat terpesona/kagum. awe-inspiring ks. membangkitkan rasa hormat. awe-stricken, awe-struck ks. 1 terpesona. 2 diliputi perasaan khidmat.
aweigh	kk. mengangkat. anchors a.! angkat sauh!.
awesome	ks. mengagumkan, membuat terpesona. it was an a. sight to behold pemandangan itu benar-benar mengagumkan.
awful	ks. 1 mengerikan dahsyat. 2 hebat.
awfully	kk. inf.: sekali, sangat.
awhile	kk. sebentar. please come to my office a. silahkan masuk kantorku sebentar.
awkward	ks. 1 aneh, janggal, kaku, kikuk, rikuk, canggung. 2 buruk sekali, canggung.
awkwardly	kk. dengan janggal.
awkwardness	kb. kejanggalan, kekakuan.
awl	kb. jarum pengerek, pusut, penusuk.
awning	kb. tenda rumah, kajang, kere.
awoke	lih awake
awol	(absent without leave) absen tanpa mendapat cuti.
awry	ks., kk. 1 serba salah, bersalahan. 2 miring.
ax(e)	kb. kampak, kapak. -kkt. 1 mengurangi, memotong (expenditures). 2 memecat, memberhentikan (personnel).
axial	ks. aksial.
axiom	kb. aksioma.
axiomatic	ks. aksiomatis, yang sudah jelas kebenarannya.
axis	kb. as, poros, sumbu, sendi. the earth's a. poros bumi. the a. negara-negara as.
axle	kb. gandar/as roda.
aye	kb. setuju.the tally is four ayes and two nays; the ayes have it hitungannya empat setuju dan dua tidak setuju. yang setuju menang. -kk ya. a., a., sir! ya, pak.
azalea	kb. semacam tanaman berbunga indah.
azimuth	kb. asimut, ukuran sudut, letak bintang.
azure	ks. biru (langit). an. a. sky langit biru.
b	kb. 1 huruf yg kedua dlm abjad inggris. 2 nota dlm musik. 3 angka yg kedua (dlm pilem-pilem).
b.	(born) lahir.b. 1934 lahir 1934.
b. litt	(bachelor of literature) sarjana muda sastera.
b.a.	(bachelor of arts) sarjana muda.
b.c.	(before christ) sebelum masehi.
b.s.	(bachelor of science) sarjana muda (umumnya dalam ilmu pengetahuan).
b.s.ed.	(bachelor of science in education) bakaloreat dalam ilmu pendidikan, sarjana muda ilmu pendidikan.
b.th.	(bachelor of theology) bakaloreat dalam ilmu agama.
babble	kb. omongan, ocehan, celoteh.2 suara air mengalir.-kki. meraban ( omong-omong).
babe	kb. 1 bayi. 2 orang kurang pengalaman, pelonco.3 sl.: cewek. some b.! bukan main cewek itu ! b. in arms 1 sangat muda, blm dpt berdiri sendiri. 2 orang yg tidak berpengalaman.
babied	lihat baby
babies	lihat baby
baboon	kb. yakis, bavian.
baby	kb. (j.-bies) 1 bayi, orok.2 kebayi-bayian.1 bermuka spt bayi. 2 sangat muda dan murni rupanya.
babysit	kkt., menjaga anak (waktu orang tua mereka pergi).
babysiting	kb. pekerjaan menjaga anak (ketika orang tua mereka pergi).
babysitter	kb. penjaga anak-anak (ketika orang tua anak-anak itu berpergian).
baccalaureate	kb. bakaloreat, sarjana muda (tingkat kesarjanaan yang terendah).
bachelor	kb. 1 jejaka, bujang(an), belum kawin. b. girl wanita yang belum kawin. 2 sarjana muda. bachelor's degree tingkat/gelar sarjana muda. b. of arts sarjana muda (ilmu sastera).
bachelorhood	kb. kejejakaan.
bachelorship	kb. 1 kesarjanaan. 2 tiingkat kesarjanaan. 3 masa bujang, kejejakaan.
bacillary	ks. basiler. b. dysentery disentri basil(i).
bacilli	j. lih bacillus.
bacillus	kb. (j. bacilli) basil.
back	kb. 1 punggung. 2 sebelah belakang. 3 sandaran. 4 (soccer) bek, pemain belakang. 5 kekuatan. -ks. 1 belakang. 2 tunggakan. 3 lama. -kkt. 1 menyokong. 2 mengongkosi. to b. a way 1 mengelakkan diri, mundur. 2 mengundurkan diri,mundur.
backache	kb. sakit punggung.
backbite	kkt., kki. memfitnah. she is always backbiting dia selalu memfitnah.
backbone	kb. 1 tulang punggung. 2 kekuatan. he doesn't have much b. dia tidak mempunyai kekuatan.
backbreaker	kb. melelahkan, meletihkan. that job is a real b. pekerjaan ini sangat melelahkan.
backbreaking	ks. sangat melelahkan. that's b. work itu pekerjaan yang sangat melelahkan.
backdown	kb. kemunduran, pengunduran. that was a b. for that country itu adalah kemunduran bagi negara itu.
backdrop	kb. latar belakang. the incident took place against the b. of a slum area peristiwa itu terjadi dengan daerah yang termiskin sebagai latar belakang.
backer	kb. penanggung, penyokong. who's the financial b.? siapa penanggung keuangan?
backfield	kb. sport: daerah pemain belakang, mis.: dalam permainan sepakbola.
backfire	kb. ledakan yang terjadi sebelum waktunya. kki. 1 meledak karena (setelannya) por. 2 ketahuan sebelumnya.
background	kb. 1 latar belakang. 2 dibelakang-belakang. 3 dasar.
backhand	kb. tenn.: bekhen, pukulan dengan punggung tangan menuju kedepan.
backhanded	ks. berupa sindiran. b. compliment pujian yang serupa sindiran.
backing	kb sokongan, bantuan, dukungan.
backlash	kb. 1 tendangan, pukulan. 2 serangan balasan, reaksi yang tidak baik.
backless	ks. 1 tanpa punggung. b. chair kursi tanpa punggung sandaran. 2 punggung terbuka. b. dress baju dengan punggung terbuka.
backlog	kb. 1 jaminan simpanan. 2 timbunan sesuatu yang belum dikerjakan.
backrest	kb. penopang punggung, sandaran.
backroom	kb. kamar tersembunyi/dirahasiakan. b. politics politik yang tidak diketahui orang banyak.
backside	kb. inf.: pantat, sebelah belakang.
backslapper	kb. seorang peramah.
backslapping	kb. keramah-tamahan. sometimes we tend to overdo b., and it is misinterpreted kadang-kadang kami condong untuk beramah -tamah yang berlebih-lebihan dan orang salah mengerti.
backslide	kki. (backslid, backslidden) kembali mengerjakan kebiasaan lama yang tercela.
backspin	kb. tenn.: bekspin, putaran kebelakang sehingga bola berputar.
backstabber	kb. pemfitnah.
backstabbing	kb. kelicikan atau khianat yang bertujuan merusak. he engages in a lot of b. dia terlibat dalam banyak kelicikan yang bertujuan merusak.
backstage	kb. 1 dibelakang layar (panggung). 2 secara rahasia, gerakan dibelakang layar. b. manoeuvres gerakan dibelakang layar.
backstop	kb. penghalang, penahan, penyokong.
backstoped	-kkt. memberikan bantuan, menyokong.
backstretch	kb. daerah pembalapan yang letaknya sebelum garis finis.
backstroke	kb. gaya punggung.
backtrack	kki. mundur, menarik kembali. he had to b. his earlier statement dia harus mundur pada pernyataannya yang semula.
backward	ks. 1 terbelakang. 2 miskin. -kk. 1 kebelakang. 2 terbalik.
backwardness	kb. keterbelakangan.
backwash	kb. 1 air yang kembali karena tolakan dayung, roda kincir angin dsb. 2 gelombang surut (disebabkan oleh perputaran air). 3 akibat buruk.
backwater	kb. 1 air yang ditahan/dibendung. 2 terpencil dan terkebelakang. a b. town kota terpencil dan terkebelakang.
backwoods	kb., j. 1 daerah yang masih hutan, tempat yang terpencil, pedusunan jauh terpencil dari kota. 2 udik, kasar, dusun. his b. dress pakaiannya yang kampungan.
backwoodsman	kb. (j. -men) orang pedusunan/udik/kampung.
bacon	kb. sepek, daging babi yang diasin dan dikukus.
bacteria	kb. bakteri.
bacteriological	ks. bakteriologis. b. warefare perang kuman.
bacteriology	kb. bakteriologi.
bad	kb. inf.: in b. dalam kesukaran. -ks. 1 jahat. 2 buruk. 3 jelek. 4 susah. 5 tidak enak. 6 busuk.
bade	lih bid.
badge	kb. 1 lencana. 2 tanda pangkat.
badger	kb. 1 semacam tukang bakul/jagung. 2 semacam luak. -kkt. merengek-rengek, mendesak, mengganggu terus-menerus.
badly	badly
badminton	kb. bulu tangkis.
badness	kb. tingkah laku yang buruk, keburukan, kejahatan.
baffle	kkt. 1 mengherankan, menyusahkan, membingungkan. 2 mencengangkan.
baffling	ks. mengagumkan, mengherankan.
bag	kb. 1 kantong. karung, tas. 2 koper, kopor. 3 lingkaran. 4 karung. 5 perempuan.
bagatelle	kb. 1 soal yang sepele. 2 barang yang sepele.
bagful	kb. kantong penuh. two bagfuls of peanuts kacang kantong penuh.
baggage	kb.bagasi, kopor-kopor, barang. b. car kereta bagasi/barang. b. room ruang bagasi.
bagged	-kkt. menjerat, menangkap, membunuh. -kki. longgar.
baggy	ks. longgar (of clothes).
bah	kseru. cih, ah (pernyataan tidak sabar, menghina). b., i don't believe you! ah, saya tidak percaya padamu!.
bail	kb. uang tanggungan/menjamin, jaminan. to b. out 1 memberi jaminan. 2 menimba, menggayung. 3 sl.: mengeluarkan. 4 meloncat keluar.
bailer	kb. gayung, timba.
bailiff	kb. juru sita, pembantu kepala polisi/seksi.
bailiwick	kb. 1 daerah kekuasaan (pembantu kepala seksi). 2 lingkungan pengetahuan.
bait	kb. umpan. -kkt. 1 mengumpani. 2 menyerang. 3 menyiksa.
bake	kb. pesta atau pertemuan informil dimana diadakan makan. -kkt. membakar (a cake). -kki. matang.
baker	kb. tukang roti, tukang bikin kue. .
bakery	kb. (j. -ries) toko roti (dan kue).
baking powder	bubuk pengembang kue. baking soda tepung soda pengembang kue.
bakterial	ks. bakteris.
bakyard	kb. halaman belakang.
balance	kb. 1 keseimbangan. 2 tenang. 3 saldo. 4 akhir-akhir, sisa. 5 neraca. -kkt. 1 mencocokkan. 2 memperhitungkan. 3 mengimbangkan. -kki. 1 mengimbangkan badannya 2 teratur. 3 klop seimbang, cocok.
balanced	ks 1 tetap pendirian, stabil. 2 teratur. 3 kelop seimbang, cocok.
balcony	kb. (j. -nies) balkon.
bald	ks. botak, gundul. a b. spot bagian yang botak di kepalanya.
baldheaded	ks. botak, gundul.
balding	ks. mulai botak. he's b. ia mulai botak.
bale	kb. bal, bandel, bungkus. a b. of cotton sebal kapas. -kkt. mempak, membungkus. to b. hay mempak rumput kering.
balinese	kb. 1 orang bali. 2 bahasa bali. -ks. yang berhubungan dengan bali.
balk	kki. 1 menolak keras. he balked when he was asked to do that job ia menolak keras ketika diminta mengerjakan pekerjaan itu. 2 mogok.the horse balked at crossing the stream kuda itu mogok waktu menyebrangi sungai itu.
ball	kb. 1 bola. 2 pesta dansa. 3 jantung (of foot, hand).
ballad	kb. ballada.
ballast	kb. tolak bara, balas, pemberat.
ballet	kb. sendratari, balet.
ballistic	kb. ballistics j. ilmu balistik. -ks. balistik. b. missile roket, peluru yang digerakkan dengan roket.
balloon	kb. balon, pelembungan.
ballot	kb. (surat) suara, surat pemilihan, kartu pemumgutan suara. -kki. memilih.
balloting	kb. pemungutan suara.
ballpoint	kb. b. pen pena bolpoin, pen atom.
ballroom	kb. ruangan dansa.
ballyhoo	kb. sl.: 1 reklame yang menggemparkan. 2 kegemparan, kehebohan. -kkt. mengadakan reklame yang menghebohkan, menggembar-gemborkan.
balm	kb. (minyak) balsem.
balmy	ks. 1 sejuk-segar (of weather). 2 sl.: tolol, gila.
baloney	klb. 1 sl.: omong-kosong, ngawur belaka. 2 inf.: semacam sosis.
balpark	kb. stadion baseball.
balsa	kb. pohon kayu balsa.
balsam	kb. minyak balsem.
balusterade	kb. birai, langkan.
bamboo	kb. bambu. b. shoots rebung. b. curtain tirai bambu.
bamboozle	kkt. inf.: memperdayakan. he was bamboozled by the activities of the group ia terpedaya oleh kegiatan kelompok itu.
ban	kb. larangan.
banal	ks. dangkal, biasa. b. ideas pikiran-pikiran yang dangkal.
banality	kb. (j. -ties) kebanalan, hal yang dangkal/biasa.
banana	kb. pisang. b. oil cairan berbau pisang untuk membuat esensi-esensi.
band	kb. 1 ben, orkes. 2 pita. 3 gerombolan. 4 pembalut. 5 berkas, pita.to b. together berkumpul, bersatu. band-aid plester untuk luka ringan.
bandage	kb. pembalut, balutan, perban. -kkt. membalut, memperban, memalut (a wound).
bandied	lih bandy.
bandit	kb. bandit, penjahat, penyamun, penggarong.
banditry	kb. penggarongan, kebanditan, kejahatan.
bandmaster	kb. pemimpin (korps) musik.
bandstand	kb. pentas/panggung orkes.
bandwagon	kb. kereta musik, kereta yang membawa kumpulan musik.
bandy	ks. bengkok. b. legs kaki yang bengkok. b. -legged ks. berkaki-bengkok.
bane	kb. kutuk. he has been the b. of my existence ia telah menjadi kutuk dalam kehidupan saya.
bang	kb. 1 letusan, bunyi keras. 2 suara keras. 3. letupan. 4 sensani --kkt. 1 memukulkan. 2 membantingkan. -kki. 1 memukul. 2 tertutup. to b. up membenturkan. bang-up ks. tepat dan baik sekali.
banguet	kb. bangket, perjamuan, pesta makan.
banish	kki. membuang. to b. all o's fears membuang semua ketakutannya.
banishment	kb. pembuangan.
banister	kb. sandaran tangga, pegangan pada tangga.
banjo	kb. banjo.
bank	kb. fin.: bank. 2 tepi/pinggir sungai. 3 tumpukan, longgokan, onggokan. kkt. 1 menyimpan uang. 2 menumpuk. 3 membendung. 4 bertumpuk-tumpuk b. account simpanan di bank.
bankbook	kb. buku simpanan/deposito.
banker	kb. bankir, direktur bank.
banking	banking
banknote	kb. uang kertas.
bankroll	kb. uang yang tersedia pada seseorang.
bankrupt	kb. orang bangkrut. -ks. bangkrut, pailit. -kkt. membangkrutkan.
bankruptcy	(j. -cies) kb. kebangkrutan, kepailitan.
banned	-kkt. melarang.
banner	kb.bendera, spanduk, pataka. -ks. gilang-gemilang.
bantam	kb. semacam ayam. -ks.bantam.
bantamweight	kb. kelas bantam.
banter	kb. olok-olok, kelakar,sendagurau.to engage in b. with s.o. berolok-olok dengan seseorang. -kki. berkelakar, bersendagurau.
baptism	kb. pembaptisan, permandian.
baptismal	ks. mengenai pembaptisan. b. font bejana air, kulah/palung permandian.
baptist	kb. pembaptis. b church gereja pembaptis.
baptize	kkt. mempermandikan, membaptiskan.
bar	kb. 1 batang. 2 potong. 3 palang. 4 halangan, penghalang. 5 bar. 6 nav.: ambang sungai. 7 pekerjaan/golongan pengacara. 8 pengadilan. 9 kesatuan irama, balok. 10 tiang.-kd. kecuali.
barb	kb. fish: mata kail. 2 (harpoon) piarit. 3 bot.: kait, duri. 4 ejekan yang tajam.
barbarian	kb. orang yang biadab.
barbaric	ks. 1 biadab. that custom is b. kebiasaan itu biadab. 2 kejam sekali. the treatment of the prisoners was b. perlakuan itu terhadap tawanan kejam sekali.
barbarism	kb. kebiadaban, kekasaran.
barbarous	ks. biadab, kejam. assassination is a b. act pembunuhan secara diam-diam adalah tindakan yang biadab.
barbecue	kb. 1 tamasya dengan makan-makan daging/ikan panggang (sate). 2 anglo yang berapi kecil. -kkt. memanggang (daging).
barbed	ks. 1 berduri, berkait, beruit. 2 yang menusuk hati.
barber	kb. tukang cukur, barbir, pemangkas rambut. b. shop tempat/toko pemangkas rambut.
barberry	kb. (j. -ries) semacam murbey yang buahnya merah dan kecut.
barbiturate	kb. obat bius tidur.
bare	ks. gundul. 2 kosong. 3 nyata, terang. 4 yang paling sederhana. 5 tak bersepatu. 6 telanjang. -kkt. 1 membuka. 2 memperlihatkan.
bareback	kk. tidak berpelana. to ride b. menunggang kuda tidak berpelana.
barefaced	ks. yang tidak kenal malu. that's a b. lie ini bohong yang tidak mengenal malu.
barefisted	ks. 1 tanpa sarung tangan. b. fight tinju tanpa sarung tangan. 2 pantang mundur. b. determination keputusan yang pantang mundur.
barefoot(ed)	ks. kaki ayam, tak bersepatu dan tak berkaos, dengan kaki telanjang. he likes to go b. ia suka tak bersepatu dan tak berkaos.
barehanded	ks. 1 tidak bersarung tangan. 2 dengan kekuatan sendiri. 3 dengan tanpa tangan.
bareheaded	ks. tanpa tutup kepala. to walk b. in the snowstorm berjalan di badai salju itu tanpa tutup kepala.
barelegged	ks. tanpa kaos kaki panjang. to walk b. through the cold wind jalan tanpa kaos kaki panjang didalam angin yang dingin itu.
barely	kk. 1 baru saja. 2 hampir tidak. 3 sedikit saja.
bargain	kb. 1 persetujuan. 2 harga yang murah sekali. 3 setuju. -kki. 1 tawar- menawar. 2 bertawar-tawaran, berdagang.
bargaining	kb. 1 tawar-menawar. 2 perundingan.
barge	kb. kapal barkas, tongkang, perahu seret. -kki. to b. ahead maju terus.
baritone	kb. penyanyi bariton. -ks. bariton.
barium	kb. barium.
bark	kb. 1 salak, gonggongan (of the dog). 2 kulit kayu (of the tree). 3 rentetan tembakan. (of a rifle). 4 hati. -kki. membentak, menghardik.
barley	kb. gerst (semacam gandum dipakai untuk membuat bir).
barn	kb. gudang.
barnacle	kb. kepah, remis, tertitip, kijimg.
barnstorm	kki. inf.: pergi berkeliling mengadakan pidato-pidato kampanye. the presidential candidate barnstormed around the country calon presiden itu mengadakan pidato-pidato kampanye di seluruh negeri.
barnyard	kb. pekarangan/halaman gudang ternak.
barometer	kb. barometer. the b. is falling penunjuk barometer sedang turun.
barometric	ks. barometrik. b. presure tekanan barometrik.
baron	kb. baron. sugar b. raja gula.
barrage	kb. 1 tembakan yang ramai. 2 suatu serangan dengan kata-kata. the reporters tossed a b. of questions at the president wartawan-wartawan itu menyerang presiden dengan pertanyaan-pertanyaan.
barred	kkt 1 memalangi. 2 melarang 3 menghalangi, menghambat.
barrel	kb. 1 tong. 2 (gun) laras (bedil), lop. inf.: b. of fun penuh lelucon. -kkt. memasukkan kedalam tong. - kki. sl.: to b. along meluncur dengan cepat.
barrelhead	kb. tutup tong. sl.: cash on the b. tunai. he paid cash on the b. ia membayar tunai.
barren	ks. 1 tandus, gundul. the field looked b. ladang itu kelihatan tandus. 2 mandul. the animal was rendered b. binatang itu dibuat mandul.
barrenness	kb. 1 ketandusan (of a field). 2 kemandulan (of a woman).
barricade	kb. barikade, penghalang, penghambat. the boys hid behind a b. of rocks anak-anak laki-laki itu bersembunyi dibelakang barikade batu-batu. -kkt. menghalangi ( a roaf)
barrier	kb. 1 rintangan. 2 rr.: palang kereta api.
barring	kd. 1 terkecuali. 2 kalau tidak.
bartender	kb. penjualan minuman keras pada bar, petugas/pelayan bar.
barter	kb. dagang tukar-menukar, barter-kkt. menukarkan
bas-relief	kb. pahatan/ukiran/gambar timbul.
basal	ks. dari dasarnya, sbg dasar.
basalt	kb. basal.
base	kb. 1 kaki ( of monument, mountain ) 2 dasar.3 pangkalan.4 alas 5 sport: bidai.6 pokok.ks.1 pokok, pusat.2 dasar.3 jelek.4 hina, cendala.kkt. berdasarkan, mendasarkan.
baseball	kb. baseball,sm kasti.
baseless	baseless
baseline	kb. 1 garis dasar, basis 2 tenn: garis pangkalan.
basement	kb.ruangan di bawah tanah (dari sebuah gedung atau rumah )
baseness	kb. kerendahan budi, kehinaan.
bases	kb., j. lih basis.
bash	kb. 1 tamparan. 2 sl., pesta. -kkt. menampar.
bashful	ks. malu, seganl. he's a very b. boy ia pemalu betul
bashfulness	kb. sifat/perasaan malu, keseganan.
basic	ks. 1 dasar. 2 utama
basil	kb. kemangi, selasih, ruku-ruku.
basin	kb.1 baskom.2 kolam. 3 lembah sungai.
basis	kb. ( j. -ses ). dasar. what is the b. for your decision? keputusanmu kau ambil berdasarkan apa?.
bask	kki. 1 berjemur. to b. in the sun berjemur di panas matahari. 2 bersenang-senang.
basket	kb. 1 keranjang. a b. of of strawberries sekeranjang buah arbey 2 tempat barang (pada sepeda.)
basketball	kb. bola keranjang/basket.
basketlike	ks. berbentuk seperti keranjang. a b. object benda yang menyerupai keranjang.
basketry	kb. pembuatan penganyaman keranjang.
bass	kb. 1 penyanyi bass. b. drum genderang bas. 2 suara bas. b. voice suara bas.
bassinet	kb. buaian (berbentuk keranjang).
basso	kb. penyanyi dengan suara bas.
bassoon	kb. sejenis serunai dari pada kayu (bersuara rendah).
bastard	kb. haram zadah, anak diluar perkawinan yang sah. -ks. tidak asli. b. poetry puisi yang tidak asli.
bastardization	kb. pernyataan haram, penurunan nilai/derajat.
bastardize	kkt. menurunkan nilai/derajat kwalitas.
baste	kkt. 1 memerciki, menyirami. to b. a roast memerciki panggangan. 2 menjelujuri (adress). 3 sl. : memukul. i basted him one saya memukulnya.
bastion	kb. kubu baluarti, benteng (pertahanan)
bat	kb. 1 keluang, kele(le)war, kalong. 2 sport: pentungan, alat pemukul. -kkt. (batted) memukul (bola).
batch	kb. 1 setumpuk. 2 sekumpulan. 3 sejumlah. 4 seberapa.
bated	ks. tertahan. they waited with b. breath for the end of the story dengan menahan napas mereka menunggu akhir cerita itu.
bath	kb. 1 mandi. 2 kamar mandi.
bathe	kkt. 1 memandikan. 2 mandi, bermandikan. -bathing kb. mandi, senang.
bather	kb. perenang.
bathinette	kb. tempat mandi kecil bagi bayi.
bathing	lih bathe.
bathrobe	kb.mantel mandi.
bathroom	kb. 1 kamar mandi. 2 kamar kecil.
batik	kb. batik.
batiste	kb. kain batis.
baton	kb. tongkat kecil yang dipakai oleh panglima atau oleh pemimpin musik.
battalion	battalion
batten	kkt. to b.(down) mempersiapkan kapal untuk bayu. to b.(down) the hatches menutup palka rapat-rapat.
batter	kb. adonan. b for the cake adonan untuk kue. -kkt. memukul (berulang-ulang). a hurricane battered the city for six hours topan memukul kota itu selama enam jam.
battery	kb. (j. -ries) 1 aki. the car b. was dead aki mobil itu kosong/mati. 2 deretan. a b. of cameramen sederetan tukang pemotret.
battle	kb. peperangan. 2 perjuangan 3 pertempuran.-kkt.1 berjuang,melawan, bertempur.2 melawan.-kki. berjuang.
battlefield	kb. medan perang, pertempuran.
battleship	kb. kapal perang/ penempur.
bauxite	kb. boksit, bauksit.
bawdiness	kb. kemesuman.
bawdy	ks. mesum, carut.
bawdyhouse	kb. rumah sundal/ pelacuran.
bawl	kki. berteriak, menangis.inf. : to b. out membentak, menyentak-nyentak,menghardik, menggusari,mendamprat. bawling kb. teriakan, tangisan.
bay	kb. the b. of the hounds salak anjing-anjing pemburu. 2 teluk.b. window 1 jendela yg menganjur.2 sl.: perut yg menonjol keluar.
bayonet	kb. bayonet, (mata) sangkur.-kkt. menusuk dgn bayonet.
bazaar	kb. pasar. charity b. pasar amal/ derma
bb	bb gun= air rifle.
bbl	(barrel) tong.
be	kki. (ind. waktu ini). am (dipakai untuk orang pertama tunggal) ; are (dipakai untuk orang kedua dan jamak) ; is (dipakai untuk orang ketiga tunggal). was (dipakai untuk tunggal) ; were (dipakai untuk jamak) been (partisip waktu lampau).
beach	kb. pantai. -kkt. menarik kepantai. the sinking ship was beached kapal yang tenggelam itu ditarik ke pantai.
beachcomber	kb. 1 seorang kulit putih yang hidup melarat di pulau lautan teduh. 2 ombak besar.
beacon	kb. suar, menara api, rambu, lentera laut.
bead	kb. manik-manik. -beads j. tasbih. -beaded ks. bermanik-manik. b. dress baju yang bermanik-manik.
beady-eyed	ks. mata yang menyerupai manik-manik.
beak	kb. paruh.
beaker	kb. gelas kimia.
beam	kb. 1 balok, tiang. 2 sorotan. 3 lebar (kapal). 4 sinar. -kkt. mengarahkan (siaran). -kki. bercahaya, berseri-seri. -beamed ks. bertiang. -beaming ks. berseri-seri (face).
bean	kb. 1 buncis. sl.: full of beans a) bersemangat, segar. b) berkepala udang. inf.: hill of beans sepele. 2 sl.: kepala. -kkt. sl.: memukul. b. sprouts tauge.
beanpole	kb. 1 tiang buncis. 2 sl.: kurus kering. he's a real b. ia kurus kering sekali.
bear	kb. beruang.-kkt (bore, borne) 1 memikul 2 tahan, betah.3 menunjang.4 melahirkan.5 menanggung.6 menghasilkan 7 mengemban, memikul. 8 mengandung.9 memuat.-kki 1 membelok.2 menuju. to b. down berusaha keras.to b. down on 1 memusatkan diri pd, berusaha
bearable	ks. lumayan, dpt ditahan.
beard	kb. janggut, jenggot. -kkt. menghadapi.-bearded ks. berjanggut, berjenggot.
bearer	kb. pembawa (surat).
beast	kb.1 binatang (buas).2 jahanam, bangsat
beat	kb. rute/ronda 2 (drum) dentaman gendang. 3 gerakan irama/tempo.4 denyut(an), debar. -kkt.(beat-beaten) 1 memukul.2 mengalahkan.3 mengocok, mengaduk. inf,: mengacaukan.5 mengepakkan.6 inf,: melebihi.7 si,: pergi, nyah.
beater	kb1. pemukul.2 pengocok.
beatnik	kb. pemuda dan pemudi di as yg tingkah lakunya berlawanan dgn segala adat kebiasaan; di indonesia sering disamakan dgn crossboy dan crossgirl, sm hippy sekarang.
beau	kb. pesolek, pemberahi, rancak di labuah
beautician	kb. ahli kecantikkan.
beautification	kb. pengindahan.
beautiful	ks. indah, cantik, elok, bagus.-beautifully kk. dgn indah.
beautify	kkt. memperindah, memperelok, mempercantik.
beauty	kb. (j.-ties) 1 orang cantik 2 indah. 3 kecantikan.
beaver	kb. berang-berang.to work like a b. bekerja dgn rajin.
beaverboard	kb. kertas tebal dan keras, harbor.
became	lih become
because	ksam. karena, sebab.
beck	kb. isyarat dgn kepala atau tangan.
beckon	kkt. mengisyaratkan,memberi isyarat.-kki. memberi isyarat kpd.kkt. (became, become) cocok pantas.-kki menjadi.
bed	kb. tempat tidur.2 dasar.3 alas 4 kebun, taman.kkt. (bedded) to b. down memberi pondokan.b. and board penginapan dan makanan.b. covers/linen sepere, sarang bantal, dsb.-bedding kb. sepre, selimut, kain-kain tempat tidur.
bedbug	kb. kutu busuk, kepinding, tinggi, bangsat.
bedclothes	kb. j. sepere dan sarung bantal, kain-kain tempat tidur.
bedevil	kkt. menggoda, mengganggu, membuat bingung, menyusah-nyusahkan.
bedfellow	kb.kawan, teman.
bedlam	kb. hiruk-pikuk,ribut, gempar,gaduh.
bedouin	kb. orang badui.-ks. badui.
bedpan	kb. bejana,sorong.
bedragglade	ks. basah kuyup,berlumur.
bedridden	ks. terbaring di tempat tidur.
bedrock	kb. batuan dasar, lapisan tanah keras.
bedroll	kb. sulungan alas tidur,selimut dsb, yg dibawa berkemah.
bedroom	kb. kamar tidur.
bedside	kb.disisi tempat tidur.
bedsore	kb. luka baring.
bedspread	kb. penutup tempat tidur, ulas tempat tidur yg menutupi sepre.
bedspring	kb. per tempat tidur.
bedtime	kb. waktu tidur.
bedwetting	kb. ngompol,kencing di tempat tidur.
bee	1 tawon 2 saingan, perlombaan.to have a b. in o's bonnet 1 pikirannya tergoda 2 agak sinting. 3 hanya memikirkan satu hal satu saja.
beech	kb. sej. pohon.
beef	kb. (j. beeves) 1 daging sapi.2 sl,: keluhan.-kkt. sl,: meggerutu.sl, to b. up menaikkan, menambah.
beefsteak	kb. daging bistik.
beehive	kb. sarang lebah.
beeline	kb. jalan langsung.
been	lih. be.
beep	kb. tit (bunyi).
beer	kb. bir.
beeswax	kb. lilin tawon lebah.
beet	kb. bit. b. sugar gula bit.
beetle.	kb. kumbang.
beeves	lih. beef
bef.	(before) sebelum(nya).
befall	kkt. menimpa. (befell, befallen) saya harap tdk akan ada kemalangan yg menimpa sdr.
befallen	lih. befall.
befell	lih. befall.
befit	kkt. (befitted) cocok, pantas, serasi.-befitting ks.cocok, sesuai tepat. before kk. lebih dahulu.-kd. 1 sebelum, lebih dahulu, duluan. 2 dimuka, dihadapan,didepan.-ksm. 1 sebelum,2 daripada.
beforehand	kk. sebelumnya.you should have prepared it b.kamu seharusnya menyediakannya sebelumnya.
befriend	kkt. melindungi,berlaku spt sahabat, menolong.
befuddle	kkt. membingungkan.
beg	kkt.(begged) meminta.2 mengemis.3 ingin.to b. off menolak.to go begging tdk diindahkan orang.
began	lih begin.
begat	lih. beget.
beget	kkt. (begat, begotten) 1 memperanakkan (a child). 2 menurunkan (of fish, etc.).
beggar	kb. pengemis, orang minta-minta, kere.-kkt. to b. description tdk terlukiskan.
begin	kkt. (began, begun) memulai.-kki. (me) mulai.does not begin to tdk dpt. to b. on mulai mengerjakan to b. over (again) mulai dari permulaan.to b. with 1 mulai dgn.2 pertama-tama.-beginning kb. permulaan.
begotten	lih. beget.
begrudge	kkt. 1 iri akan/pada. 2 menyesalkan.i don't b. the money spent on his education saya tidak menyesalkan uang yg telah dikeluarkan utk pendidikannya.
beguil	kkt. memperdayakan.-beguiling ks. yg memperdayakan
behalf	kb. kepentingan. in b. of utk kepentingan. on b. of atas nama
behave	kki. 1 berkelakuan. 2 berjalan 3 menunjukkkan reaksi.
behavior	kb. 1 kelakuan. 2 tindak-tanduk. 3 jalan. on o's best b. bertingkah laku dengan sopan.
behavioral	ks. yang berhubungan dengan kelakuan atau perangi. b. science ilmu pengetahuan sosial (yang berhubungan dengan tingkah laku manusia, seperti sosiologi, antropologi, psikologi). the b. sciences ilmu-ilmu perilakuan.
behead	kkt. memenggal/memotong kepala.
beheld	lih behold.
behemoth	kb. 1 raksasa binatang. 2 raksasa.
behind	kb. inf.: pantat. -kk. ketinggalan. -kd. 1di-/ke-belakang. 2 terbelakang. b. the times ketinggalan zaman.
behold	kkt. (beheld) melihat. what a sight they beheld! alangkah bagusnya pemandangan yang mereka lihat! b.! lihatlah!.
beige	ks. sejenis warna antara abu-abu dan coklat.
belabor	kkt. 1 berulang-ulang menghantam. i see no reason to b. the point saya tidak melihat alasan untuk berulang-ulang menghantam soal itu. 2 memukul dengan keras. the owner belabored his dog pemilik itu memukul anjingnya dengan keras.
belated	ks. terlambat. the b. invitation arrived today undangan yang terlambat itu sampai hari ini.
belay	kkt. nav.: membatalkan (perintah), menghentikan. b. that! berhenti!
belch	kb. serdawa. -kkt. menyemburkan, mengeluarkan (smoke). -kki. beserdawa. he belched dia beserdawa.
beleagured	ks. terkepung. the b. forces tentara yang terkepung.
belfry	kb. (j. -ries) menara tempat lonceng bergantung.
belgian	kb. orang belgia. - ks. yang berkaitan dengan belgia. b . lace renda belgia.
belgium	kb. belgia.
belie	kkt. mengingkari, memungkiri. his action b. his principles tindakan-tindakannya mengingkari pendiriannya.
belief	kb. 1 kepercayaan, keyakinan. 2 kepercayaan, perasaan. beyoned b. tidak masuk akal, ajaib, mustahil. his strength is beyond b. kekuatannya sungguh-sungguh menakjubkan.
believe	kkt. percaya. i b. you saya percaya kepadamu. - kkt. percaya. to b. in percaya akan (ghosts). to make b. berbuat seolah-olah.
believer	kb. orang yang percaya, penganut, pengikut.
belittle	kkt. 1 menganggap kecil terhadap. she belittled her friend dia menganggap kecil terhadap temannya. 2 meremehkan. to b. s.o's efforts to... meremehkan usaha-usaha seseorang untuk ...
bell	kb. 1 lonceng, bel, genta. pushbutton b. lonceng/bel tombol. 2 giring-giring, bel (pada sepeda).
bellboy	kb. pelayan, pesuruh di hotel dsbnya yg pekerjaannya mengangkat dan menjadi pesuruh buat tamu.
belle	kb. 1 wanita/gadis cantik. 2 wanita yg tercantik dlm suatu rombongan.
bellicose	ks. suka berkelahi/berperang.
belligerent	kb.negara yg berperang.-ks. yg suka berkelahi. he's a b. boy dia seorang anak yg suka berkelahi.
bellow	kb. lenguh (of a bull)-kkt. meneriakkan.-kki. melenguh. the bull bellowed loud and long sapi itu melenguh keras dan lama.
bellows	kb., j. puputan, embusan, pengembus, ubub(an).
belly	kb. (j.-lies) perut.. b. dance tari perut. b. laugh ketawa terbahak-bahak.
bellyache	kb. inf,: sakit perut. -kki. inf,: berkeluh kesah (about ttg).
bellyfull	kb. inf,: muak, jemu. i've had a b. of your nagging aku sudah muak dgn ocehanmu
belong	kki. mestinya. tob. to 1 termasuk.2 kepunyaanmu.-belongings kb., j. harta milik, barang-barang,personal b. barang-barang pribadi.
beloved	kb. : orang yg dicintai, kekasih-ks. dicintai.
below	kk. di (ke) bawah. the captain went b. kapten pergi kebawah.
belt	kb. ikat pinggang.2 daerah 3 ban,lajur.-kki. si,: to b.s.t. out mengumandangkan.
bemoan	kkt. meratapi, merintihkan
bemused	ks. kagum,kaget 2 melongo, (me) ngelamun.
bench	kb. bangku. 2 law: hakim, mahkamah, pengadilan.
bend	kb. belokan, beliku, tikungan.-bends j. kejang urat disebabkan tekanan udara yg tiba-tiba.-kkt. (bent) 1 menekuk.2 menekukkan. 3 melipat.4 membekokkan, melenturkan.-kki. binglai, lunglai, melengkung, bungkuk.
beneath	kd. 1 dibawah. put it b. these papers taruhlah itu dibawah kertas-kertas ini. 2 tak pantas, hina. it's b. me to do that tak pantas bagi saya mengerjakan itu. b. it all sebenarnya, pada hakekatnya.
benediction	kb. doa, ucapan syukur.
benefactor	kb. dermawan.
beneficence	kb. kemurahan hati, derma.
beneficent	ks. bersifat dermawan. b. act tindakan yang bersifat dermawan.
beneficial	ks. bermanfaat. rest is b. istirahat adalah bermanfaat.
beneficiary	kb. (j. -ries) ahli waris, penerima warisan. the children were named beneficiaries in the will anak-anak itu disebut ahli waris dalam surat wasiat.
benefit	kb. 1 kebaikan, manfaat. 2 kepentingan. b. of the doubt pembebasan dari dakwaan. of b. berguna, berfaedah. -kkt. menguntungkan. -kki. beruntung.
benevolence	kb. kebajikan, perbuatan baik.
benevolent	ks. penuh kebaikan/kebajikan. b. act tindakan yang penuh kebaikan.
benign	ks. 1 ramah. b. countenance roman muka yang ramah. 2 lunak, tidak berbahaya. b. tumor penyakit tumor yang lunak (tidak berbahaya).
bent	kb. bakat. -ks. 1 peot, bengkok. 2 bungkuk. 3 cenderung. 4 bertekad. lih bend.
benumbed	ks. kebas (karena kedinginan).
benzoin	kb. kapur barus.
bequeath	kkt. mewariskan. she was bequeathed $10,000 by her father dia diwarisi ayahnya $10,000.
bequest	kb. warisan, pusaka.
berate	kkt. mencaci-maki.
bereave	kkt. (bereaved atau bereft) kehilangan. he was bereft of hope dia kehilangan harapan.
bereavement	kb. kehilangan. we offered our sympathy in their b. kami menyampaikan belasungkawa atas kehilangan yang mereka derita.
bereft	lih bereave.
beret	kb. (topi) baret.
beriberi	kb. beriberi.
bermuda	kb. bermuda. b. onion bawang bermuda. b. short sejenis celana pendek.
berry	kb. (j. -ries) raspberries and strawberries are berries buah prambus dan arbei termasuk jenis berry.
berserk	ks., kk. amuk. to go b. mengamuk marah sekali.
berth	kb. 1 tempat (ber) labuh/tambatan/merapat. 2 tempat tidur (di kapal, kereta api, dsb). 3 pekerjaan, jabatan. 4 tempat. to give a wide b. to 1 memberikan keluasan yang cukup. 2 mengelakkan. -kkt. mengepilkan, menambat(kan) (a ship). -kki. berlabuh.
beseech	kkt. (besought atau beseeched) memohon.
beset	kkt. (beset). 1 menimpa, menyerang. we were b. by troubles on all sides kami ditimpa oleh segala macam kemalangan. 2 mengelilingi, mengepung.
beside	kd. 1 disamping, disebelah. 2 dibandingkan dengan. to be b. o.s. 1 tidak tahan. 2 lupa akan diri karena marah.
besides	kk. lagi pula, tambahan. -kd. selain.
besiege	kkt. 1 mengepung. the city was besieged for three weeks kota itu dikepung tiga minggu lamanya. 2 menyerbu. we were besieged whit requests for autographs kami direbu dengan permintaan tanda tangan.
besmirch	kkt. menodai (s.o's character).
besought	lih beseech.
bespatter	kkt. mereciki.
bespeak	kkt. (bespoke, bespoken) 1 memesan lebih dahulu (a seat at the opera). 2 memperlihatkan. a neat house bespeaks care rumah yang rapi memperlihatkan pemeliharaan.
bespoke(n)	lih bespeak.
best	kb. 1 paling baik, terbaik. all for the b. berlangsung dengan baik, untuk maksud baik. -ks. 1 terbaik. 2 paling enak. -kk. lih. well. yang paling. -kkt. inf.: mengalahkan. -best selling ks. yang paling laku (novel).
bestial	ks. seperti binatang, kebinatangan. his nature is b. sifatnya seperti binatang.
bestiality	kb. (j. -ties) sifat kebinatangan.
bestir	kki. to b. a.s. berbuat sesuatu, bertindak. it's time we bestirred ourselves; the weather's getting worse sudah waktunya kita berbuat sesuatu.; cuaca bertambah buruk.
bestow	kkt. memberikan, melimpahkan. to bestow o's blessing on s.o. memberikan berkatnya pada seseorang.
bet	kb. taruhan. to b. on 1 bertaruh. 2 tak usah sangsi. -betting kb. bertaruh. b. is legal bertaruh diizinkan.
betake	kki. (betook, betaken) to b.o.s. pergi. to b. o.s. to church pergi ke gereja.
betel	kb. sirih. b. nut buah pinang.
betook	lih betake.
betray	kkt. 1 menghianati. 2 membuka(kan) (a secret). 3 memperlihatkan (o's ignorance) 4 menyingkapkan.
betrayal	kb. penghianatan.
betrayer	kb. penghianat.
betroth	kkt. menunangi.. to be betrothed bertunangan. - betrothed kb. tunangan.
betrothal	kb. pertunangan.
better	kb. lih good. 1 atasan. 2 tukang/jago bertaruh. -ks. lebih baik. b. than 1 lebih baik daripada. 2 lebih dari. -kk. 1 lebih sehat. 2 makin baik 3 lebih suka. -kkt. memperbaiki.
betterment	kb. perbaikan, kemajuan.
bettor	kb. tukang/jago bertaruh.
between	kk. diantaranya, didepannya. in b. 1 diantara. 2 sambil. -kd. (di)antara. i sat b. the two of them saya duduk diantara mereka berdua.
betwixt	kk. b. and between ditengah-tengah in the argument he was cought b. and between didalam perdebatan itu dia terjepit ditengah-tengah.
bevel	kb. 1 alat pengukur sudut. 2 siku-siku putar. -kkt. memiringkan. to b. off menyerong. -beveling kb. penyerongan.
beverage	kb. minuman
bevy	kb. (j. -vies) 1 rombongangn. b. of beautiful girls rombongan gadis-gadis cantik. 2 kawanan. a b. of birds sekawanan burung.
bewail	kkt. meratapi (s.o.'s death).
beware	kki. hati-hati. 2 berhati-hati. 3 hati-hati, awas.
bewhiskered	ks. berjanggut dan berkumis, bercambang.
bewilder	kkt. membingungkan. the many regulations bewildered the new employee peraturan yang banyak itu membingungkan pegawai ynag baru itu. -bewildered ks. binging, kagum. -bewildering ks. yang membingungkan.
bewilderment	kb. kebingungan, kekaguman.
bewitch	kkt. mempesonakan. her performance bewiched us permainannya mempesonakan kami. -bewitching ks. yang mempesonakan. she has a b. smile senyumanya mempesonakan.
beyond	kb. alam baka. -kd. 1 melebihi. 2 terlalu sulit. 3 melewati. 4 diluar.
bf	(old face) huruf tebal.
biannual	ks. dua kali setahun. the is a b. conferece konperensi ini diadakan dua kali setahun.
bias	kb. 1 prasangka, purbasangka. 2 miring. -kkt. membuat berat sebelah. -biased ks. berat sebelah, condong berprasangka.
bib	kb. oto, kain alas dada, kain liur, cukin (biasanya untuk bayi dan kanak). inf.: b. and tucker pakaian. he wore his best b. and tucker dia mengenakan pakaiannya yang terbagus.
bibl.	(bibliography) bibliografi.
bible	kb. 1 buku penuntun yang sangat ditaati. 2 b. alkitab, kitab injil.
biblical	ks. yang berhubungan dengan kitab injil.
bibliog	(biblioggraphy) bibliografi
bibliographer	kb. ahli bibliografi.
bibliographic(al)	ks. yang berhubungan dengan bibliografi.
bibliography	kb. (j. -phies) bibliografi.
bibliophile	kb. penggemar/pencinta buku, bibliofil.
bibulous	ks. 1 ketagihan minuman keras. 2 mabok.
bicameral	ks. yang terdiri daripada dua dewan.the u.s. congress is a b. body kongres amerika terdiri daripada dua dewan.
bicarbonate	kb. b. of soda bikarbonat soda.
bicentenary	kb. (j. -ries) 1 peringatan dari sesuatu yang terjadi 200 tahun yang lewat. 2 kurun masa 200 tahun.
bicentennial	kb., ks. dies natalis atau peringatan 200 tahun.
biceps	kb. otot lengan sebelah atas.
bichloride	kb. biklorida.
bicker	kki. bercekcok. the girls were bickering anaanak perempuan itu sedang bercekcok. -bickering kb. percekcokan.
bicuspid	kb. geraham muka, gigi seri.
bicycle	kb. sepeda, pit. -kki. bersepeda, naik sepeda. she bicycled down town ia bersepeda ke kota. b. stand tempat penjagaan sepeda.
bicyclist	kb. pengendara sepeda.
bid	kb. tawaran. -kkt. (bade, bid) minta, menawar. -kki. 1 menawar. 2 meminta. -bidding kb. 1 tawar-menawar. 2 perintah.
bidder	kb. penawar, pengkol.
bide	kkt. menunggu. we will have to b. our time kami harus menunggu kesempatan yang baik.
biennial	kb. s.s.t. yang terjadi sekali dua tahun.
bier	kb. usungan/tandu jenazah.
bifocals	kb., j. kacamata yang dapat dipakai untuk melihat jauh dan melihat dekat.
bifurcate	kkt. membagi dalam dua cabang. -kki. terbagi dalam dua cabang.
bifurcation	kb. pencabangan dua.
big	ks. (big, bigger, biggest) 1 besar. 2 besar, terkenal. 3 dewasa. -kk. inf.: dengan sombong. to talk b. omong/bercakap besar, menyombong, membual. sl.: b. wheel tokoh, orang penting.
bigamist	kb. orang yang beristeri dua.
bigamous	ks. yang beristeri dua.
bigamy	kb. (j. -mies) bigami, hal beristeri dua.
bigheaded	ks. berkepala besar, sombong.
bight	kb. 1 teluk. 2 gelung, jerat.
biginner	kb. orang yg baru mulai. he's a b. in indonesa. ia baru mulai belajar bahasa indonesia. beginner's luck semata-mata beruntung karena baru memulai s.s.t.
bigness	kb. 1 besarnya. 2 kemurahan. b. of heart is one of his qualities kemurahan hatinya adalah salah satu dari sifat-sifatnya.
bigot	kb. orang fanatik.
bigoted	ks. berkeras dalam pendirian. he is b. in his opinions dia berkeras memegang pendiriannya..
bigotry	kb. (j. -ries) kefanatikan, sikap keras dalam memegang pendirian.
bigwig	kb. inf.: tokoh, orang penting.
bike	inf.: = bicycle.
bikini	kb. sejenis pakaian mandi wanita yang terdiri daripada dua potong kain (hanya cukup untuk menutupi aurat dan buah dada).
bilabial	kb., ks. bilabial, dengan mempergunakan kedua bibir. b. sound suara bilabial.
bilateral	ks. dua belah pihak, timbal-balik, bilateral. b. treaty persetujuan bilateral.
bile	kb. (air) empedu. b. duct saluran air empedu.
bilge	kb. 1 lambung, bagian dasar daripada kapal. b. water air kotor yang tergenang di dasar kapal. 2 inf.: omong kosong.
bilingual	kb. seorang yang pandai dua bahasa. -ks. 1 pandai dua bahasa. 2 tertulis dalam dua bahasa.
bilingualism	kb. bilingualisme, dwibahasa.
bilious	ks. 1 yang berhubungan dengan atau bersifat empedu. 2 menderita karena atau disebabkan oleh gangguan pada empedu./hati.
bilk	kkt. menipu. he bilked the firm of $5,000 ia menipu perusahaan itu dengan $5,000.
bill	kb. 1 uang kertas. 2 rekening, bon, tagihan. 3 paruh (of a bird) 4 programa, acara, pelakat. 5 rancangan undang-undang. -kkt. 1 mengajukan/menarik rekening, menagih. 2 mengumumkan. -billing kb. 1 pengajuan rekening..
billboard	kb. 1 papan pengumuman, papan iklan. 2 pelakat besar.
billet	kb. tempat penginapan tentara.2 pekerjaan, jabatan.-kkt. memberi penginapan
billfold	kb. dompet (utk uang kertas).
billhead	kb. formulir rekening dgn nama, alamat dsb dari perusahaan dicetak di atasnya.
billiard	kb. bilyar.-billiards j. bilyar, bola sodok, sodok bola.
billion	kb. milyar, seribu juta (di as).-billions j. milyaran.
billionaire	kb. bilyuner, milyarder.
billionth	ks. yg kesemilyar.
billow	kb. ombak/gelombang besar.-kki. 1 mengombak.2 menggelembung.
billowy	ks. menggelembung, bergelombang-gelombang
billy	kb. (j-lies) tongkat polisi, pentung.inf.: b. goat bandot.
bimonthly	kb. (j-lies) majalah sekali dua bulanan. -ks. sekali dua bulan.
bimotored	ks. bermotor dua.
bin	kb. tempat menyimpan gandum atau arang.
binary	ks.1 biner, kembar.2 pasangan, sepasang.
binational	ks.yg mengenai dua negara.2 dwi kewarganegaraan.
binaural	ks.yg dipakai kedua telinga.b. reception penerimaan siaran melalui dua pengeras suara yg memberikan effek tiga dimensi.
bind	kb. inf.: to be in a b. terjepit.-kkt. (bound) 1 mengikat.2 membalut. 3 menjilid.to b. fast menambat.to b. hand and foot mengikat kaki dan tangan.to b. o. s. to 1 menyetujui.2 mengikat diri sendiri.-bound ks. 1 harus, berniat.2 terpaku.3 dijilid.
binder	kb. penjilid buku.2 map.3 bahan pengikat
bindery	kb. (j. ries) tempat penjilidan.
binge	kb.inf. : pesta minuman keras,pelesir minum.
bingo	kb. permainan bingo.
binnacle	kb. rumah kompas/pedoman.
binoculars	kb. , j. teropong.
binomial	ks. math.: binomial, suku dua. b. theorem teorem binomial.
biobibliography	kb. (j. -phies) bibliografi mengenai kehidupan dan hasil-hasil karya seorang pengarang.
biochemical	ks. yang berhubungan dengan biokimia.
biochemist	kb. ahli biokimia.
biochemistry	kb. biokimia.
biographer	kb. penulis biografi.
biographic(al)	ks. yang berhubungan dengan biografi, biografis. b. directory buku biografi.
biography	kb. (j. -phies) biografi, riwayat hidup.
biological	ks. biologis, yang berhubungan dengan ilmu hayat atau biologi.
biologist	kb. ahli biologi.
biology	kb. ilmu hayat, (ilmu) biologi.
biometry	kb. biometri.
biophsycs	ks. biofisika.
biopsy	kb. (j. -sies) biopsi.
biostatics	kb. biostatika.
bipartisan	ks. yang disokong oleh dua partai politik. b. foreign policy politik luar negeri yang disokong oleh dua partai.
bipartite	ks. mengenai dua orang, dua pihak, dua negara dsb. b. treaty perjanjian antara dua negara.
biped	kb. binatang yang berkaki dua.
biplane	kb. pesawat udara bersayap dua, sayap kembar.
bipolar	ks. mempunyai dua kutub, berkutup dua, bipoler, dwipolar, dwi-kutub.
bipolarity	kb. bipolaritas.
birch	kb. sejenis pohon.
bird	kb. 1 burung. 2 sport : bola bulu tangkis.
birdhouse	kb. sangkar burung.
birdie	kb. golf: biji dibawah par, birdie.
birdseed	kb.padi-padian untuk makan burung.
birth	kb. 1 kelahiran. 2 timbulnya. b. certificate akte kelahiran, surat lahir. b. control pembatasan kelahiran, perencanaan berkeluarga, keluarga berencana.
birthday	kb. hari ulang tahun, hari lahir. inf.: b. suit telanjang.
birthmark	kb. bercak bawaan, tahi lalat.
birthplace	kb. tempat lahir.
bis	kb. mus.: dua kali.
biscuit	kb. bisk(u)it.
bisect	kkt. membagi dua. to b. triangles membagi dua segitiga. -bisecting ks. yang membagi. b. line garis bagi.
bisection	kb. pembagian dua.
bisexual	kb. banci. -ks. biseksuil.
