caecum	kb. usus buta, bagian pertama dari usus besar.
caesarean	kb., ks. pembedahan perut untuk menolong melahirkan anak.
caesura	kb. penggalan (perhentian pada untai sajak).
cafe, cafe	kb. 1 restoran, rumah makan. 2 warung kopi.
cafetaria	kb. kafetaria, restoran dimana para pembeli melayani sendiri.
caffein(e)	kb. kafein. caffein-free tanpa kafein.
cage	kb. 1 kandang. 2 sangkar, kurung. -kkt. mengurung, memperkandang (an animal).
cagey	ks. inf.: cerdik, lihai, licik. -cagily kk. secara lihay.
cagily	lih cagey.
caginess	kb. kelihayan, kelicikan.
cahoot	kb. sl.: to be in cahoots with bekerjasama ( dengan rahasia), ikut sekongkol dengan. sl.: to go into caboots berkongsi.
cain	kb. keributan. sl.: to raise c. ribut tak keruan, marah sekali.
caisson	kb. 1 alat yang dipakai untuk turun kedalam air (berbentuk peti terbalik). 2 peti atau kereta tempat menyimpan bahan peledak.
cajole	kkt., kki. membujuk. he was cajoled into taking the post ia dibujuk supaya mau menerima jabatan itu.
cajolery	kb. (j, -ries) bujukan.
cake	kb. 1 kue.2 batang.3 balok. -kki. melekat, melengket.
calamine	kb. kalamina. c. lotion losion kalamina.
calamitous	ks. yg mendatangkan bencana, yg sangat membahayakan, yg merugikan
calamity	kb. (j. -ties) malapetaka, bencana, celaka besar.
calcification	kb. proses mengeras menjadi kapur.
calcify	kki. (calcified) mengeras karena kapur.
calcimine	kb. 1 bahan labur. 2 sm cat kapur. -kkt. melabur, mengapur (dinding,dsb).
calcium	kb. kalsium, zat kapur. c. oxide kapur hidup/tohor.
calculate	kkt. menghitung. -kki. memperhitungkan.-calculated ks. yg sdh diperhitungkan.-calculating ks. yg memperhitungkan semua.
calculation	kb. perhitungkan, kalkulasi.
calculator	kb. 1 mesin hitung.2 seorang yg menghitung, penghitung, tukang/juru kalkulasi.
calculus	kb. hitungan, kalkulus.
caldron	cauldron
calendar	kb. 1 kalendar, penanggalan, takwim. 2 (daftar) acara (di pengadilan, dlm kongres).c. day 24 jam c. month satu bulan.c. year jangka waktu 365 atau 366 hari, tahun takwim.
calendrical	ks. yg berh.dgn kalendar.
calf	kb. (j. calves). 1 anak sapi. 2 betis.
calfskin	kb. kulit anak sapi.
caliber	kb. 1 kaliber (bedil). 2 mutu.3 kecakapan, kemampuan, kaliber.
calibered	ks. berkaliber. small-calibered rifle bedil yg kalibernya/berkaliber kecil.
calibrate	kkt. menyesuaikan, mengkaliberkan.
calibration	kb. peneraan, pencocokan, pengujian, pertimbangan dgn ukuran dasar.
calico	kb. belacu, kain mori mentah.
calif	negara bagian as.
calipers	kb., jangka lengkung.
calisthenics	kb. gerak badan, gimnastik, (ber)senam.
calk	kkt. mendempul (windows).
call	kb. 1 panggilan. 2 kunjungan. 3 teriak. 4 bunyi, kicauan. -kkt. 1 memanggil. 2 menyebut. 3 mengadakan. 4 menilpon. 5 menamakan. 6 menganggap. 7 menghentikan. 8 kata. 9 membangunkan. 10 memutuskan. call-up kb. pengerahan. -calling kb. panggilan pekerjaan
caller	kb. tamu.
calligrapher	kb. seorang yang bagus sekali tulisannya.
calligraphy	kb. tulisan tangan yang sangat elok, tulisan indah.
calliope	kb. semacam orgel yang dijalankan oleh mesin uap.
callous	ks. yang tidak mempunyai perasaan.
callousness	kb. sifat tidak berperasaan, sifat berkulit tebal.
callow	ks. muda dan belum berpengalaman.
callus	kb. risa, belulang.
calm	kb. ketenangan, reda. -ks. tenang, reda. -kkt. 1 menenangkan. 2 bereda. -calmly kk. dengan tenang, nguler kambang.
calmness	kb. ketenangan, keredaan.
calomel	kb. semacam obat pencahar, urus-urus.
caloric	ks. yang berhubungan dengan kalori. c. content jumlah kadar kalori.
calorie, calory	kb. (j. -ries) kalori.
calumniate	kkt. memfitnah.
calumniation	kb. pemfitnahan.
calumny	kb. (j. -nies) fitnah.
calve	kkt. melahirkan anak sapi.
calves	lih calf.
calypso	kb., ks. kalipso. c. music musik kalipso
calyx	kb. daun pelindung/kelopak (pada bunga).
cam	kb. bubung(an), hubungan, sisir. c. whell roda sisir.
camaraderie	kb. persahabatan.
cambodia	kb. negeri kamboja.
cambodian	kb. 1 seorang kamboja. 2 bahasa kamboja. -ks yang berhubungan dengan kamboja. c. literature kesusasteraan kamboja.
cambric	kb. kain katun halus (sekali).
came	lih come.
camel	kb. 1 unta. 2 ship.: tengki/drum berisi udara untuk mengangkat kapal yang tenggelam. camel's hair bulu unta, kamhar. c.-hair coat jas dari bulu unta.
camellia	kb. bunga kamelia.
cameo	kb. batu berharga yang diasah sehingga timbul dan latar belakangnya biasanya berwarna lain.
camera	kb. alat potret, kamera, foto tustel. camera prohibited dilarang memotret.
cameraman	kb. (j. -men). juru potret/kamera.
camouflage	kb. penyamaran, pengabuan mata. c. clothing pakaian macan loreng. -kkt. menyamarkan, mengkamuflir.
campus	kb. kampus, perkampungan pada perguruan tinggi.
camshaft	kb. poros/batang dengan sisir dalam silinder mesin, poros nok.
can	kb. 1 kaleng. 2 sl.: penjara. 3 sl.: kakus, kamar kecil. -kkt. (canned) 1 mengawetkan didalam kaleng. 2 sl.: memecat. 3 sl.: menghentikan. -kkb. (could) 1 dapat, bisa. 2 pandai. 3 boleh. 4 berhak. -canning kb. pengawetan, pengalengan.
can't	(cannot) tidak dapat. lih can.
canada	kb. kanada.
canadian	kb. she's a c. ia seorang wanita bangsa kanada. -ks. yang berhubungan dengan kanada c. bacon daging panggang babi yang dikukus-kering.
canal	kb. terusan, kanal. suez c. terusan suez. c. zone daerah terusan.
canalization	kb. 1 penyaluran, penerusan. 2 pembuatan terusan-terusan, kanalisasi.
canalize	kkt. 1 mengalirkan, menyalurkan. 2 menggali terusan.
canape	kb. makanan kecil yang menyertai minuman-minuman.
canard	kb. desas-desus, omong kosong, kabar angin, berita yang dibikin-bikin. kabar yang dibesar-besarkan.
canary	kb. (j. -ries) burung kenari. c. islands kepulauan canary.
canasta	kb. semacam permainan kartu remi merangkaikan sedikitnya tujuh kartu.
cancan	kb. tari kankan.
cancel	kkt. 1 membatalkan (an agreement, subscription). 2 mencap. 3 menghapuskan. to c. both parts of a fraction menghapuskan dua bagian pecahan.
cancellation	kb. 1 pembatalan. c. of an appointment pembatalan janji. 2 pencapan. c. of stamps must be done at the post office mencap pembatalan perangko harus dikerjakan di kantor pos.
cancer	kb. 1 (penyakit) kanker. 2 zod.: c. (rasi) sartan, karkata.
cancerous	ks. yang bersifat penyakit kangker. he suffers from a c. condition ia menderita penyakit yang bersifat kangker.
candelabrum	kb. (j. -labra). tempat lilin yang bercabang, kandil.
candid	ks. 1 terus terang, jujur, tulus ikhlas. he gave a c. reply to the questions ia menjawab pertanyaan itu dengan terus terang. 2 bebas, tak sadar.
candidacy	kb. (j. -cies) pencalonan.
candidate	kb. calon. c. president calon untuk presiden
candied	lih candy.
candle	kb. lilin. c. power kekuatan lilin. -kkt. to c. eggs menguji telur dengan meneropong ke arah cahaya .
candleholder	kb. tempat lilin.
candlelight	kb. cahaya lilin. by c. dibawah cahaya lilin.
candlenut	kb. buah kemiri.
candlestick	kb. kandil.
candor	kb. keterusterangan. he spoke with c. ia berbicara terus terang.
candy	kb. (j. -dies) gula-gula, manisan. -kkt. memberi gula pada, memaniskan, membuat manisan pada.. -candied ks. diberi gula. c. apples manisan apel.
cane	kb. 1 (stick) tongkat. 2 rotan. cane(-bottomed) chair kursi (yang beralaskan) rotan. 3 memukul dengan tongkat. c. field kebun tebu. -caning kb. 1 (of a chair) merotan. 2 (of a child) memukul dengan tongkat.
canful	kb. sekaleng penuh. a c. of peas sekaleng penuh ercis.
canine	ks. anjing. c. trait ciri anjing. c. tooth gigi taring.
canister	canister
canker	kb. 1 penyakit sariawan. c. sore bintil-bintil di mulut, sariawan. 2 kebusukan.
cannel	kb. c. coal batu arang yang membara dengan jernih.
cannery	kb. (j. -ries) pabrik pengalengan.
cannibal	kb. orang yang makan daging manusia.
cannibalism	kb. kebiasaan makan dagimg manusia.
cannibalize	kkt. mencopot (onderdil mobil dsb.)
cannon	kb. meriam. c. ball peluru bundar untuk meriam. c. fodder serdadu umpan meriam.
cannot	tidak dapat. lih can.
canny	ks. cerdik, licik, lihai. c. businessman saudagar yang cerdik.
canoe	kb. kano. -kki. bersampan.
canoeist	kb. pengayuh sampan/kano.
canon	kb. 1 peraturan-peraturan/dalih-dalih agama. 2 norma, ukuran.
canonical	ks. resmi, menurut undang-undang gereja. c. writings tulisan-tulisan dalam buku resmi (misalnya qur'an, injil).
canonize	kkt. menjadikan (s.s.o. orang) suci dalam gereja.
canopy	canopy
cant	kb. 1 bahasa yang khas untuk suatu golongan. the c. of beggars bahasa pengemis -kkt. memiringkan. the strong wind canted the boat to starboard angin keras itu memiringkan kapal itu ke arah sebelah kanan.
cantaloupe	kb. belewa(r), semacam semangka.
cantankerous	ks. bantahan, suka membantah.
cantata	kb. nyanyian untuk paduan suara.
canteen	kb. 1 pelples. 2 kantin.
canter	kb. lari ligas. the horse went at a c. kuda itu meligas saja. -kki. meligas.
cantilever	kb. 1 tembok yang menganjur keluar penahan balkon. 2 penopang, penyangga. c. bridge jembatan yang dibangun dengan bantuan dua buah penopang, yang tidak saling menyangga.
canto	kb. bagian dari suatu syair.
canton	kb. wilayah, daerah bagian.
cantor	kb. pemimpin nyanyi, penyanyi (di gereja jahudi).
canvas	kb. 1 kampas, kain mota/terpal. 2 kain kampas. 3 lantai (yang berkampas).under c. 1 dibawah kemah. 2 dengan layar terkembang. -kkt mengampas.
canvass	kb. pemeriksaan dengan teliti. -kkt. 1 meneliti. 2 mengadakan penyelidikan -kki. meminta uang.
canvasser	kb. seorang yang meminta suara, langganan kepada majalah, uang dsb. untuk organisasi-organisasi kesejahteraan dsb.
canyon	kb. jurang, ngarai, tebing.
cap	kb. 1 sumbat (botol). 2 acad.: topi. 3 tutup (untuk pulpen). -kkt. (capped) 1 menutupi. 2 terdapat diatas. 3 membalut, memberi tutup. 4 mengakhiri
cap'n	(captain) kb. 1 kapten. 2 nakhoda.
cap.	cap.
capability	kb. (j. -ties) 1 kesanggupan, kemampuan. 2 kemampuan, kecakapan.
capable	ks. 1 cakap, mampu. 2 sanggup. -capably kk. dengan cakap.
capacity	kb. (j. -ties) 1 kapasitas. 2 cakap. 3 daya muat/tampung, kapasitas. 4 daya tahan. 5 kekuatan. -ks. yang besar jumlahnya.
cape	1 mantel tanpa lengan. 2 tanjung
caper	kb. melonjak-lonjak, meloncat-loncat, - capers j. sebangsa semak-semak (tumbuhan kecil dan rendah)
capful	sebanyak isi peci/topi
capillary	kb (j. -ries) pipa/pembuluh rambut, -ks. kapiler. c. action tindak kapiler.
capital	kb. 1 ibu kota. 2 modal, kapital. 3 huruf besar. -ks. 1 besar. 2 dengan ancaman hukum mati. 3 baik sekali.
capitalism	kb. kapitalisme.
capitalist	kb. kapitalis.
capitalistic	ks. kapitalistis.
capitalize	kkt. menulis dengan huruf besar. proper names are capitalized nama diri ditulis dengan huruf besar.
capitation	kb. pajak perseorangan yang sama buat tiap orang.
capitol	kb. gedung dewan perwakilan rakyat negarabagian.
capitulate	kki. menyerah, berkapitulasi.
capitulation	kb. 1 penyerahan, kapitulasi. 2 uraian ringkas, garis besar.
capon	kb. ayam kebiri.
caprice	kb. perubahan pikiran dengan tiba-tiba (tanpa sebab-sebab yang nyata).
capricious	ks. tak terduga-duga, berubah-ubah.
capriciousness	kb. ketidakteraturan.
capricorn	kb. makara (nama gugusan bintang).
caps.	1 (capital letter) huruf besar. 2 (capitalize) menulis dengan huruf besar.
capsize	kkt., kkt. terbalik. the ship capsized in heavy seas kapal itu terbalik kena ombak besar di laut.
capstan	kb. putaran/paksi jangkar.
capstone	kb. puncak. the c. of a career puncak karir.
capsule	kb. kapsul. is the medicine in c. form? apakah obat itu berupa kapsul? -ks. singkat, ringkas.
capt.	(captain) 1 kapten. 2 nakhoda.
captain	kb. 1 kapten. 2 pemimipin, kapten. 3(ship's) nakhoda. 4 tokoh, pemimpin
captaincy	kb. (j. -ties) tingkatan/pangkat kapten.
caption	kb. 1 judul halaman, bab, dsb. 2 tulisan dibawah karikatur, gambar, dsb.
captious	ks. yang suka cari gara-gara, bawel, cerewet.
captivate	kkt. memikat/menawan/menarik hati -captivating ks. menawan/memikat hati.
captivation	kb. pemikatan/penawanan hati, pesona.
captivator	kb. penawan/pemikat/penarik hati.
captive	kb. tawanan, tahanan. -ks. c. audience segolongan pendengar yang mau tak mau harus mendengarkan atau menonton.
captivity	kb. (j. -ties) tahanan, tawanan kurungan. in c. dalam tahanan
captor	kb. penawan, penahan, orang yang menahan.
capture	kb. penangkapan. -kkt. 1 merebut. ( a town, the market, first prize) . 2 menangkap (a criminal, animal).
car	kb. 1 mobil. c. wash a) cuci mobil. b) tempat cuci mobil. 2 kereta, gerbong, wahon. freight c. gerbong barang. pullman c. wahon yang bertempat tidur. c, park pelataran parkir.
caramel	kb. karamel, gula bakar.
carat	kb. karat. 18 c. gold emas 18 karat.
caravan	kb. kafilah.
caraway	kb. jintan, jemuju. c. seed biji jemuju/jintan.
carbide	kb. karbit.
carbine	kb. karabin, karaben.
carbohydrate	kb. hidrat-arang, karbohidrat.
carbolic	kb. c. acid (asam) karbol.
carbon	kb. 1 karbon, zat arang. c. black hitam arang/hangus. 2 karbon. c. copy karbon, tembusan, salinan. c. paper kertas karbon. c. monoxide karbon monoksida.
carbonate	kkt. mencampur dengan soda. carbonated water air soda.
carbonic	kb. c. acid asam arang/karbonat.
carbonization	kb. karbonisasi.
carbuncle	kb. 1 inas, radang dibawah kulit, bisul. 2 sejenis batu delima yang berwarna merah jingga.
carburetor	kb. karburator.
carcass	kb. 1 bangkai. 2 kerangka sesuatu yang sudah mati.
carcinogen	kb. segala sesuatu yang menyebabkan kangker.
card	kb. 1 kartu. 2 acara, rencana. 3 kartu nama. 4 inf.: seorang yang lucu benar. -kkt. 1 menyisir (wood). 2 mencatat. card-carrying ks. tercatat, resmi.
card.	(cardinal) kardinal.
cardamom	kb. kardamunggu, kapulaga.
cardboard	kb. kardus, kertas karton. -ks. palsu, sok, bikinan. c. champion jagoan palsu.
cardholder	kb. pemegang kartu.
cardiac	kb. penderita penyakit jantung. -ks. yang berhubungan dengan jantung. c. arrest perhentian jantung. c. disease penyakit jantung. c. symptoms gejala-gejala jantung.
cardinal	kb. 1 rel.: kardinal, pejabat tinggi gereja. 2 burung kardinal. -ks. 1 merah cerah (of a color). 2 utama, pokok. c. number bilangan pokok. c. point (of compass) ibu mata angin.
cardiogram	kb. kardiogram.
cardiograph	kb. kardiograf.
cardiologist	kb. ahli jantung.
cardiology	kb. kardiologi, ilmu penyakit jantung.
cardiovascular	ks. yang mengenai jantung dan urat-urat darah.
cardplayer	kb. pemain kartu.
cardsharp	kb. pemain kartu yang suka menipu.
care	kb. 1 perawatan. 2 perhatian, ketelitian. 3 asuhan, perlindungan, pemeliharaan. 4 kesusahan. -kki. 1 mau, suka. 2 peduli. 3 urusan. 4 ada perhatian. to c. for 1 memelihara. 2 mengurus. 3 mau. 4 suka.
careen	kki. miring, teleng. the car careened to oneside and flipped over mobil itu miring ke sebelah dan terbalik.
career	kb. karir, riwayat kerja. -ks. tetap. c. foreign service officer diplomat pegawai tetap. c. woman wanita yang bekerja.
carefree	ks. riang, tiada yang dipikirkan sama sekali.
careful	ks. (ber-)hati-hati. -carefully kk. 1 dengan hati-hati. 2 dengan teliti.
careless	ks. sembrono, sembarangan, serampangan. -carelessly kk. dengan sembrono, tanpa tanggung jawab.
carelessness	kb. kesembronoan, pengabaian.
caress	kb. usapan, pelukan, cumbuan, elusan. -kkt. memeluk sambil membelai. she caressed her doughter warmly ia memeluk dan membelai anak perempuannya dengan mesra.
caret	kb. tanda sisipan (^)
caretaker	kb. 1 pengurus, penjaga. 2 pengemban. c. cabinet kabinet sementara.
carfare	kb. ongkos bis/trem.
carful	kb. sepenuhnya mobil, semobil penuh. a c. of children anak-anak semobil penuh.
cargo	kb. muatan. c. ship kapal barang. c. space ruang muat(an). c. handling muat-bongkar barang.
carhop	kb. pelayan di restoran drive-in.
caribbean	ks. karibia. c. sea laut karibia.
caribou	kb. karibu.
caricature	kb. karikatur. -kkt. membuat sindiran dengan karikatur.
caries	kb. kebusukan pada tulang atau gigi, mati tulang.
carillon	kb. menara lonceng
carload	kb. segerobak. a c. of potatoes kentang segerobak.
carmine	ks. merah tua/padam.
carnage	kb. pembunuhan, penyembelihan besar-besaran. c. in battle pembunuhan pada pertempuran.
carnal	ks. yang bersifat jasmani, jasmaniah, badaniah. to have c. knowledge melakukan persetubuhan, bersetubuh.
carnation	kb. anyelir.
carnival	kb. karnaval, kirab, pesta, pasar malam dengan hiburan-hiburan.
carnivorous	ks. yang makan daging. dog are c. anjing adalah hewan yang makan daging.
carol	kb. nyanyian/lagu gembira.
carom	kb. j. caroms semacam permainan karambol. -kki. mental, terpelanting. the ball caromed back to his glove bola itu mental kembali dan ditangkap di tangannya.
carouse	kki. minum sampai mabuk, berpesta minum-minum. all those at the party caroused all night long di pesta itu semunya mabok-mabokan semalam suntuk.
carousel	kb. korsel.
carp	kb. semacam ikan gurame. -kki. mengomel, mencari kesalahan. to c. about s. t. mengomel tentang apa saja. -carping kb. cela-mencela. c. criticism pembahasan yang mencemoohkan.
carpenter	kb. tukang kayu. carpenter's level sipat datar, alat penimbang datar. carpenter's square siku-siku.
carpentry	kb. pekerjaan kayu.
carpet	kb. babut, permadani, ambal, hamparan. c. weeper alat penyapu ambal. -kkt. memasang babut. -carpeting kb. 1 bahan-bahan untuk permadani. 2 permadani.
carpetbagger	kb. petualang/oportunis politik.
carport	kb. atap tambahan untuk perlindungan mobil.
carpus	kb. pangkal tangan, tulang pergelangan tangan
carriage	kb. 1 kereta yang ditarik oleh kuda. 2 sikap-diri, pembawaan (badan).
carried	lih carry.
carrier	kb. 1 alat pengangkut, perusahaan pengangkutan. 2 penyebar, pembawa. carrier-based ks. yang berpangkalan di kapal induk.
carries	lih carry.
carrion	kb. 1 daging bangkai. 2 sampah kotoran.
carrot	kb. bortel, wortel. 2 penarik, pemikat.
carry	kkt. (carried) 1 mengangkat. 2 membawa. 3 mempunyai. 4 memenangkan. 5 menggotong, mengangkat. 6 menerima, meloloskan. 7 mempengaruhi. 8 memikul. 9 menjual. 10 memuat. - kki. terdengar.
cart	kb. kereta. 2 gerobak, kereta. -kkt. 1 mengangkut dengan kereta. 2 mengangkat dengan kereta.
carte blanche	kb. kekuasaan penuh, blanko mandat. we have given him c. in thi matter kami sudah berikan kepadanya kekuasaan penuh dalam hal ini.
cartel	kb. suatu gabungan perusahaan-perusahaan yang bertujuan monopoli teristimewa dalam mengatur harga-harga.
cartilage	kb. tulang rawan/muda.
cartload	kb. segerobak penuh.
cartographer	kb. pembuat peta.
cartography	kb. perpetaan.
carton	kb. 1 slof, bos. a c. of cigarettes satu slof rokok. 2 kotak kardus, dos, karton.
cartoon	kb. gambar lucu, (gambar) kartun.
cartoonist	kb. seniman (gambar) kartun.
cartridge	kb. pelor, peluru. 2 isi pulpen.
carve	kkt. 1 mengukir, memahat. 2 memotong-memotong. 3 menuliskan, menggoreskan. -carving kb. ukiran. c. knife pisau daging.
carver	kb. pengukir, pemahat. 2 pisau daging.
cascade	kb. air terjun kecil, riam, jeram. a c. flowers bunga-bunga yang berjatuhan (seperti air terjun). -kki. mengalir/berpancaran kebawah. the water cascade over the cliff air terjun melewati batu-batu.
case	kb. 1 kotak, peti. 2 tempat, tas. 3 panggilan. 4 penyakit. 5 perkara. 6 keadaan, hal yang sebenarnya. 7 kasus. 8 orang sakit, orang yang terluka. 9 pengaduan (of the government). 10 alasan. -casing kb. selubung. 2 lis, pinggiran, bingkai, pian.
casebook	kb. 1 buku berisi keputusan-keputusan perkara pengadilan. 2 perkumpulan dari catatan-catatan mengenai hal-hal yang sebenarnya dalam sebuah lapangan.
casein	kb. kasein.
casement	kb. jendela yang dibuka dengan mendorong keluar.
caseworker	kb. karyawan/karyawati untuk kesejahteraan sosial.
cash	kb. 1 uang. 2 kontan, tunai. -kkt. menguangkan (a chek). cash-and-carry ks. bayar kontan dan barangnya segera diangkat, membeli kontan. c. sale penjualan dengan pembayaran tunai. c. advence uang panjar.
cashbox	kb. peti uang.
cashew	kb. (biji) jambu monyet. c. nut biji jambu monyet, kacang mende.
cashier	kb. kasir, pemegang kas. -kkt. memecat.
casino	kb. kasino, tempat berjudi/penjudian, ruangan/kamar judi.
cask	kb. tong (kecil)
casket	kb. peti mayat/mati/jenazah.
cassava	kb. singkong, ubi/ketela kayu.
casserole	kb. 1 tempat makanan yang ada tutupnya untuk memasak atau menyajikan makanan. 2 makanan biasanya merupakan sebuah adukan dimasak didalam kuah di tempat semacam itu.
cassette	kb. kaset.
cassock	kb. baju jubah.
cassowary	kb. (j. -ries) burung kasuari.
cast	kb. 1 pembalut (dari) gigi. 2 thea.: para pelaku. 3 cetakan. 4 warna tambahan, semu. -kkt. (cast) 1 melemparkan (a stone, line). 2 membuat. 3 memberikan, memasukkan. -casting kb. 1 thea.: pemilihan pemain-pemain. 2 tuangan.
castanet	kb. kastenyet.
castaway	kb. 1 orang yang kapalnya karam. 2 orang paria, orang buangan masyarakat.
caster	kb. 1 lereng-lereng (pada sofa, kursi, tempat tidur dsb.). 2 pengail. 3 botol kecil (untuk merica, garam dsb.)
castigate	kkt. menghukum (a pupil)
castle	kb. 1 benteng, kastil. 2 istana.
castor	kb. 1 c. oil kastroli, minyak jarak. 2 = caster.
castrarion	kb. pengebirian.
castrate	kkt. mengebiri.
casual	kb. 1 secara kebetulan. 2 sambil lalu. 3 begitu saja, sepintas lalu. 4 lepas. 5 tidak tetap. 6 sederhana. -casualy kk. 1 begitu saja. 2 secara iseng-iseng, sambil lalu.
casuality	kb. hubungan sebab dan akibat.
casualness	kb. secara tidak formil, secara tidak dibuat-buat. the c. of his approach made me feel at home caranya mendekati saya secara tidak formil itu membuat saya merasa seperti di rumah sendiri.
casualty	kb. (j. -ties) korban (kecelakaan).
cat	kb. kucing. cat's paw kaki kucing. c. nap tertidur sebentar-sebentar.
cataclysm	kb. bencana alam.
cataclysmic	ks. bersifat perubahan besar. recent developments have been c. for that country kejadian-kejadian baru-baru itu merupakan perubahan besar untuk negeri itu.
catafalque	kb. podium/panggung untuk peti mayat.
catalepsy	kb. katalepsia, semacam ayan.
catalog	= catalogue.
cataloger	kb. pendaftar buku-buku.
catalogue	kb. 1 katalogus. 2 pendaftaran buku-buku atau barang-barang dagangan. -kkt. 1 membuat daftar nama-nama buku. 2 mendaftarkan.
catalyst	kb. katalisator.
catapult	kb. katapel, jepretan. -kkt. melontarkan, menjepretkan, mempelantingkan.
cataract	kb. air terjun yang terjal sekali. 2 bular (of the eye).
catarrh	kb. radang selaput lendir di hidung dan tenggorokan yang disertai keluarnya lendir.
catastrophe	kb. malapetaka, bencana alam.
catastrophic	ks. yang merupakan bencana besar.
catcall	kb. ejekan, teriakan-teriakan menandakan kejengkelan.
catch	kb. pegangan, jepitan, kaitan, gesper. 2 tangkapan. 3 inf.: calon suami idaman. 4 tersedan-sedan. 5 inf.: udang di balik batu, maksud tersembunyi. -ks. menarik, muluk-muluk. -kkt. (caught) 1 menangkap. 2 naik, mengejar. 3 ketularan. 4 menyangkut.
catchall	kb. tempat untuk segala macam barang.
catcher	kb. penangkap bola.
catchup	= catsup.
catchword	kb. kata semboyan/slogan. " the great society" is an example of a c. "the great society adalah suatu contoh kata slogan.
catchy	ks. 1 mudah diingat, menarik. c. tune lagu yang mudah diingat. 2 memperdayakan, menipu.
catechism	kb. katekismus.
catecornered	ks. berseberangan sudut. my house is situated c. from his rumahku terletak berseberangan sudut dari rumahnya.
categorical	ks. pasti, positif. c. statement pernyataan yang pasti. -categorically kk. dengan mentah-mentah, dengan pasti.
categorize	kkt. 1 mengganggap. 2 menggolongkan, membagi, mengkategorikan.
category	kb. (j. -ries) kategori, kelompok, golongan.
cater	kki. 1 memenuhi. 2 melayani. 3 menyediakan makanan. -catering kb. melayani pesanan untuk pesta-pesta dsb., melever makanan.
caterer	kb. pemborong, leveransir makanan untuk pesta-pesta dsb.
caterpillar	kb. ulat (bulu). c. tractor traktor berban-gigi, traktor yang bannya bergigi.
catfish	kb. semacam ikan (berkumis seperti kucing)
catfood	kb. makanan untuk kucing.
catgut	kb. tali/senar dibuat dari usus kambing atau hewan lainnya dijemur dan dipintal untuk biola, raket dsb.
catharsis	kb. perasaan terharu disebabkan oleh sandiwara tragedi dsb.
cathartic	kb. pencuci perut, obat pencahar, urus-urus.
cathedral	kb. katedral.
catheter	kb. med.: pipa dipakai untuk dimasukkan kedalam lubang tubuh (mis: jalan air kencing dari kandung kencing).
cathode	kb. c. ray sinar katoda.
catholic	catholic
catholicism	kb. paham/kayakinan/doktrin katholik.
catnip	kb. semacam tanaman yang mengandung permen sangat disukai kucing.
catsup	kb. 1 saus/sos tomat. 2 = ketchup.
cattiness	kb. sifat suka membenci.
cattle	kb. ternak, lembu, sapi. c. breeding peternakan sapi, lembu dsb. c. car gerobak lembu. c. crossing penyeberangan ternak. c. grazing mengangon ternak, pengangon.
cattleman	kb. (j. -men). peternak.
catty	ks. tajam (mulut, perkataan), berisi kebencian. she can be very c. if she wants to kalau mau ia mulutnya bisa tajam. c. remark ucapan berisi kebencian.
catty-cornered	= catercornered.
catwalk	kb. jalan sempit di jembatan, tangki, mesin dsb.
caucasian	ks. yang berhubungan dengan bangsa "kulit putih". he is c. by race ia bangsa kulit putih. ia berbangsa eropah.
caucus	kb. rapat anggota-anggota partai politik. -kki. mengadakan rapat. the striking group caucused this morning para pemogok tadi pagi mengadakan rapat.
caught	lih catch.
cauldron	kb. ketel, cerek, ceret, kawah, kancah.
cauliflower	kb. blumkol, kol kembang.
caulk	= calk.
causal	ks. sebab musabab, bersifat sebab- menyebab. what is the c. relationship between these two events? apakah hubungan sebab musabab antara dua kejadian ini?
causation	kb. yang menyebabkan, yang mendatangkan akibat.
causative	ks. kausatif. -kan is a c. suffix -kan adalah akhiran kausatif.
cause	kb. 1 sebab, penyebab. 2 alasan. 3 maksud. 4 perkara. -kkt. menyebabkan.
causeway	kb. jalan lintasan yang ditinggikan melewati rawa-rawa dsb.
caustic	kb. bahan tajam yang dapat membakar kulit. -ks. 1 pedas, tajam. 2 tajam, yang membakar kulit.
cauterize	kkt. membakar (a wound).
caution	kb. 1 perhatian, berhati-hati. 2 peringatan. -kkt. memperingati.
cautious	ks. berhati-hati. be very c. hati-hatilah.
cav., cav.	cav., cav.
cavalcade	kb. arak-arakan, iring-iringan, pawai. c. of stars iring-iringan bintang (film, dsb.).
cavalier	ks. sombong, congkak, angkuh. i don't like his c. manner saya tak suka sifatnya yang sombong.
cavalry	kb. (j. -ries) kavaleri, pasukan/barisan kuda.
cavalryman	kb.(j. -men). anggota kaveleri.
cave	kb. gua. _kki. to c. in runtuh, ambruk, longsor. the house caved in rumah itu ambruk. cave-in kb. runtuh, ambruk, longsor (of a tunnel).
caveat	kb. surat protes/keberatan. to enter a c. against mengajukan surat keberatan thd.
cavern	kb. gua besar, lobang besar didalam tanah.
cavernous	ks. 1 besar. 2 dalam (dan tinggi). 3 cekung. he had c. eyes matanya sangat cekung. c. mountain area daerah pegunungan yang penuh goa.
caviar	kb. kaviar, telur ikan.
cavil	kki. bertengkar tentang hal-hak yang kecil. she tends to c. about insignificant matters ia suka sekali bertengkar tentang hal yang kecil-kecil.
cavity	kb. (j. -ties) 1 lubang (in a tooth). 2 rongga, ruang. abdominal c. rongga perut.
cavort	kki. melompat-lompat. the childrent c. about the yard anak-anak melompat-lompat di halaman.
caw	kb. gaok. -kki. menggaok.
cayenne	kb. c. pepper lada merah, cabai rawit.
cbs	(columbia broadcasting system) organisasi siaran columbia.
cc	1 (cubic centimeter) sentimeter kubik. 2 (centimeters) sentimeter-sentimeter. 3 (chapters) bab-bab.
ceaceless	ks. terus-menerus, tanpa berhenti. c. efforts usaha-usaha yang terus-menerus. -ceaselessly kk. dengan tak henti-hentinya, tanpa henti-hentinya, dengan terus-menerus. the rain poured c. hujan turun dengan tak henti-hentinya.
cease	kkt. berhenti. the rain beating on the roof gemeretak hujan di atap berhenti. -ceasing kb. perhentian. cease-fire kb. gencatan senjata .
cedar	kb. pohon cedar. c. chest lemari dari kayu cedar.
cede	kkt. menyerahkan, memberikan. the area was ceded to ... daerah itu diserahkan kepada....
ceeb	(college entrance examination board) dewan pemilihan/ujian masuk sekolah tinggi.
ceiling	kb. 1 langit-langit. 2 batas (ter)tinggi. 3 plafon, gaji yang tertinggi.
celebrate	kkt. 1 merayakan (a birthday). 2 menyelenggarakan (mass). -celebrated ks. ternama, terkenal, kenamaan. a c. author seorang pengarang yang ternama.
celebration	kb. perayaan. c. of mass penyelenggara misa.
celebrity	kb. (j. -ties) seorang yang terkenal/masyhur.
celery	kb. seladri, seledri.
celestial	ks. yang berhubungan dengan angkasa/sorga. c. body benda angkasa. c navigation navigasi angkasa.
celibacy	kb. (j. -cies ) (pem)bujangan.
celibate	kb. bujang, tidak kawin.
cell	kb. 1 sell dalam penjara/biara. 2 sel, lubang kecil. c. of a honeycomb sel sarang tawon. 3 sel (tumbuh-tumbuhan). plant cells are often microscopic sel tumbuh-tumbuhan seringkali sangat kecil.
cellar	kb. gudang dibawah tanah. 2 inf.: tempat terakhir. this baseball is in the c. regu baseball ini menduduki tempat terakhir.
cellist	kb. pemain celo.
cello	kb. selo.
cellophane	kb. kertas kaca.
cellular	ks. yang berhubungan dengan sel, terdiri dari sel. c. structure bangunan yang terdiri dari sel.
celluloid	kb. seluloida.
cellulose	kb. selulosa.
cels.	(celsius) celsius.
celsius	kb. c. scale skala celsius.
cement	kb. 1 semen. c. mixer mesin pencampur semen. 2 plombir (tooth). -kkt. 1 menyemen (a wal). 3 mempererat (a friendship).
cemetery	kb. (j. -ries) 1 kuburan, makam. 2 kerkop (for westerners).
cenotaph	kb. tugu/tanda untuk memperingati orang yang dikubur di lain tempat.
censer	kb. pedupaan, anglo dupa.
censor	kb. sensor. -kkt. memeriksa, menyensor.
censorship	kb. sensor, penyensoran. postal c. sensor pos.
censure	kb. celaan, kecaman. he was exposed to strong c. for his action ia dikecam habis-habisan karena tindakannya itu. -kkt. mencela, mengecam. to c. severely for o's public behavior mencela dengan keras sekali karena tindakan di muka umum.
census	kb. sensus, cacah jiwa. c. taker pencacah.
cent	kb. sen. ten cents sepuluh sen. i haven't a c. sesenpun tak ada pada saya.
cent.	1 (century) abad. 2 (center) pusat. 3 (centimeter) sentimeter.
centenarian	kb. seorang yang umurnya seratus tahun atau lebih.
centenary	kb. (j. -ries) abad, seratus tahun, ulang tahun keseratus.
centennial	kb. ulang tahun ke-100. cornell celebrated its c. in 1965 universitas cornell merayakan hari ulang tahunnya yang keseratus dalam tahun 1965.
center	kb. 1 pusat. 2 bagian tengah. 3 (soccer) penyerang tengah. -kkt. menempatkan di tengah-tengah. to c. around 1 mengerumuni, mengelilingi. 2 mengisahkan tentang, berkisar sekitar.
centerpiece	kb. perhiasan di tengah-tengah (meja).
centigrade	kb. bagian perseratus. c. thermometer termometer berskala 100 derajat.
centigram	kb. sentigram.
centimeter	kb. senti (meter).
centipede	kb. lipan, halipan, kalalipan poisonous c. kelabang, lipan berbisa
central	kb. pegawai kantor telpon, pusat, penghubung (telpon pusat). -ks. yang berhubungan dengan pusat. 2 tengah. 3 pokok. -centrally kk. di tengah-tengah, di pusat.
centralization	kb. sentralisasi, pemusatan.
centralize	kkt. menyentralisasikan, memusatkan.
centre	= center.
centrifugal	ks. sentrifugal. c. force gaya sentrifugal/melanting (dari pusat).
centrifuge	kb. pemusing, mesin pusingan, mesin pemisah dengan putaran.
centripetal	ks. sentripetal. c. force gaya sentri petal.
century	kb. (j. -ries) abad. the 20th c. abad ke-20.
cephalic	ks. berhubungan dengan kepala, tengkorak, batok kepala. c. index indeks batok kepala.
ceramic	ks. dari tanah. c. tile genteng tanah.
ceramics	kb. 1 keramik, barang-barang tembikar. 2 kerajinan keramik.
cereal	kb. 1 tanaman sejenis rumput yang menghasilkan biji-bijian untuk dimakan. 2 biji-bijian, padi-padian (yang dapat dimakan). corn is a c. jagung adalah termasuk biji-bijian.
cerebellum	kb. (j. -lums atau -la) otak kecil sebelah belakang, yang menguasai koordinasi otot-otot.
cerebral	ks. yang berhubungan dengan otak.c. hemorrhage pendarahah otak. c. palsy lumpuh karena otak yang luka.
cerebration	kb. cara berfikir, fikiran.
cerebrum	kb. otak besar.
ceremonial	ks. berhubungan dengan upacara. c. outfit pakaian upacara.
ceremonious	ks.penuh dengan upacara. c. occasion perayaan penuh dengan upacara.
ceremony	kb. (j. -nies) 1 upacara. 2 formalitas, cara tata tertib. to stand on c. formil-formilan, berpegang teguh pada tatacara, resmi-resmian.
certain	ks. 1 pasti, (ter)tentu. 2 beberapa. 3 khusus. 4 yang dapat dipercaya. -certainly kk. 1 pasti, tentu (saja). 2 memang.
certainty	certainty
certifiable	ks. dapat dipertanggungkan kebenarannya. c. results hasil-hasil yang dapat dipertanggungkan kebenarannya.
certificate	kb akte, sertipikat, surat (keterangan). birth c. akte kelahiran. 2 surat (keterangan). 3 diploma, ijazah.
certification	kb. diploma, keterangan. a school teacher requires c. seorang guru perlu mempunyai keterangan kecakapan. duplicate of his lost c. salinan diplomanya yang hilang.
certifies	lih certify.
certify	kkt. (certified) 1 menandai. 2 menerangkan dengan sebenarnya. -kki. 1 menjamin. 2 menyatakan. -certified ks. 1 berijazah. 2 yang ditanggung dijamin/disahkan.
certitude	kb. ketentuan, kepastian.
cervical	ks. yg berh. dgn tengkuk/kuduk.c. vertebra tulang tengkuk.
cervix	kb. tenguk, kuduk. c. of the uterus leher rahim.
cesarean	=caesarean.
cessation	kb. penghentian,, gencatan. c. of hostilities gencatan permusuhan.
cession	kb. penyerahan . c. of teritory penyerahan daerah.
cesspool	kb. tengki septik, perigi, jamban, tandas, camplungan.
ceylon	kb. sri langka, sailan.
ceylonese	kb. orang sailan. -ks. yg berh. dgn sailan.
cf (compare)	bandingkan. cf. jones, p 62. bdgk jones,hal. 62.
cg (centigram)	sentigram.
ch. (chapher)	bab.
ch. e.	(chemical engineer) insinyur kimia.
chafe	kkt. 1 melukai. 2 menggosok spy panas. 3 memarahkan. -kki. kesal, jengkel, dongkol. chafing dish sm kompor yg dipakai di atas meja makanan, joan(g)lo.
chaff	kb. sekam, dedak. -kki. mencemoohkan, memperolok-olokan, menyindir.
chagrin	kb. perasaan menyesal/terhina/kecewa.-kkt. to be chagrined sedih, menyesal.
chain	kb. rantai.2 rangkain, rentetan.-kkt.1 merantai (an animal).2 mengikat.
chair	kb. kursi.2 jabatan3 ketua. 4 kursi listrik.-kkt. mengetuai (a meeting).
chairman	kb. (j.-men). ketua, pemimpin rapat.-kkt. (chairmanned) mengetuai.
chairmanship	kb. kedudukan ketua.
chairwomen	kb. (j.-women) ketua (wanita).
chalet	kb. villa kecil di pegunungan.
chalice	kb. piala yang dipakai dalam misa suci.
chalk	kb. kapur. c. line benang kapur untuk membuat garis lurus dengan kapur. 2 kapur tulis. -kkt. to c. up 1 beruntung, mujur, bahagia. 2 mencatat.
chalky	ks. 1 berisi kapur. 2 pucat, pasi. his face was c. mukanya pucat.
challenge	kb. 1 tantangan. 2 teguran. 3 penolakan, keberatan. -kkt. 1 menantang. 2 menegur. 3 meragukan. -challenging ks. menarik, menantang. he has a c. job. pekerjaannya sangat menarik.
challenger	kb. penantang.
chamber	kb. 1 kamar, bilik. 2 ruang. 3 dewan. 4 majelis. c. music musik untuk main di ruangan kecil (trio, kwartet).
chamberlain	kb. 1 pengurus rumah tangga raja dsb. 2 bendahara(wan). city c. bendaharawan kota.
chambermaid	kb. babu kamar/dalam, pelayan.
chameleon	kb. bunglon.
chamois	kb. 1 semacam kidang yang kulitnya halus. 2 simlir.
champ	kb. sl.: juara. -kki. 1 menggerut. 2 mengertak gigi.
champagne	kb. sampanye.
champion	kb. juara. c. boxer juara tinju. -kkt. memperjuangkan. to c. socialist goals memperjuangkan tujuan-tujuan sosial.
chance	kb. kesempatan. -kkt. mencoba. -kki. untung-untungan. c. meeting perjumpaan yang tak disangka-sangka.
chancel	kb. mimbar.
chancellery	kb. (j. -ries) kedutaan, tempat kanselir.
chancellor	kb. 1 ketua perwakilan atau kedutaan. he's c. of austria ia perwakilan austria. 2 ketua penanggung jawab, rektor. he's c. of the university ia ketua penanggung jawab universitas.
chancery	kb. (j. -ries) 1 arsip umum. 2 + chancellery. court of c. pengadilan berdasar keadilan.
chancy	ks. inf.: untung-untungan. going out in bad weather like this is c. bepergian dalam cuaca seburuk ini adalah untung-untungan.
chandelier	kb. kandelar, kandil, tempat lilin.
change	kb. 1 perubahan. 2 pergantian, ganti. 3 uang kembali. -kkt. 1 merubah. 2 menukarkan. 3 bertukar, menukar. 4 (ber)ganti. 5 mengalih. -kki. 1 menukar pakaian. 2 ganti. 3 berubah. c. of name penggantian nama.
changeable	ks. bertukar-tukar., berubah-ubah, angin-anginan. the weather in ithaca is c. cuaca di ithaca suka bertukar-tukar.
changeover	kb. perubahan. there has been a complete c. in goverment sudah ada perubahan besar didalam pemerintahan.
changer	kb. record c. gramophon.
channel	kb. 1 terusan. deep c. terusan yang dalam. 2 saluran. c. of communication (alat) saluran komunikasi.
chant	kb. nyanyian (yang gampang dan pendek), lagu gereja. -kkt. menyanyi (a psalm). -kki. menyanyi.
chaos	kb. kekacau-balauan, kalang-kabut.
chaotic	ks. kacau-balau, semrawut. c. situation suasana kacau-balau.
chap	kb. inf.: anak, bujang, orang laki-laki. -kkt. (capped) merekah. chap-stick kb. batangan salep yang keras untuk bibir yang merekah-rekah.
chapel	kb. kapel.
chaperon(e)	kb. wanita pengantar/peneman gadis, pengawal. she was a c. at the party ia dijadikan pengantar pada pesta itu. -kkt. mengantar. he chaperoned the group on its outing ia mengantar rombongan itu waktu tamasya.
chaplain	kb. pendeta/kiyai untuk golongan istimewa, seperti sekolah, tentara dsb. army c. imam/pendeta tentara. prison c. pendeta penjara.
chapter	kb. 1 bab. c. of a book bab di buku. 2 cabang. c. of a fraternity cabang perhimpunan mahsiswa. 3 babak. a new c. in the history of shipping babak baru dalam sejarah perkapalan.
char	kkt. (charred) 1 membuat arang, mengarangkan. 2 membakar hangus, gosong. the meat was charred daging itu terbakar hangus.
character	kb. 1 watak, karakter, sifat. 2 peran. 3 huruf.
characteristic	kb. sifat (yang khas). -ks. khas. that's c. of her itu memang khas dia.
characterization	kb. pemeranan, pelukisan watak. his c. of lincoln was superb pemeranannya sebagai presiden lincoln sangat mengagumkan.
characterize	kkt. 1 menggolongkan. i would c. him, as a strict father saya akan golongkan dia sebagai seorang ayah yang keras. 2 memberi ciri kepada.
charade	kb. permainan menebak kata atau ucapan dengan menggambarkan bagian kata atau ucapan.
charcoal	kb. arang (kayu). c. drawing lukisan/gambar arang.
chard	kb. semacam lobak/bit, swiss c. bit swis.
charge	kb. 1 ongkos, harga. 2 tuntutan, tuduhan. 3 perintah, instruksi, komando. 4 pimpinan, urusan, penguasaan.5 serangan, serbuan. 6 utang. 7 beban. 8 tanggung jawab. 9 isi.
charge d'affaires	kb. kuasa usaha.
chargeable	ks. dapat dimasukkan/dibebankan. i suppose this is c. to my account saya kira ini dapat dimasukkan ke rekening saya.
chariot	kb. kereta pertempuran.
charisma	kb. karisma
charismatic	ks. berkarisma. a c. leader pemimpin berkarisma.
charitable	ks. 1 murah hati. he's a c. person ia seorang yang suka menderma. 2 berhati lembut, bersifat toleransi. he is very c. towards his friend's weaknesses ia amat toleran terhadap kelemahan-kelemahan temannya.
charity	kb. (j. -ties) 1 amal, derma. 2 kemurahan hati.
charlatan	kb. tukang obat, (dukun) klenik.
charley	kb. c. horse kaku kejang pada kaki/lengan.
charm	kb. daya tarik, pesona, keluwesan. 2 anting-anting. 3 guna-guna, jimat. -kkt. mempesonakan. -charmed ks. bahagia, menyenangkan, senang. -charming ks. sangat menarik, mempesonakan, luwes.
charmer	kb. pemikat/penarik hati, perayu.
chart	kb. 1 peta. 2 grafik. -kkt. 1 membuat peta, memetakan. 2 membuat rencana, merencanakan.
charter	kb. 1 piagam. 2 carter. -kkt. 1 mencarter, menyewa (a plane). 2 mengizinkan dengan piagam resmi (a bank).
chartreuse	ks. 1 hijau muda kekuning-kuningan. 2 minuman keras.
charwoman	kb. (j. -women). pekerja wanita yang membersihkan kantor, rumah dan gedung-gedung, juru sapu, wanita pembersih kantor.
chary	ks. 1 berhati-hati. 2 tidak mudah memberikan.
chase	kb. pengejaran, penguberan, pemburuan. -kkt. mengejar, menguber, memburu. -kki. 1 sibuk, mengejar. 2 mengusir. 3 menghalau pergi, mengusir, menolak. 4 mengejar.
chaser	kb. 1 pemburu, pengejar. 2 (drink) inf.: minuman (air) sesudah minuman keras.
chasm	chasm
chassis	kb. casis.
chaste	ks. suci, murni, belum berdosa. a c. girl seorang perawan yang masih suci.
chasten	kkt. menghukum, berhati-hati. he was chastened by his experience ia bertambah berhati-hati karena pengalamannya.
chasteness	kb. kemurnian, kesucian.
chastise	kkt. menghukum (untuk kebaikan). the judge chastised him for his conduct hakim itu menghukum dia karena perbuatannya.
chastisement	kb. hukuman, penyucian.
chastity	kb. 1 kesucian, kemurnian, kebersihan. 2 kesederhanaan. c. of style kesederhanaan gaya.
chat	kb. obrolan. to get together a c. bertemu untuk ngobrol. -kki. (chatted) mengobrol, bercakap-cakap.
chateaubriand	kb. daging punggung sapi yang dianggap terbaik.
chattel	kb. barang bergerak.
chatter	kb. obrolan, ocehan. -kki. 1 mengobrol, mengomong. 2 menggigil, gemeretak, gemeletup. the cold makes my teeth c. hawa dingin menggigilkan gigi saya.
chatterbox	kb. pembual, pengoceh, tukang ngobrol.
chatty	ks. 1 suka mengobrol, suka bercakap-cakap dengan ramah tamah. 2 tidak formil.
chauffeur	kb. sopir, pengendara mobil. -kkt. mencicit, menciap (of birds, chicks). she likes to be chauffeured about ia suka sekali dibawa jalan-jalan naik mobil.
chauvinism	kb. sovinisme, sifat patriotik yang berlebih-lebihan.
chauvinistic	ks. bersifat patriotic yang berlebih-lebihan.
cheap	ks. 1 murah. dress baju murah. 2 rendah, malu. i feel c. after that experience saya merasa rendah sesudah pengalaman itu.
cheapen	kkt. merendahkan. -kki. menjadi lebih murah, turun harganya. canned foods have cheapened lately makanan dalam kaleng turun harganya akhir-akhir ini.
cheapness	kb. 1 kemurahan. the c. of life kemurahan hidup. 2 kerendahan (harga). the c. of rice murahnya beras.
cheapskate	kb. sl.: orang kikir.
cheat	kb. penipu. -kkt. menipu. -kki. 1 menyontek, menjiplak. 2 main curang. -cheating kb. menyontek, menjiplak.
cheater	kb. penyontek, penjiplak, penipu.
check	kb. 1 cek. 2 tanda penerimaan karcis. 3 tanda (pemeriksaan). 4 perbandingan, pedoman. 5 pengawas, pencegah. -kkt. 1 mengirimkan. 2 menitipkan, menyimpan. 3 memeriksa. 4mengurangi. -kki. cocok. -checking account rekening koran.
checkbook	kb. buku cek.
checker	kb. 1 pengawas, pemeriksa, pengontrol. 2 kasir (pada supermarket). 3 buah (main) dam. -checkers j. dam. -kkt. bergambar dengan tanda-tanda petak-petak yang bermacam-macam warnanya. -checkered ks. berganti-ganti, tidak tetap,berubah-ubah.
checkerboard	kb. papan main dam.
checkmate	kb. 1 sekakmat. 2 sekak, menyerah tanpa syarat, bertekuk lutut. -kkt. membuat sekakmat.
checkout	kb. pemeriksaan, percobaan. the new car underwent a final c. mobil baru itu menjalani pemeriksaan terakhir.
checkpoint	kb. pos/tempat pemeriksaan.
checkroom	kb. tempat penyimpanan mantel, topi dsb.
checkup	kb. pemeriksaan.
cheek	kb. pipi. c. by jowl berdampingan, berdekat-dekatan. to turn the other c. memberikan pipi yang lain.
cheekbone	kb. tulang pipi, pasu-pasu.
cheeky	ks. bermuka tebal/papan.
cheep	kb. ciap-ciap (anak ayam, burung). -kki. mencicit, menciap of birds, chicks).
cheer	kb. sorak(-sorai). -kkt. let's c. the team on mari kita bersorak untuk regu itu. -kki. bersorak. to c. up 1 menghibur, menggembirakan. 2 bergembira. -cheering kb. sorak-sorai. ks. yang bersorak.
cheerful	ks. 1 riang, gembira. she has a. c. disposition. ia bersifat periang. 2 menyenangkan, menggembirakan. this is such a c. room. kamar ini menyenangkan sekali
cheerfulness	kb. kegembiraan, kebahagiaan, keriangan.
cheeriness	kb. kegembiraan
cheerless	ks. sedih, tanpa kegembiraan, suram. a c. room. kamar tanpa kegembiraan
cheery	ks. (pe)riang. c. disposition. tabiat yang periang
cheese	kb. keju
cheeseburger	daging cincang dengan sepotong keju
cheesecake	kb. 1 kue dibuat dari keju, telor dsb., roti keju. 2 sl.: gambar yang menunjukkan keindahan tubuh wanita.
cheesecloth	kb. kain katun tipis
cheesy	ks. sl.: buruk, kurang baik buatannya. this suit looks c. baju setelan ini kelihatan buruk buatannya.
chef	kb. juru masak (kepala, koki.)
chemical	kb. bahan kimia. --ks. kimia(wi). c. formula rumus kimia. c. engineer insinyur kimia. c. enginering teknik kimia. c. warfare perang kimia.
chemise	kb. kemeja dalam untuk wanita.
chemist	kb. ahli kimia.
chemistry	kb. (j. -ries) ilmu kimia.
chenille	kb. sm katifah, permadani, kain korden.
cherish	kkt. menghargai. i c. this ring saya menghargai benar cincin ini. to c. the hope that ... berharapan, mengharap-harapkan, bhw..., menginginkan bhw...
cheroot	kb. cerutu.
cherry	kb. (j. ries). 1 buah ceri. to can cherries mengawetkan buah ceri. c. brandy brendi dibuat dari buah ceri. c. pie pai berisi buah ceri. c. red merah jambu/ceri. c. stone biji buah ceri. 2 kayu ceri. a chest of solid c. peti dari kayu ceri yang tebal.
cherub	kb. (j. -bim atau -bs). kerubi(a)n.
chess	kb. catur.
chessboard	kb. papan catur.
chessman	kb. (j. -men), buah catur.
chest	kb. 1 dada. to be hit hit in the c. kena pada dada.inf.: to get s.t. off o's c. melegakan hati. imust get this problem off my c. saya harus meringankan diri dari persoalan ini. 2 peti. tool c. peti untuk alat-alat. 3 lemari. c. of drawers lemari berlaci.
chestnut	kb. kastanye, berangan. to pull s.o.s chestnuts out of the fire bersusah-payah atau berkorban untuk membantu orang lain melepaskan diri dari kesulitan. inf.: that's an old c. itu lelucon basi. itu cerita usang.
chesty	ks. sl.: sombong, besar kepala.
chevron	kb. tanda pangkat ketentaraan.
chew	kb. kunyahan. -kkt. 1 mengunyah. 2 memamah. -kki. 1 mengunyah. 2 mengunyah tembakau sugi. -chewing kb. pengunyahan.
chewy	ks. kenyal. c. candy gula-gula yang kenyal.
chic	ks. elok, cantik, (bergaya) jelita.
chicanery	kb. (j. -ries) penipuan, ketidakjujuran.
chick	kb. 1 anak ayam. 2 sl.: gadis manis. she's a cute c. ia gadis/cewek yang manis. c! c! (to call chickens) kur! kur!
chicken	kb. 1 ayam. 2 sl.: pengecut. chicken-breasted ks. berdada burung/busung. chicken-hearted ks. pengecut, mudah ditakuti.
chickpea	kb. semacam kacang panjang atau buncis.
chicle	kb. getah sawo untuk membuat permen karet.
chicory	kb. (j. -ries) tanaman yang akarnya dibakar sebagai pengganti kopi.
chide	kkt. mencaci. his father chided him for his poor grades ayahnya mencacinya karena angka-angkanya yang jelek.
chief	kb. 1 kepala.c. of staff kepala staf. 2 ketua. c. justice of supreme court ketua mahkamah agung. 3 sep. -ks. kepala c. executive kepala negara. 2 utama. c. export ekspor utama.
chieftain	kb. kepala (suku).
chiffon	kb. semacam kain sutra yang tipis sekali.
chiffonier	kb. lemari tinggi berlaci biasanya pakai cermin.
chigger	kb. kutu, tuma, kuman.
chilblain	kb. gatal-gatal pada tangan dan kaki karena kedinginan.
child	kb. (j. children) 1 anak. 2 kanak-kanak. 3 bani.
childbearing	ks. kemampuan beranak. she is still of c. age ia masih dalam usia untuk beranak.
childbed	kb. nifas, waktu bersalin.
childbirth	kb. bersalin, sedang melahirkan.
childhood	kb. masa kanak-kanak/kecil. c. in the village semasa kecil di kampung.
childish	ks. kekanak-kanakan. don't do such c. things jangan berbuat kekanak-kanakan.
childishness	kb. hal/sifat kekanak-kanakan.
childlike	ks. kekanak-kanakan. she is adorable with her c. ways ia sangat memikat hati dengan tingkah-lakunya yang kekanak-kanakan itu.
children	lih child.
chili	kb. cabe rawit. c. con carne daging pedas dengan kacang. c. sauce sambal rawit yang cair.
chill	kb. udara dingin. i feel a c. saya kedinginan. -chills. j. dingin. -ks. dingin. -kkt. 1 mendinginkan (food, drink). 2 menawarkan hati. -chilled ks kedinginan. -chilling ks. mengerikan.
chiller	kb. inf.: sesuatu yang menakutkan. that mystery movie was a real c. film detektif itu betul-betul film yang menakutkan.
chilliness	kb. kedinginan, hal yang dingin. his attitude betrayed a certain c. towards me tingkah lakunya menanda-nandakan sikap yang dingin terhadap saya.
chilly	ks. dingin. it's c. here dingin disini.
chime	kb. 1 sepasang lonceng-loncengan. 2 bunyi genta lonceng. -chimes j. genta-genta. -kkt. membunyikan. -kki. berbunyi (dalam paduan genta). to c. in 1 menyetujui, cocok dengan , perpaduan dengan.
chimera	ks. gagasan yang tak masuk akal.
chimney	kb. 1 cerobong asap. 2 corong asap (untuk lampu).
chimp	inf.: = chimpanzef.
chimpanzee	kb. simpanse.
chin	kb. dagu. -kkt (chinned) mengangkat badan di palang. kki. inf.: omong-omong. chin-deep ks. setinggi dagu.
chin.	(chinese) yang berhubungan dengan tionghoa/cina.
china	kb. 1 piring-piring porselin, piring mangkok, pecah belah. 2 c. (negeri) tiongkok, cina.
chinaman	pej.: kb. (j. -men). cina. inf.: he didn't have a c's chance of succeeding harapan kecilpun ia tak ada untuk berhasil.
chinatown	kb. kampung cina, pecinan.
chinaware	kb. tembikar, barang pecah-belah.
chinch	kb. kutu busuk, tinggi, bangsat.
chinchilla	kb. semacam kerikit, sejenis tikus.
chinchy	ks. sl.: pelit, kikir, loba, tamak, serakah. don't be so c. janganlah begitu pelit.
chinese	kb. 1 orang cina. 2 bahasa cina. ks. cina. she's c. ia orang cina. c. cabbage sawi. c. red merah-jingga.
chink	kb. celah, sela, renggang, retak.
chintz	kb. kain cita.
chip	kb. 1 sumbing. 2 keping, bilah, tatal. 3 keripik. golf : c. shot pukulan cip. sl.: to cash in o's chip 1 menukarkan kepingan-kepingan kartu poker dengan uang. 2 mati, wafat. -kkt. (chipped) menyumbingkan. -kki. 1 pecah. 2 nglotok, mengelupas.
chipmunk	kb. tupai/bajing tanah.
chipper	kb. inf.: segar, gembira. i feel pretty c. after the operation saya merasa segar setelah pembedahan
chiropodist	kb. perawat kaki.
chiropractor	kb. orang yang menyembuhkan penyakit dengan pengobatan tulang punggung.
chirp	kki. mengerik.
chisel	kb. pahat. -kkt. 1 memahat (wood). 2 sl.: menipu (the goverment). -kkt. sl.: to c. in on menyusup masuk ke. -chiseled ks. (seperti) dipahat.
chiseler	kb. pemahat. 2 sl.: penipu.
chit	kb. bon(makanan). 2 catatan.
chit-chat	kb. obrolan, percakapan ramah tamah. -kki. (chit-chatted) mengobrol
chitlings	kb. , j. usus (kecil) sapi atau babi yang dipotong-potong untuk dimasak dan dimakan.
chivalrous	ks. sangat sopan.
chivalry	kb. kekesatriaan, kesopanan.
chives	kb., j. lokio, semacam bawang putih.
chloride	kb. khlorida.
chlorination	kb. khlorinasi, desinfeksi dengan khlor.
chlorine	kb.khlor. c. bleach bahan pemucat yang mengandung khlor.
chloroform	kb. khloroform, obat bius. -kkt. 1 memakai khloroform. 2 membunuh dengan khloroform.
chlorophyl	kb. zat hijau (daun).
chock-full	ks. penuh sesak. his wallet was c. of money dompetnya penuh dengan uang.
chocolate	kb. cok(e)lat. -ks. coklat.
choice	kb. 1 pilihan. 2 pemilihan. -ks. berharga.
choiceness	kb. kwalitas/nilai tinggi
choir	kb. paduan suara (di gereja/sekolah). brass c. kesatuan musik tiup.
choirboy	kb. anak laki-laki yang ikut dalam paduan suara gereja.
choirmaster	kb. pemimpin paduan suara gereja.
choke	kb. auto.: cok. -kkt. 1 mencekik. 2 menghambat. -kki. tercekik. to c. back menahan. to c. down terpaksa menelan. to c. off mematahkan. to c. up memenuhi, mengisi.
cholera	kb. kolera.
cholesterol	kb. kholesterol.
choose	kkt. (chose, chosen) 1 memilih (a candidate, a dress, etc.). 2 memutuskan. -kki. memilih. -chosen ks. terpilih. -choosing kb. kehendak.
choosy	ks. inf.: cerewet, rewel. a c. person seorang yang cerewet.
chop	kb. 1 pukulan (tinju). 1 potongan. 3 cap. -chops. j. mulut, dagu dan pipi, muncung. -kkt. (chopped) 1 memotong, membelah (wood). 2 merambah, membabat (a path). 3 tenn.: memukul kebawah. -chopped ks. yang dicacah/dicincang.
chop suey	kb. semacam bakmi.
chopper	kb. 1 pemotong. 2 sl.: helikopter. sl.: choppers j. gigi-gigi.
choppy	ks. 1 berombak. c. sea laut yang berombak. 2 yang berkejut. c. gestures gerak-gerik yang kikuk.
chopsticks	kb., j. penjepit, supit.
choral	ks. yang berhubungan dengan paduan suara. c. group (perkumpulan) paduan suara.
chorale	kb. nyanyian untuk paduan suara.
chord	kb. 1 mus.: paduan nada. 2 tali atau penghubung antara dua titik dilingkaran. 3 perasaan.
chore	kb. pekerjaan, tugas. to do the daily chores about the house or farm melakukan tugas-tugas sehari-hari di rumah atau di usaha tani.
choreographer	kb. pencipta tarian atau sendratari.
choreography	kb. khoreografi.
chortle	kb. kekeh. -kki. tertawa terkekeh-kekeh. to c. with glee tertawa terkekeh-kekeh kegirangan.
chorus	kb. 1 paduan suara. 2 ulangan lagu, refrein. c. girl gadis anggota dari rombongan penari dan penyanyi.
chose	lih. choose.
chosen	lih choose.
chow	kb. sl.: makanan. c. time waktu makan. c. mein sup kental dengan mie.
chowder	kb. sup kental.
chrestomathy	kb. (j. -thies) bunga rampai, kutipan sastera.
chrism	kb. minyak suci.
christ	kb. kristus, isa (al-masih).
christen	kkt. 1 membaptis. 2 memberi nama kepada. -christening kb. 1 pembaptisan. 2 upacara pemberian nama.
christendom	kb. umat kristen.
christian	kb. seorang kristen/nasrani/masehi. -ks. kristen, nasrani, masehi.
christianity	kb. 1 agama kristen. 2 kaum kristen.
christianization	kb. penyebaran agama kristen.
christianize	kkt. menjadikan orang kristen.
christmas	kb. 1 natal. 2 hari natal.
chromatic	ks. 1 bertautan dengan warna. 2 bertautan dengan nada. c. scale skala musik terbagi sama dalam duabelas nada dan setengah nada.
chrome	kb. khrom. c.-plated ks. sepuhan/bersepuh khrom.
chromium	kb. khrom
chromosome	kb. bagian sel yang mengandung sifat turun-temurun.
chronic	ks. 1 menahun, terus-menerus,tak hilang-hilang, khronis, kronis.
chronicle	kb. 1 sejarah, tarikh. 2 catatan, rentetan kejadian-kejadian, kronik(a). -kkt. mencatat rentetan kejadian-kejadian.
chronicler	kb. penulis kronik.
chronological	ks. kronologis, secara berturut-turut. in c. order secara kronologis/berturut-turut.
chronology	kb. (j. -gies) urutan waktu, kronologi.
chrysalis	kb. kepompong.
chrysanthemum	kb. krisan, bunga serunai.
chubbiness	kb. kegemukan.
chubby	kb. gemuk.
chuck	kb. gamit, usapan. -kkt. 1 membuang. 2 melemparkan. 3 mengusap. inf.: to c. up 1 meninggalkan, menghentikan. 2 muntah. c. roast potongan daging sapi antara leher dan bahu.
chuckhole	kb. lobang di jalan.
chuckle	kb. ketawa tertekan, ketawa-ketawa kecil.
chug	chug
chum	kb. inf.: sobat kental, sahabat karib. -kki. (chummed) berteman bergaul. the two girls have chummed together for years kedua gadis itu telah berteman bertahun-tahun lamanya.
chumminess	kb. inf.: keakraban.
chummy	ks. inf.: akrab.
chump	chump
chunk	kb. 1 gumpal, potong, bongkah. a c. of bread segumpal roti. 2 potong. a c. of wood sepotong kayu.
church	kb. 1 gereja. . service kebaktian gereja. to enter the c. a) masuk gereja. b) menjadi pendeta.
churchgoer	kb. orang yang selalu pergi ke gereja.
churchgoing	ks. saleh, selalu ke gereja. c. family keluarga yang selalu ke gereja.
churchman	kb. (j. -men). 1 pendeta. 2 anggota gereja yang setia.
churchwoman	kb. (j. -women) anggota wanita gereja yang setia.
churchyard	kb. halaman gereja.
churlish	ks. kasar, tidak tahu aturan.
churn	kb. tong susu (untuk membuat mentega). -kkt. 1 mengaduk (milk). 2 mengocok. the speedboat churned the water kapal motor cepat itu mengocok air.
chute	kb. = parachute. to c. the chutes meluncur di tempat peluncuran.
chutney	kb. kuah dibuat dari buah-buahan, daun-daun, merica. dsb.
chyme	kb. air perut yang menghancurkan makanan.
cicada	kb. semacam jengkerik.
cider	kb. sari buah apel.
cigar	kb. serutu, cerutu. c. store warung rokok.
cigarette	kb. rokok (kertas), sigaret, rokok putih. c. case kotak/tempat rokok, selepa. c. holder pipa sigaret. c lighter seteker, pemantik api, geretan.
cinch	kb. sl.: suatu yang mudah dan pasti. it's a c. ! 1 itu mudah sekali ! 2 pasti sekali. -kkt. inf.: menang.
cinchona	kb. 1 pohon kina. 2 kulit pohon kina.
cinder	kb. abu api/bara, sisa arang, terak. c. block blok sinder.
cinema	kb. gedung bioskop.
cinematography	kb. pembuatan dan reproduksi filem-filem.
cinnamon	kb. kayu manis.
