glos	(ling.) gloss.
glosarium	(ling.) glossary.
glotal	(ling.) glottal.
glotalisasi	(ling.) glottalization.
glotis	(ling., anat.) glottis.
glotokronologi	(ling.) glottochronology.
glugut	(java) fine hairs of the bamboo.
glukosa	glucose.
go	1. (china) five. go-ban 50,000. go-cap 50. go-ceng 5,000. go-pek 500. go-tiau five million. 2. go gonorrhea.
go-go	see sistem.
goa	see gua 1.
goal	see gol.
gobah	see kubah.
goban	see go 1.
gobang	k.o. colonial era coin (valued at two-and-a half cents) with hole in middle.
gobar	somber.
gobek	metallic cylinder with plunger to mince betel chew, esp. for toothless elders. meng-gobek pound areca nut with such a device.
gobernor	see gubernur.
gobet	meng-gobet cut very thin, grate.
goblek	1 finished, done. 2 done as o. pleases.
goblok	stupid.
gocan	(jakarta) toss and turn (ino.'s sleep).
gocap	see go 1.
gocek	meng-gocek (sport) maneuver with the foot.
goceng	see go 1.
gocet	see gocek.
gocoh	ber-gocoh fight, pummel.
goda	meng-goda 1 tempt. 2 plague, tease, torment. goda-an temptation.
godam	sledgehammer. strike, pound (of fist, club, etc.).
godek	side whiskers, sideburns. ber-godek growing side burns.
godog,godok	s.t. boiled.
godot	meng-godot slice, saw thinly.
goek	sound of clearing the throat.
gogo	1. nonirigated rice field. 2. go-go dance.
gogoh	meng-gogoh shiver.
gogok	(java) meng-gogok 1 drink straight from a pitcher or bucket. 2 guzzle, swill.
gogos	see gugus.
gohok	(jakarta) k.o. plant bearing sour purple fruit.
gohong	(m) hole, cave.
gojlog,gojlok	meng-gojlok 1 shake up (from accident, etc.). 2 haze (new students, etc.).
gokart	go-cart.
gol	1. goal, score, point. 2 achieve a goal. 3 (sport) goal, goal post.
gol.	[golongan] group.
golak	ber-golak 1 boil (of water). 2 seethe, churn. brew, boil. turbulence, upheaval.
golak-galik	1 up and down. 2 to and fro.
golbi	fly (of trousers).
golek	1. ber-golek 1) rol. 2) lie down. 2. (coll.) k.o. wooden rod-puppet used in a genre of wayang. golek-an (java) doll, puppet.
goler	lie down. ber-goler 1 turn or roll over. 2 lie down.
golf	/golef/ pe-golf golfer.
golkar	[golongan karya] (pol.) the group of functionaries, a political party established by gvt. for technocrats and civil servants.
golkarisasi	(pol.0 process or movement to enlist support and secure victory for golkar.
golok	machete (often somewhat short). meng-golok slash with such a weapon.
golongan	1 group 2 class .
golongisme	mentality characterized by divisiveness and group-orientation.
gombak	1 forelock. 2 tuft, crest.
gombal	empty, false.
gombang	1. glazed earthenware jar. 2. (m) handsome, good-looking.
gombeng	meng-gombeng enlarge (a hole), interspace s.t.
gombinis	see komunis.
gombol	bunch (of keys, etc.).
gombrong	(jakarta) loose-fitting (of clothing).
gombyok	(java) tassel, fringe.
gombyor	baggy (of k.o. pants).
gomok	see gemuk.
gompal	(jakarta) torn down, broken.
gompyok	1. thick (of hair, leaves). 2 betasseled. 2. (biol.) gonad.
goncang	1 shake. 2 shaky, swaying. 3 unstable, changeable.
gonceng	see bonceng.
gondang	(java) 1 snail, slug. 2 name for various k.o. mollusks.
gondok	1. goiter. 2. (java) angry in a suppressed way. gondok-an easily irritated.
gondol	1. meng-gondol 1 (java) carry in mouth (of dog, etc.). 2 walk away with or win (a championship). 3 (coll.)steal or swipe. peng-gondol winner, champion (of tournament, etc.). 2. see gundul.
gondong	goiter. gondong-an s.t. similar to goiter.
gondorukem	see gandarukam.
gondoruwo	see gendruwo.
gondrong	long-haired, esp. of men.
gong	1. gong. meng-gong-kan second a motion, idea, etc. 2. sound of barking.
gonggong	1. sound of barking. ber-, meng- 1) bark (of dog). 2) ( coll.) scold. 2. (lit) meng-gonggong carry in mouth (of animals).
gongli	(sunda) (bagong lieur) willing sexual partner.
gongseng	meng-gongseng fry s.t without oil.
goni	1 jute. 2 gunny-sack.
goniometri	goniometry.
gonjong	(lit.) steep and pointedd, pitched (of roof, etc.).
gono-gini	property acquired jointly, esp. during marriage, and which is divided equally in event of divorce.
gonorea, gonori	gonorrhea.
gonta-ganti	1 muttually, reciprocally. 2 take turns, ber-gonta-ganti alternate.
gontai	slow.
gontok	hit with the fists in anger.
gontokan	1 quarrel. 2 engage in a conflict, fistfight, etc.
gonyak	meng-gonyak-kan (lit.) ridicule, deride.
gonyok	meng-gonyok wipe, scour, make clean.
gonyokan	1 wiping, cleaning. 2 scourge, wiping out.
gopeh	quick. gopoh-gopoh in a hurry, hurriedly. ter(gopoh-gopoh) hurry, hurriedly, hastily.
gopek	see go 1.
gorden,gordin	curtain.
gordon	see kordon.
gorek	meng-gorek scratch. peng-gorek-an scratching, scraping.
goreng	s.t. fried, fried food. meng-goreng fry.
gores	1 scratch. 2 etch lines into s.t.
goret	see gores.
gori	(java) unripe jackfruit.
gorila	gorilla.
gorok	cut (a throat). peng-gorok-an slaughtering.
gorong-gorong	water-channel.
gosip	gossip. meng-gosip-kan gossip about s.t. gosip-gosip-an spreading by word of mouth.
gosok	gosok-gigi (coll.) toothbrush.
gosong	1. sandbar. 2. (java) burnt, scorched, singed.
gossip	see gosip.
got	gutter, drain.
gotes	meng-gotes pluck, pick, gather.
gotiau	see go 1.
gotong	meng-gotong carry s.t. so heavy two or more people must cooperate. gotong-an heavy burden, shared load.
gotong-royong	community self-help, mutual cooperation. ber-gotong-royong cooperate, share work.
gotri	(java) pellet, buckshot.
gotrok	(java) k.o. narrow-gauge railway (used for transporting sugar).
goyah	loose, wobbly (of teeth,chair legs, etc.).
goyak	meng-goyak (m) shake or rock s.t.
goyang	shaky, wobbly, unsteady.
goyangan	1 oscillation, staggering. 2 fluctuation.
goyor	see guyur.
gr	[gotong royong] mutual aid.
gr-	see also entries with ger-.
grad	degree.
gradag	(java) sound of dragging or moving over a rough surface. gradag-an clatter, tumult.
gradah,gradak	see geledah.
gradasi	gradation.
graduil	gradual.
graf	(ling.0 graph, letter (of a writing system).
grafik,grafika	on a graph.
grafis	graphic.
grafit	graphite.
gragal	bits of plaster, cement, rocks left over from construction.
gram	gram.
gramang	see geramang.
gramatika	(ling.) grammar.
gramatikal	(ling.) grammatical.
gramopon	phonograph.
granat	grenade.
granit	granite.
grapik	see grafik.
grasi	clemency granted by head of state.
gratifikasi	1 bonus (for workers). 2 dividend (for shareholders).
gratis	free, gratis. meng-gratis-kan give away for free. gratis-an s.t. for free.
gravir	engraving (in trophies, etc.).
gravitasi	(phys.) gravity.
grebeg, grebek	see garebeg.
gregatan	see geregetan.
gregel	(java) ng-gregel-i nervous to the point of quivering (and lossing grip of s.t.).
greges	(java) feverfish. ng-greges suffer or tremble from a fever.
greget	see geregetan.
grehon	greyhound.
gremet	(java) meng-gremet advance very slowly. meng-gremet-i crawl on s.t.
grendel	latch, door bolt.
grengseng	(java) feeling of excitement or anticipation.
grepe	see gerapai.
gres	(sl.) brand new (car, etc.).
grifir,gripir	see geripir.
grimis	see gerimis.
grobak	see gerobak.
grodok	sound of dragging or bumping (i.e. metal banging against metal, etc.).
grogi	see gerogi.
grogol	see gerogol.
grogot	see gerogot.
grojok	gush forth.
grojokan	flushing.
grombolan	see gerombol.
gros	1. gross, unit of measure. 2. (ambon) large.
grosir	wholesaler, distributor.
growak	having a hole or flaw.
grumbul	see gerombol.
grundel	see gerundel.
grup	group.
gua	1. cave, grotto. 2. (jakarta, china, coll.). i, familiar firts person pronoun.
gual-gail	loose, wobby (of teeth).
guam	theush (children's disease).
gub.	[gubernur] governor.
gubah	1. gubah-an 1) arrangement or composition (of music, flowers). 2) literary work. 2. see kubah.
gubal	1. clump, pile 9of stone, soil etc.). 2. cambium, soft wood between bark and xylem.
gubang	1. notch in tree for foothold when climbing. 2. ber-gubang roll over to clean itself (of animals). 3. see gobang.
gubel	meng-gubel coax, urge.
gubernemen	1 gvt. (colonial period). 2 residence of the governor.
gubernur	governor.
gubit	(m) meng-gubit beckon to.
gubris	meng-gubris heed, pay attention to (a request, etc.).
gubuk	1 hut, shack. 2 shelter in rice field.
guci	porcelain or earthenware jug.
gudang	1 warehouse, storehouse. 2 storeroom, pantry.
gudangan	(java) steamed mixed vegetables with grated coconut and chili peppers.
gudeg	(java) young jackfruit cocked in coconut milk with spices.
gudel	1. water buffalo calf. 2. plaque (on o.'s teeth).
gudik	1. scabies. gudik-an mangy. 2. ter-gudik-gudik flop about (of dog's tail, fish on land, etc.).
gue	see gua 2.
gugah	1. meng-gugah 1) waken, arouse. 2) move (s.o.'s heart, conscience). ter-gugah awakened, aroused. gugah-an the moving of s.t. 2. meng-gugah(kan) grouse, complain, grumble.
gugat	a shock, jerk, jolt. meng-gugat shake, rock s.t.
gugatan	1) accustion. 2) (leg.) suit. 3) claim. 4) criticism.
gugu	(java) meng-gugu listen to and obey s.o. ter-gugu trusted, relied on.
guguh	1. meng-guguh 1) beat (a drum). 2) knock on (a door). 2. (jakarta) very old.
guguk	1. hillock, knoll. 2. meng-, ter-guguk cry with gasping, boo-hoo sounds.
gugup	panickly, nervouse, jittery. ke-gugup-an nervousness, jumpiness. peng-gugup a nervous person.
gugur	1 fall (of leaves, hair, etc.) 2 fall prematurely (of fruit, fetus, etc.).
gugus	group, cluster.
guha	see gua 1.
guik	meng-guik-guik squeal (of pig).
guit	meng-guit 1 touch with the feet. 2 infringe on.
gul	see gol.
gula	sugar. gula-gula 1 sweets, candy. 2 mistress.
gulai	k.o. curry.
gulali	1 taffy. 2 k.o. syrupy sweet.
gulana	see gundah.
gulat	ber-gulat wrestle e.o. wrestler.
gulden	guilder (monettary unit in colonial times or the current dutch unit).
gule	see gulai.
gulet	1. see gulat. 2. see gelut.
guli	marbles.
guliga	bezoar, esp. when used as amulet.
guling	ber-guling 1 roll. 2 sleep with a bolster.
gulir	ber-gulir move, roll on, go.
gulita	dark.
gulma	weeds.
gulu-banyak	(auto.) curved part of exhaust pipe.
gulung	1 roll. 2 coil (of rope). peng-gulung roller.
gulut	ber-, ter- (gulut-gulut ) in hurry, hastily, in haste. meng-gulut hurry s.t. up, accelerate.
gum	sound of boom (cannon, etc.).
gumal	1 wrinkled, creased (of cloth). 2 rumpled, crumpled (of paper).
gumala	see gemala.
gumalai	see gemulai.
gumam	gumam-an a murmur.
gumpal	1 clod, clump (of earth, clay, clouds, etc.). 2 wad, ball.
gumuk	(java) knoll.
gumul	1 wrestle. 2 struggle.
gumulan	a tangle (of issues, boys wrestling, etc.).
gumun	(java) astonished, surprised.
gun	1 (china sleep. 2. fine-toothed comb in weaving machines to separate threads.
guna	1 use, purpose. 2 for, in order to.
guna-guna	magic, magical formulas.
gunapa	(coll.) what for ?
gunawan	1 (lit.) virtuous, noble. 2 useful (person).
guncang	see goncang.
gundah	depressed, dejected. gundah-gulana despondent.
gundal	1. 1) notch (in wood). 2) knot (in string) as indicator in counting. 2. see begundal.
gundar	coarse brush (for cleaning a horse, etc.). meng-gundar use such a brush.
gundi	see legundi.
gundik	concubine, mistress.
gundu	1 k.o. nut used as a marble. 2 marble. ber-gundu play marbles.
gunduk	ber-gunduk-gunduk be piled up in several heaps.
gundukan	heap, pile.
gundul	1 bald. 2 bare, barren (of land). 3 leafless.
gung	see gong 1.
gunggung	sum total. gunggung-an the total.
gungli	see gongli.
guni	see goni.
gunjai	tassel, tuft.
gunjing	gossip. ber-gunjing gossip with s.o. else. meng-gunjing-kan say s.t. bad about s.o. gunjing-an slanderous gossip.
guntai	1. owned by an absentee landlord. 2. see gontai.
guntak	rattling (e.g. of seeds in fruit). ber-guntak rattle.
gunting	1 scissors, shears, clippers. 2 (coll.) cut, clip, trim.
guntingan	1 clipping (from newspaper, etc.). 2 cut, style of cutting (a pattern, etc.).
guntung	1 flat, level, smooth. 2 short. 3 blunt, flat. meng-guntung top (a tree, pole, etc.).
guntur	thunder.
gunung	mountain .
gunungan	1 (java) mountainlike figure in the wayang play symbolizing the universe. 2 imitation mountain.
gup	sound of mutted thud.
gurah	ber-gurah gargle, rinse. meng-gurah rinse s.t. out (vat, o.'s mouth, bottle, etc.).
guram	1. dull, dim, hazy. 2. 1 chiken flea. 2 insignificant, inconsequential. 3. gums.
gurami	k.o. fish, gurami.
guras	see kuras 2.
gurat	1 scratch, line. 2 (jakarta, sl.) lines in the palm.
guratan	1 sketch, outline. 2 facial wrinkle.
gurau	1 a joke. 2 say jokingly. ber-gurau joke, jest. gurau-an joke, prank.
gurdi	drill, auger.
gurem	(jakarta, java) see guram 1,2.
guri	small earthen pot.
gurih	1 deliciously oily 9and salty) but causing thirst (of fried fish, etc.). 2 delicious in general. ke-gurih-an too salty and crisp.
gurinda	see gerinda.
gurindam	(lit.) 1 aphorism in two lines. 2 rhapsodical type of free verse.
guris	see gores.
gurit	1 philosophical verse. 2 simple verse in rhyme. meng-gurit poetize, versify, write poetry.
gurita	1. octopus. 2. baby's vest.
guru	teacher.
guruh	thunder. ber-, meng-guruh thunder, boom.
gurun	wasteland, desert.
gurung	(java) windpipe, esophagus, gullet. gurung-an water channel.
gus	1. (java) respectful term of address by adults to boys or youth. 2 see bagus.
gusah	(java) meng-gusah chase away.
gusar	angry.
gusi	gums.
gusti	1 the lord. 2 lord ! exclamation of hope. 3. aristocratic title.
gusur	gusur-an an area condemned for right of way or public use.
gutik	meng-gutik touch with tips of fingers.
gutural	guttural.
guyah	see goyah.
guyon	(java) ber-guyon joking. guyon-an joke, object of fun.
guyub	1. (java) friendly, close, mutually helpful. ke-guyub-an communality. per-guyub-an community organization based on ascribed status. 2. see kuyup.
guyur	ber-guyur bathed in (sweat, etc.).
guyuran	splash.
gwo-yeu	/kwo-i/ see kuoyu.
h	h, the 8th letter of the alphabet.
h.	1. [haji] (islam) title of o. who has made the pilgrimade to mecca. 2. [hijriah] year of the arabic calendar. 1406 in the year 1406 of the hijriah.
ha	1. huh (question marker) 2. 1) humph ! (exclamation of derision). 2) ah ! (exclamation of discovery). 3) ha ! (exclamation of disbelief).
ha.	[hektar] hectare.
haacih,haaciu	see hacih.
haah	see ha 2.
haak	see hak 3.
habelur	see hablur.
habib	respectful term of address for ethnic arabs who can trace their ancestry to muh.
habil	(bib.) abel, o. of adam's sons.
habis	1 finished, used up. 2 completed, through, concluded.
hablur	crystal.
habsyi	1 ethiopia, byssinia. 2 african.
hacih	/hacing, haciu, hacu / atchoo ! (sound of a sneeze).
had	boundary, limit.
hadang	see adang.
hadap	1 across (the street). 2 side. 3 facing in a certain direction.
hadapan	1 front. 2 future. 3 presence.
hadas	(islam) ritual impurity.
hadat	see adat 1.
hadiah	1 prize. 2 reward. 3 gift. with a gift. present s.t., donate.
hadir	be present.
hadirat	1 (rel.) presence (of god). 2 female members of the audience.
hadirin	those present, audience.
hadis	(islam) traditional collection of stories relating words or deeds of muhammad the chief source of guidance for understanding religious questions.
hadlir	see hadir.
hadlirat	see hadirat.
hadlirin	see hadirin.
hadrah	1 (islam) communal gathering, us. mystical, sometimes including group chanting with tambourine accompaniment. 2 tambourine.
hadrat	1 ( islam) religious gathering. 2 presence.
hafal	1 know by heart, memories. 2 know s.t. very well.
hafalan	material to be memorized.
hah	see ha 2.
haha	sound of loughter.
hai	1 hey ! (exclamation to call s.o.'s attention). 2 what ! (exclamation of surprise).
hai-alai	see hailai.
haid	menstruation.
haik	charge ! (exclamation shouted when attacking).
hailai	(sport) jai alai.
hairan	see heran.
haisom	(china) k.o. dish made of sea cucumber.
haiwan	see hewan.
haiyaa	(china) 1 greetings ! 2 exclamation of disapproval.
haj	(islam) pilgrimage to mecca.
hajar	meng-hajar beat up, thrash soundly. hajar-an beating, thrashing.
hajat	1 wish, desire. 2 intent, intention. 3 (euphemism) urination or defecation.
haji	(islam) 1 o. who has made the pilgrimage to mecca. 2 title and term of address for such a pilgrim.
hajing	see hacih.
hajjah	see hajjah.
hak	1.1) right. 2) rightful authority. 2. heel (of shoe). 3. knit.
hakekat,hakikat	1 truth, reality. 2 essence.
hakiki	true, real, authentic.
hakim	judge. meng-hakim-i pass judgment on, judge s.t. departmen-kehakiman ministry of justice.
hakjing	see hacih.
hakul-yakin	(lit.) be truly convinced of s.t.
hal	1. 1) matter, thing. 2) case. 3) concerning. 2. galvanized sheet iron.
hal.	[halaman] page of book.
hala	direction.
halai-balai	1 ignored, neglected. 2 in confusion.
halal	1 (islam) allowed, permitted. 2. rightfull, legal.
halal-bihalal,halal-bilhalal	1 (islam) ask and give forgiveness at the end of the fasting period. 2 a gathering of social group (workers at same office, people of same ethnic origin, etc.) soon after islam fasting month for such a purpose.
halaman	1 yard (of a house). 2 premises. 3 page (of book).
halang	1. ber-halang-an be hindered, handicapped. 2. see alang 1.
halangan	hindrance, obstacle.
halat	1. see helah. 2. see alat 2.
halau	expel s.o.
halia	ginger.
halilintar	1 flash of lightning. 2 thunderbolt.
halimbubu	whirlwind.
halimun	mist, fog.
halintar	see halilintar.
halipan	see lipan.
halkum	adam's apple.
halma	chinese checkers.
halo	hello.
halsduk	neck scarf.
halte	stopping place for public vehicles.
halter	dumbbell, bar bell.
haluan	1 (naut.) bow, prow. 2 direction. 3 foremost section. se-haluan of the same course.
halus	1 refined, cultured, sensitive. 2 soft, delicate, smooth (of skin, cloth, etc.) 3 unseen (of spirits). 4 small. 5 finely pounded or granulated of flour, etc.).
halusinasi	hallucination.
halwa	fruits preserved in sugar.
ham	ham.
hama	1 plant disease, pest. 2 infection. 3 pest, scourge. meng-hama-kan contaminate.
hamal	(zod.) aries.
hamba	1 slave, servant. 2 (lit.) i, esp. when talking to s.o. of higher rank, often in formal prayers. 3 (lit) yes.
hambalang	a great deal of violence (esp. in reference to martial art films).
hambar	1 tasteless, flat, insipid. 2 vapid, trite.
hambat	checked, blocked.
hambatan	1 obstacle, obstruction. 2 barrier, fence, wall. 3 (ling.) closure.
hambung	see ambung.
hambur	jump.
hamburger	k.o. sandwich, served with sauces in sliced bun.
hambus	see embus 1.
hamenworst	/hamemwors/ luncheon meat.
hamil	pregnant, pregnancy. meng-i, meng-kan impregnate, make pregnant.
haminte	see geminte.
hamis	see amis.
hampa	1 empty. 2 without result.
hampai	see ampai 1.
hampar	1 spread (rug, etc.). 2 explain, elucidate.
hamparan	1 rug, carpet. 2 spread out area.
hampedal	see empedal.
hampedu	see empedu.
hampir	1 near, close. 2 almost. hampir-an vicinity, neighborhood.
hampiran	vicinity, neighborhood.
hamud	acid.
hamun	ber-hamun-hamun rail at, be abusive.
hamzah	letter of arabic alphabet representing glottal stop.
hana	1 wide and uninhabited. 2 empty, deserted
hanacaraka	the java, sunda, or madurese syllabary.
hancing	stench, foul odor.
hancur	1 shattered, smashed. 2 dissolved.
handai	friend, companion.
handal	see andal.
handikap	(sport) handicap.
handuk	towel.
hang	(lit.) male title.
hangar	see hanggar 1.
hangat	warm.
hanggar	1. 1) airplain hangar. 2) sports hall. 2. see anggar 2, anggar 3.
hangit	see angit.
hangus	1 burnt, scorched. 2 singed. 3 (coll.) completely used up (of money).
hanjut	meng-hanjut hit s.o., crush s.o.
hankam	[pertahanan dan keamanan] defense and security.
hanra	[pertahanan rakyat] lower level civilian defense units.
hansip	[pertahanan sipil] civilian defense units often given neighborhood patrol tasks.
hansop	child's play- and sleepwear with short sleeves and short legs.
hantam	1 fight, scuffle. 2 collide with. 3 infringe on.
hantaman	blow, smack, punch.
hantar	see antar 1.
hantir	meng-hantir wield, manage, handle.
hantu	1 ghost. 2 evil spirit.
hanuman	(lit.) the white monkey, sacred hero of the ramayana.
hanya	1 only. 2 only, however.
hanyir	see anyir.
hanyut	1 washed away, drift. 2 drift, wander. 3 lose o.s. (in reveries, etc.).
hao	(china) filial piety.
hapak	see apak.
hapal	see hafal.
hapermot	see havermut.
hapus	1 completely remove. 2 clean s.t., wipe off (blackboard).
harafiah	see harfiah.
harakah,harakat	wowel (in arabic grammar).
harakiri	(japanese) suicide.
haral	see aral.
haram	1 (islam) forbidden, proscribed. 2 (coll.) on no account, under no circumstances. 3 never ! (an exclamation of strong denial).
haramjadah	/haramzadah/ illegitimate (child).
harangaso	(sunda) k.o. tuber.
harap	(lit.) war.
harapiah	see harfiah.
harasia	(sl.) see rahasia.
harbor,hardbord	beaverboard, hardboard.
hardik	say s.t. sharply, snarl.
hardikan	rebuke,scolding, harsh words.
harfiah	literal, word for word.
harga	price, cost, value.
hari	day. se-hari-hari every day.
harian	1 daily. 2 daily newspaper.
haribaan	lap.
harim	wife, female members of the family (esp. among those of arabic descent or educational background).
harimau	tiger.
haring	1. herring. 2. see aring 1,2.
harini	(coll.) today.
harkah,harkat	1 level, standard. 2 rate, value. 3 dignity.
harlah	[hari lahir] inniversary, birthday.
harmoni	harmony.
harmonik	see harmonis.
harmonika	harmonica.
harmonis	1 harmonious. 2 harmonic.
harmonisasi	harmonization.
harmonium	harmonium.
harpa	harp.
harpis	harpist.
harpus	resin used by violinists.
hart	(crd.) heart.
harta	property, wealth.
hartawan	wealthy person, person of means.
haru	haru-biru commotion, uproar, tumult. ter-haru moved, touched, affected. ke-haru-an emotional.
haru-biru	see haru.
haruan	k.o. freshwater fish.
harum	1 fragnant, aromatic. 2 fragnance, aroma.
harun	(bib.) aaron. 2 (islam) o. of the prophets.
harung	see arung.
harus	1 have to, must. 2 (islam) permitted by religion, neither sinful nor meritorious, e.g. eating, bathing, etc.
has	1. filet, tenderloin. 2. gauze, fine screening.
hasa	(ambon) sail along the shore.
hasad	envy, spite.
hasan	good, beautiful, handsome.
hasiat	see khasiat.
hasil	1 yield, crop. 2 product. 3 result, outcome, output. success
hasrat	1 longing, desir. 2 propensity. berhasrat 1 desire, wish.
hassan	see hasan.
hasta	cubic. meng-cubic measure in cubics.
hastakarya	1 handicrafts. 2 (sl.) petting.
hasud	see hasad.
hasung	see asung.
hasut	incite, goad, stir up.
hasutan	1 instigation, provocation, fomentation. 2 agitation (for civil rights, etc.).
hasyiah	1 edge, border. 2 marginal annotation.
hasyis	hashish.
hati	1 liver. 2 seat of emotions. 3 (crd.) heart.
hatsil	see hasil.
hatta	(lit.) then, thereupon.
hatur	see atur 2.
haus	1. 1) thirsty. 2) thirst, thirstiness. 2. see aus.
havermut	oatmeal.
hawa	1 air. 2 climate, weather. meng-hawa evaporate.
hawa-nafsu	carnal desire, lust.
hawai,hawaian	hawaiian-style music.
hawar	blight.
hawatir	see kuatir.
hawe	see awe.
hawiah	(islam., lit.) depths of hell.
hayal	see khayal.
hayali	see khayali.
hayat	life.
hayati	biological, vital.
hayo	1 come ! (in exhortations). 2 behold! there you have it !
hayun	see ayun.
hb	/habe/ k.o. pencil.
hb.	[hari bulan] (lit.) date.
hbs	[hoogere burger school] four-year secondary school for children of the elite (colonial period).
hc.	[honoris causa] honorary.
hcs	[hollandsh-chineesche school] dutch-medium primary school for well-to-do ch [colonial period].
he	1. huh (interrogative particle). 2. umm (hesitation particle). 3. see hai.
heban	(lit.) hurl, throw s.t. heavy, throw with both hands.
hebat	unusually intensive (excitement, attractiveness, intelligence, violence, etc.).
heboh	1 commotion, uproar. 2 fuss, row, stir. 3 sensational.
hedonisme	hedonism.
hee	(coll.) uh huh, yes.
heeh	see ha 2.
heehm	see ehm 1.
hegemoni	hegemony.
heh	see he 1.
hei	see hai.
heiho	indigenous militia during the japanese period.
hejan	see ejan.
hejrah	see hijrah.
hek	(coll.) fence (around yard, etc.).
hektar	hectare.
hektoliter	hectoliter.
hela	meng-hela drag, haul, pull (carriage, wagon, etc.).
helah	(lit.) 1 trick, ruse. 2 excuse, pretext.
helai	1 sheet (of paper, etc.). 2 a counter for paper, cloth, leaf, etc. ber-helai in sheets, unbound.
helak	ber-helak be wafted or lifted back (of long things, whips, etc.).
helat	1. celebration, party. 2. see helah.
heleng	meng-heleng turn, look.
heli	[helikopter] helicopter.
helicak	[helikopter becak] three-wheeled motorized pedicab.
helikopter	helicopter.
helipad	[helikopter pad] helicopter pad.
helium	helium.
helm	/helem/ motorcycle helmet, hard hat.
hem	um (exclamation of distaste, scorn).
hemat	1. judgment, observation. 2. thrifty, economical, thrift.
hembalang	ber-hembalang tumble head over heels.
hembus	see embus 1.
hemong	(sl.) homo, male homosexual.
hempang	see empang.
hempas	see empas.
hempes	see himpit.
hendak	1 wish (to do s.t.). 2 intend, be going to. 3 be about to. hendak-nya be desirable that, should.
hendam-karam	destroyed, wiped out.
hendap	see endap 1.
hendel	handle (of door, etc.).
heng	(sport) hands ! (said when soccer ball is touched with hands).
hengah	see enga 2.
hengkang	see engkang.
hening	1 clear. 2 silent, quiet.
hentak	see entak.
hentam	meng-hentam-kan stamp (the foot). hentam-an 1 foot stamping. 2 big explosion.
henti	stopping, stoppage. henti-an (ling.) stop.
henyak	see enyak.
heos	meng-heos blow with a bursting sound (of steam, etc.).
hepatitis	hepatitis.
her	1 retake (an exam). 2 makeup exam.
heran	1 surprised, amazed. 2 astonisment.
herba	herb.
herbisida	herbicide.
herder	german shepherd dog.
herdislokasi	re-dislocation (of shoulder, etc.).
hereng	see ereng.
herik	see erik.
hering	k.o. fish, herring.
hero	1 popular sports figure. 2 s.o. of considerate prowess.
heroik	heroic.
heroin	heroin.
heroisme	heroism.
herot	see erot 1.
hert,herrt	sound of s.t. being ripped.
hetero	heterosexual.
heterogen	heterogeneous.
heteroseks	heterosexual.
heuristis	heuristic.
hewan	1 domesticated animal. 2 animal (as a class).
hewani	/hewaniah/ of an animal.
hey	see hai.
hi	ha ! (exclamation uttered when teasing s.o.).
hianat	see khianat.
hiansay	(china) son-in law.
hias	ber-hias 1 be decorated, adorned. 2 dress o.s., groom o.s.
hiatus	hiatus.
hiba	see iba.
hibah	bequest, grant (from foundation, etc.).
hibernasi	hibernation.
hibrida	hybrid.
hibuk	see sibuk.
hibur	1 comfort, cheer up, divert. 2 entertain.
hiburan	1 consolation, solace, comfort. 2 entertainment.
hidam	see idam.
hidang	meng-hidang-kan 1 serve (food, drink). 2 present (entertainment, etc.).
hidap	see idap.
hidayah	/hidayat/ (god's) guidance.
hidmat	see khidmat.
hidrat	(chem.) hydrate.
hidrogen	hydrogen.
hidrolik	hydraulic.
hidrolisis	hydrolysis.
hidrolistrik	hydroelectric.
hidrologi	hydrology.
hidrologis	hydrological.
hidu	meng-hidu sniff in, inhale.
hidung	nose.
hidup	1 be alive, live. 2 life. 3 fresh. 4 (coll.) run, go, esp. of machines. 5 long live ! 6 (ling.) prevocalic (of consonants).
hierarki	see hirarki.
higiene	hygiene.
higienis	hygienic.
hih	ugh ! (exclamation of distaste, disgust).
hihi	sound of twittering and giggling.
hii	/hiih/ (china) oh ! (exclamation of terror).
hijarah	(islam) flight of muh. from mecca to medina.
hijau	1 green, verdant. 2 inexperienced.
hijriah	of the islam calendar.
hikayat	1 tale, story, romance. 2 history, account.
hikmah	/hikmat/ 1 wisdom, philosophy. 2 magical power. 3 power in general.
hikwan	(china) fish balls.
hilang	1 be lost, vanish. 2 pass away, die.
hilap	see khilaf.
hilat	see helah.
hilir	lower course, downstream. meng-hilir-mudikkan steer, lead by the nose.
himar	zebra.
himbau	see imbau.
himmah	/himmat/ see hemat 1,2.
himne	a solemn song, often the antherm of an organization.
himpitan	1 be very close together. 2 (math.) coincide.
himpun	assemble, gather.
himpunan	1 association, club. 2 collection, compilation.
hina	contemptible.
hinaan	1 insult, indignity, affront. 2 taunt, gibe .
hinai	see inai.
hindar	1 pull to o. side. 2 avoid (a blow, etc.).
hindia	(lit.) indies.
hindu	see induk.
hinduisasi	hinduization.
hingar	noisy. ke-hingar-bingaran boisterousness.
hingga	until, up to. ber-hingga limited, finite.
hinggap	1 perch, alight. 2 attack (of disease, infection, etc.).
hintai	see intai.
hio	(china) joss stick.
hiolo	(china) incense burner.
hioswa	see hio.
hiperbole	hyperbole.
hiperbolisme	hyperbolism.
hipertensi	hypertension.
hipis	1 young western traveler on a low budget. 2 a style of western-influenced grooming characterized by unkempt hair and clothing.
hipmi	[himpunan pengusaha muda indonesia] indonesian association of young businessmen.
hipnotis	hypnotic. meng-hipnotis hypnotize.
hipnotisir	meng-hipnotisir hypnotize.
hipnotisme	hypnotism.
hipokrasi	hypocrisy.
hipokrit	hypocrite.
hipotea	/hipotesis/ hypothesis.
hipotek	mortgage.
hipotenusa	(math.) hypotenuse.
hipuk	see ipuk.
hirap	disappear, vanish.
hirarki	hierarchy.
hirarkis	hierarchical.
hirau	meng-hirau-kan heed, note, pay attention to.
hiris	see iris.
hiru-biru	see haru-biru.
hiru-hara	see huru-hara.
hiruk	hiruk-pikuk/piruk tumult, hullabaloo, hurly-burly (of the crowd). ke-hiruk-pirukan racket, noise, din.
hirup	whiff, sniff.
his	1. 1) shame ! (exclamation of scorn). 2) shhh ! 2. (coll.) yeast.
hisab	computation, calculation, reckoning. meng-hisab (astr.) calculate, compute. ter-hisab counted.
hisak	see isak.
hisap	see isap.
hisit	(china) shark fin (for soup).
histeri	hysteria.
histeris	hysterical.
histologi	(med.) histology.
histologik	(med.) histological.
historikus	historian.
historiografi	historiography.
historis	historic, historical.
historisitas	historicity.
hit	extremely popular.
hitam	1 black. 2 dark, swarthy.
hitung	(coll.) arithmetic.
hiu	shark.
hiung	meng-hiung whistle.
hiur	see iur.
hiwan	see hikwan.
hkbp	(huria kristen batak protestan] the batak protestant church.
hla	see lha.
hlm.	[halaman] page (of book).
hlo	see lho.
hmi	[himpunan mahasiswa islam] muslim students' association.
ho	oh !
ho,ho.	[hongeroedeem] malnutrition.
hoakiau	/hoakiauw/ overseas chinese.
hobat	see obat.
hobi	1 hobby, s.t. o. likes. 2 like s.t.
hodeng	comportment, the way o. carries o.s.
hofmester	chief musician of a palace (colonial period).
hoho	sound of laughter.
hoi	hey ! (esp. when calling s.o. from afar).
hojat	see hujat.
hokah	hookah.
hoki	(china) good luck.
hokki	field hockey.
hol	(islam) annual, ritual feast to commemorate the dead.
holan	/hollan/ (coll.) netherlands.
holopis	(kuntul baris) yo-heave-ho (exclamation to summon up strength when lifting things).
homo	male homosexual.
homogen	homogeneous.
homonim	homonym.
homonimi	homonymy.
homoseksual	/homoseksuil, homoseks/ see homo.
homoseksualitas	homosexuality.
honar	see onar.
honda	(coll.) motorcycle.
hong	1. (sport) home base. 2. earthen pipe for drainage. 3. see burung.
hongaria	hungary.
hongeroedeem	/hongerudim/ malnutrition, undernourishment.
honggi	see hongi.
honghouw	(china) empress.
hongi	punitive 17th-century expeditions by dutch in the moluccas to extirpate spice trees.
hongsi	(cina) rheumatism.
honor	/honorarium/ 1 honorarium, stipend. 2 payment for services.
honorer	1 honorary. 2 not officially confirmed (in o.'s job) and so paid by stipends not salary.
honorifik	honorific.
hooi	see hoi.
hop	1. (coll.) head, chief. 2. stop ! whoah ! (exclamation only).
hopbiro	(coll.) central (gvt.) office.
hopeng	/hoping/ (china) close friend.
hopyes	hard coffee-flavored caramel.
horas	greetings ! long live ! (batak greeting).
horden	/hordeng/ curtains, drapery.
hore	hurrah ! hurray !
horison	horizon.
horisontal	horizontal.
hormat	1 honor, respect, esteem. 2 respectful.
hormon	hormone.
horn	/horen/ ice-cream cone.
horoskop	horoscope.
hortikultura	horticulture.
hortikulturis	horticulturist.
hoskut	houscoat, dressing gown.
hospes	(biol.) viral or bacterial host.
hospital	hospital.
hospitalisasi	hospitalization.
hostes	1 taxi dancer, bar waitress. 2 prostitute.
hosti	(rel.) host, consecrated wafer.
hot	(coll.) 1 sexy. 2 sexually aroused. very popular.
hotdog	sandwich in hot dog bun.
hotel	hotel.
houder	cartridge pouch or box on soldier's belt.
hower	k.o. artillery piece.
hoyak	see oyak 2.
hoyong	see huyung.
hph	[hak pengusahaan hutan] logging concession.
hr.	[harian] daily newspaper.
hrs.	[harus] must.
huap	see suap.
hubaya-hubaya	make sure that...., above all, by all means.
hubung	connect, related.
hubungan	1 connection, relationship. 2 contact. 3 context. 4 coupling (in poetry).
huduh	see odoh.
huh	ha ! (exclamation of derision, scorn, etc.).
hujah	proof, evidence. berhujah argue, adduce arguments.
hujan	rain.
hujat	blasphemy.
hujung	see ujung.
huk	1. (sport) hook. 2. (coll.) 1) corner (of room). 2) intersection.
huk-huk	1 sound of coughing. 2 coughing.
hukum	1 law. 2 verdict.
hukuman	1 punishment 2 prisoner .
hulam	see ulam.
huler	rice huller.
hulu	1. 1) upper course (of river). 2) beginning of s.t. (in set phrases). peng-hulu see penghulu. 2. 1) upper end (of a pole). 2) hilt. 3) top of head, head (in certain phrases only).
hulubalang	1 commander, war chief. 2 district chief (in aceh).
hulur	see ulur 1.
huma	1 field for dry rice cultivation. 2 newly cleared land for agriculture.
humaniora	the humanities.
humanisme	humanism.
humas	[hubungan masyarakat] public relations.
humbalang	see hembalang.
humor	joke.
humoris	humorist.
humoristis	humorous.
hun	(china) unit of measure for weight (1/10 tael) or lenght (1/12 inch).
huncue	(china) tobacco pipe.
huni	occupy, dwell or reside in.
hunjam	stuck, inserted.
hunjuk	see unjuk.
hunkwe	k.o. gelatin made from mung bean flour.
hunus	unsheathed (sword, dagger).
hunyi	see huni.
hup-hup	exclamation to encourage o. to jump.
hura	hooray ! (exclamation of pleasure, delight). ber-hura shout hurrah.
hura-hura	(sl.) not to be taken seriously.
huriah	(sumatra) district.
huru-hara	1 disturbance. 2 hurly-burly. 3 riot.
huruf	letter, characters.
hurufuah	see harfiah.
hurung	see urung.
hurup	see huruf.
hus	hush ! be quiet !
husap	see usap.
husaren-sla	k.o. vegetable and fruit salad with mayonnaise and sometimes bits of cold meats.
huse	hurrah !
hussain	(islam) grandson of muh. martyred in religious war. hussain's and his brother hassan's deaths are commemorated on asyura.
hustis	see hostes.
husuk	see khusyu.
husus	see khusus.
husy	see hus.
hut	(zod.) pisces.
hutan	woods, forest.
hutang	debt, obligation.
hutangan	having a debt.
huyung	ter-huyung-huyung stagger, falter.
hvs	[houstvrij schrijfpapier] bond paper of 60-100 gram thickness (lit., bondpaper free of wood).
hwa-hwe	(china) popular game of numbers for gambling.
hwee	(cina) association.
hyang	tittle of authochthonous or hindu deity. wisnu vishnu.
hydrolistrik	see hidrolistrik.
hygiene	see higiene.
hygienis	see higienis.
hyperbolis	hyperbolic.
hypertensi	see hipertensi.
hypnotisir	see hipnotisir.
i	i, the 9th letter of the alphabet.
i'gris.	[inggeris] england, english.
ia	1. (lit.) he, she, it. 2. yes.
iain	[insitut agama islam negeri] gvt. institute for islam studies.
ialah	is, are (in formal statements of equivalence).
iau	see ngiau.
ib	[irian barat] irian jaya (indonesian new guinea).
iba	1 pity, compassion. 2 moved, touched, compassionate.
ibadah,ibadat	1 act of devotion. 2 religious service.
ibah	see hibah.
ibarat	1 like. 2 simile, metaphor.
ibing	(sunda) meng-ibing dance a traditional dance with a woman who is a professional entertainer. peng-ibing female entertainer who dance with men in the audience.
iblis	devil, satan.
ibni,ibnu	see bin.
ibrani	(lit.) hebrew.
ibrit	see ngibrit.
ibtida	(lit.) beginning.
ibtidaiyah	(islam) primary school.
ibu	1 mother. 2 form of address to older woman or o. in higher position, i.e. teacher, employer, etc., esp. as bu. 3 lady, woman of high standing. 4 most important or main part of s.t. feminine, motherly. per-ibu-an matriarchal.
ibuk	see sibuk.
ibul	k.o. large thornless palm that yields poisonous fruit.
ibunda	(lit.) mother (used in letters).
ibus	k.o. palm whose leaves are used for plaiting mats, etc.
icak-cole	defaulter on payments.
icak-icak	1 pretend, act as if. 2 fake, spurious.
icip	icip-icip food sample. meng-icip(i) taste, try.
id	(islam) holiday (in the names of certain celebrations).
ida	(bali) title of nobility.
idah	1. gift to establish ties of love between men and women, love token. meng-idah-kan a gift as an introduction to courtship. 2. see iddah.
idam	1 craving. 2 craving of pregnant woman for special foods. 3 desire, aspiration.
idang	see hidang.
idap	meng-idap 1 ail, be ill over a long period. 2 contract (a disease).
idayat	see hidayah.
iddah	(islam) 100-day waiting period before a widow or divorced woman may remarry.
ide	idea.
ideal	ideal.
idealis	idealist.
idealisasi	idealization.
idealisir	meng-idealisir idealize.
idealisme	idealism.
idealistis	idealistic.
idem	idem, same as what went before.
identifikasi	identification.
identifisir	meng-identifisir identify.
identik	identical.
identitas	1 identity. 2 identification.
ideologi	ideology.
ideologis	ideological.
idep	eyelash.
idep-idep	better to do (so-and-so) than...
idi	[ikatan dokter indonesia] indonesian physicians association.
idih,idii	ugh !, exclamation expressing distaste.
idil	see idul.
idin	see izin.
idiom	idiom.
idiomatis	idiomatic.
idola	popular idol.
idul	(islam) idul adha/korban feast of the sacrifice, the day that commemorates the sacrifice of ismail by ibrahim, a holy day associated with the pilgrimage to mecca. idul-fitri feast celebrating the end of fasting period.
idung	see hidung.
idup	see hidup.
idzin	see izin.
ied	see id.
ifaf,iffah	(islam) sexual abstinence.
ifitah	(islam) opening prayer.
ifrit	evil spirit.
iftar	(islam) ending of fast.
iga	(java) rib.
igal	dancing.
igama	see agama.
igau	meng-igau 1 talk in o.'s sleep. 2 be delirious, rave.
igel	see igal.
ih	ugh, exclamation showing disgust.
ihlas	see ikhlas.
ihram	(islam) consecration for use in the pilgrimage to mecca.
ihsan	1 good deeds. 2 charity.
ihtiar	see ikhtiar.
ihtilam	nocturnal emission.
ihtimal	meng-ihtimal-kan 1 order s.o. to do. 2 assign a task to.
ihwal	see hal 1.
ii	see hii.
ijab	1 final offer. 2 agreement, consent. 3 answerto prayer.
ijabah,ijabat	approval.
ijajah	see ijasah.
ijajil	devil.
ijasah,ijazah	1 diploma. 2 certificate to practice a profession. ber-ijazah licensed, certified.
ijen,ijin	see izin.
ijma,ijmak	1 (islam) consensus of opinion among scholars. 2 unanimous agreement or approval.
ijmal	resume, summary.
ijo	1. 1) buy rice from a farmer by paying for in long before the harvest. 2) give a scholarship to o. who promises to work for the donor after graduation. 2. see hijau.
