ijon	1. 1 buy rice from a farmer by paying for in long before the harvest. 2 give a scholarship to o. who promises to work for the donor after graduation.
ijtihad	1 individual interpretation and judgment. 2 personal examination of s.t. 3 diligence, effort.
ijtima	astral conjunction.
ijuk	1. palm fiber from the sugar palm. meng-ijuk bristly (of mustache). 2. ter-ijuk embarrassed, abashed, ashamed.
ik	(coll.) i.
ika	see eka.
ikal	1 curl, lock. 2 curly, wavy.
ikamat	(islam) final call to prayer.
ikan	1 fish. ikan-asin salted fish. ikan-buntal puffer fish. ikan-cuik steamed, salted fish. ikan-hiu shark. ikan-lele freshwater catfish ikan-lumba-lumab dolphin. ikan-mas goldfish, carp. ikan-julung-julung garfish. ikan-salam/salem salmon. 2 meat.
ikat	1 string, cord to tie. 2 bunch, bundle, sheaf. 3 band. 4 method of tie-dying material being woven.
ikel	see ikal.
iket	see ikat.
ikhlas	sincere, with all o.'s heart and soul.
ikhtiar	1 initiative. 2 free choice, decision. 3 course, means of action.
ikhtiari	optional.
ikhtilaf	1 difference, divergence, discrepancy. 2 deviation.
ikhtirafan	recognition.
ikhtisar	1 summary, recapitulation. 2 synopsis, abstract, outline.
ikhtisariah	succinct, brief.
ikhwal	see hal 1.
ikhwan	1 brother, comrade. 2 fraternal, brotherly.
ikip	[institut keguruan ilmu pendidikan] teachers' training college.
ikke	(coll.) i, me, my.
iklan	advertisement.
iklanisasi	commerialization of publications. per-iklanisasi-an advertising.
iklas	see ikhlas.
iklim	1 climate. 2 climate (political, etc.).
iklimatisasi	acclimatization.
ikonis	iconic.
ikonografi	iconography.
ikrab	see akrab.
ikrar	promise, pledge, declaration of intent.
iktibar	see itibar.
iktidal	(islam) proper standing posture when performing prayer ritual.
iktikad	see itikad.
iktikal	religious retreat.
iktisab	legal profit.
iktisad	(lit.) economy, economic matters.
ikut	1 follow, go along. 2 participate, join (in), also do. 3 stay with s.o. in his or her house. 4 be a follower or servant of s.o.
ilah	a god. ber-ilah athheistic, godless. meng-ilah-kan deify. ke-ilah-an divinity, godliness.
ilahi	(islam) god (in set expression).
ilahiat	godliness, divineness.
ilai	meng-ilai-ilai 1 neigh. 2 laugh uproariously.
ilalang	see alang-alang.
ilam-ilam	hazy, vague, barely visible.
ilang	see hilang.
ilanun	see lanun.
ilar	see iler.
ilas	meng-ilas squash, crush, or mash underfoot.
ilas-ilas	k.o. small tuber.
ilat	physically handicapped, physical defect.
ilat-ilat	k.o. sole or flounder.
iler	slobber, spittle. iler-an drool.
iles	see ilas.
iles-iles	see ilas-ilas.
ilham	1 divine inspiration. 2 inspiration, brainstorm.
ilir	see hilir.
illustratif	illustrative.
ilmiah	scientific.
ilmiawan	scientist, scholar.
ilmiyah	see ilmiah.
ilmiyawan	see ilmiawan.
ilmu	1 knowledge. 2 science, branch of science. 3 esoteric knowledge. ber-ilmu learned, erudite, scholarly.
ilmuwan	see ilmiawan.
ilusi	illusion. ber-ilusi have illusions.
ilustrasi	illustration.
image	see imaj.
imaginatif	imaginative.
imaj	/imej/ image.
imajinasi	imagination.
imajinatif	see imaginatif.
imajiner	imaginary.
imak	meng-imak-imak-i mock, parrot s.o.
imam	1 (islam) leader of communal prayer. 2 title of chief of an islam state. 3 catholic priest.
imamat	1 leadership. 2 priesthood.
iman	1 faith, belief, creed. 2 confidence, belief in s.t. ber-iman faithful, believing.
imanen	immanent.
imani	/imaniah/ religious, pious.
imbak	meng-imbak-imbak image, dream of.
imbal	1 lopsided, askew, awry. 2 unbalanced, off balance. imbal-an repayment for s.t. good.
imbang	1 balance. 2 match, equal.
imbas	1 air current. 2 (phys.) electrical current. se-imbas at first glance, superficially.
imbau	appeal.
imbo	built in.
imbuh	1 supplement. 2 extra, small addition given in the bargain to please a customer. imbuh-an s.t. extra given. 2 (ling.) affix.
imej	see imaj.
imigran	immigrant.
imigrasi	1 immigration. 2 bureau of immigration.
iming	meng-(iming-iming) tantalize, entice. meng-iming-kan use s.t. to entice.
imitasi	imitation.
imka	[ikatan masehi kepemudaan am] ymca.
imla	/imlah, imlak/ dictation.
imlek	1 china calendar. 2 china new year.
imobilitas	immobility.
imoral,imoril	immoral.
impak	/impek/ impact.
impas	1. impase, deadlock. 2. 1) paid off (of debt). 2) squeare, equal.
impek	see impak.
imperalis	imperialist.
imperatif	imperative.
imperialisme	imperialism.
imperialistis	imperialistic.
imperium	empire.
impersonalitas	impersonality, impersonal character.
impi	meng-impi dream, hope. meng-impi-kan dream of. impi-an dream, vision, wish.
impit	see himpit.
implemen	implement, tool.
implementasi	implementation.
implikasi	implication.
implisir	meng-implisir 1 implicate. 2 imply.
implisit	implicit.
impor	import. meng-impor import, bring in. peng-impor importer.
importir	importer.
impoten	impotent.
impotensi	impotence.
imprealisme	see imperialisme.
impregnasi	impregnation.
impresaris	impresario.
impresi	impression.
impresif	impressive.
impresionis	impressionist.
imprialis	see imperialis.
improvisasi	improvisation. ber-improvisasi improvise.
improvisator	improviser.
impuls	impulse.
impulsif	impulsive.
impun	see himpun.
imrovisir	meng-improvisir improvise.
imsak	(islam) predawn, time that the fast must begin.
imsakiah	(islam) fasting calendar.
imun	(med) immune.
imunisasi	(med) immunization.
imunitas	(med.) immunity.
imunologi	(med.) immunology.
in-absentia	/in absensia/ in absentia.
inai	1 henna. 2 red nail polish. ber-inai have o.'s nails stained with henna (in preparation for marriage ceremony). meng-inai apply henna to the fingernails.
inang	1 wet nurse, nursemaid. 2 (m) female trader. inang-inang 1 mistress. 2 (north sumatra) female pedler of smuggled goods.
inap	meng-inap spend the night, stay overnight.
inas	carbuncle on nape of neck.
inaugurasi	inauguration.
inayah,inayat	help, aid, assistance.
incang	meng-incang 1 aim at. 2 peek.
incang-incut	1 zigzag. 2 askew, not of equal length (of things that are supposed to be equal, e.g. chair legs).
incar	drill, borer.
incaran	1 aim (of gun, etc.). 2 target, thing aimed at.
incek	tread on s.t.
inci	inch.
incir	see incar.
incit	be off ! go away !
incrit-incrit	dole out.
incut	1. lame, crippled. 2. see incang-incut.
indah	1. meng-indah-kan heed, pay attention to. per-indah-an appreciation, interest. 2. 1) beautiful, attractive, handsome. 2) precious, valuable. mem-er-indah 1) beautify. 2) embelish. ke-indah-an beauty.
indang	meng-indang winnow (rice).
indap	see endap 1,2.
indar	see hindar.
indarus	(sport) cock that has been defeated and forfeited to the winner.
indayang	coconut palm frond.
indehoi	/indehoy/ have sex or pet heavily. ber-indehoi engage in sexual activity. indehoi-an be on a heavy date, be making out with e.o.
indek	see indeks.
indekos	rent room and board. have s.o. rent a room s.w.
indeks	1 index. 2 (econ.) price increase.
indeksasi	(econ.) indexing.
inden	1. pivot. 2. partially prepaid.
indentifikasi	see identifikasi.
indentitas	see identitas.
indentor	1 o. who orders s.t. prepaid. 2 depositor.
independen	independent.
indera	1. 1) the god indra. 2) the gods. ke-indera-an (lit.) the heavens, abode of the gods. 2. o. of the five senses. peng-indera-an sensation, sensory perception.
inderaloka	(lit.) the abode of the gods.
inderia	o. of the five senses. sensation.
index	see indeks.
indian	american indian.
indik	meng-indik approach crawling or bent over.
indikasi	1 indication. 2 suspicion that s.o. is a communist.
indikator	indicator.
inding	meng-inding 1 listen attentively for s.t. 2 be on the lookout for, lie in wait for.
individu	an individual.
individual	individual.
individualisasi	individualization.
individualisir	meng-individualisir individualize.
individualisme	individualism.
individualistis	individualistic.
individualitas	individuality.
individuil	see individual.
indo	a eurasian. indo belanda o. who is of dutch and indonesian parentage.
indoktrinasi	indoctrination.
indoktrinator	indoctrinator.
indoktrinir	meng-indoktrinir indoctrinate.
indologi	indonesian studies.
indonesia	1 indonesia, indonesian. 2 indonesian language.
indonesianisasi	indonesianization.
indonesianisme	indonesianism.
indra	see indera 1.
indrawi	sensory.
indria	see inderia.
induk	1 mother (us. only for animals). 2 chief, main, prime. 3 s.t. that can be regarded as a mother, thing from which s.t. else descends, the essence of a substance from which a large amount develops. per-induk-an brood, family.
induksi	induction. induce.
induktif	inductive.
indulgensi	indulgence.
indung	1 mother (of animals). 2 the thing from which s.t. else springs.
indusemen	inducement.
industri	industry. industry, industrial affairs.
industrialis	industrialist.
industrialisasi	industrialization.
industrialisir	meng-industrialisir industrialize.
industriawan	industrialist.
industriil	industrial.
industriwan	see industriawan.
inefisiensi	inefficiency.
inep	see inap.
inersi,inertia	/inersia/ inertia.
infanteri	infantry.
infark,infarkt	(med.) infarct.
infeksi	infection.
infertil	(med.) infertile.
infiks	(ling.) infix.
infiltran	infiltrator.
infiltrasi	infiltration. ber-infiltrasi infiltrate, carry out infiltration.
infiltrir	meng-intfiltrir infiltrate s.t.
infinitif	(ling.) infinitive.
inflasi	(econ.) inflation.suffer from inflation.
inflatoir	(econ.) /inflatwar/ inflationary.
infleksi	(ling.) inflection.
influensa	influenza.
info	see informasi.
informan	informant, source.
informasi	information. meng-informasi inform s.o.
informatif	informative.
informil	informal. ke-informil-an informality.
infrastruktur	infrastructure.
infus	(med.) meng-infus give an infusion or intravenous feeding.
infusi	infusion.
inga	ter-inga-inga 1 dazed, lost in thought. 2 surprised.
ingar	see hingar.
ingat	1 remember, recall. 2 attentive, careful. 3 plan, intend.
ingatan	1 memory, remembrance. 2 thought, idea, notion, purpose.
ingau	see igau.
inggang-inggung	stagger, totter.
inggeris	england, english. ke-nggeris-inggeris-an anglicized.
inggih	(java) yes (to s.o. of higher position).
inggris	see inggeris.
inggu	1. asafetida. 2. k.o. coral fish.
inggung	see inggang-inggung.
ingin	wish, desire. ke-ingin-tahuan curiosity.
ingkar	1 reluctant. 2 refuse, fail to keep o.'s word.
ingkel	meng-(ingkel-ingkel) 1 tease, pester. 2 oppress, maltreat, torture.
ingko	see engko.
ingsut	ber-ingsut shift, move slowly.
ingus	nasal mucus, snot.
ingusan	1 runny-nosed. 2 inexperienced.
inhalasi	inhalation.
inheren	inherent.
inhibisi	inhibition.
ini	1 this, these. 2 now. 3 this (coming period of time). 4 here (in introductions). 5 hesitation word when o. does not wish to plunge directly into s.t.
inisial	1 initial. 2 initials.
inisiasi	inisiation. meng-inisiasi-kan inisiate.
inisiatif	initiative.
inisiator	o. who initiates s.t.
injak	injak-injak 1 pedal (esp. for gas in cars). 2 stirrup. 3 running board.
injap	having spikes turned inward (of traps that permit entrance, but make egress impossible).
injeksi	(med.) injection.
injil	1 (bib.) gospel. 2 (bib.) new testament. 3 (islam) the sacred book revealed to the prophet jesus. peng-injil evangelist, preacher.
injili,injiliah	evangelical.
injin	(coll.) engine.
inkarnasi	incarnation. meng-inkarnasi-kan incarnate.
inkaso	payment, collection, cashing of a check.
inklaring	banking clearance.
inklinasi	inclination.
inklusif	inclusive.
inkompatibilitas	incompatibility.
inkonsekwensi	inconsistency.
inkonstitusional	/inkonstitusianil/ unconstitutional.
inkonvensional	/inkonvensionil/ unconventional.
inkorporasi	incorporation. meng-inkorporasi-kan incorporate.
inkubasi	incubation.
inkubator	incubator.
inkuisisi	inquisition.
inlander	indigene (during colonial times, often derog.).
inmas	[intensifikasi massal] program of agricultural intensification on a massive scale.
innalillahiwainnailaihiraji'un	(islam) we are truly allah's and to him we return (in obituaries and eulogies).
inokulasi	inoculation.
inovasi	innovation.
inovatif	innovative.
inpentaris	see inventaris.
inplensa,inplinsa	see influensa.
inporman	see informan.
inpres	[instruksi presiden] presidentaial directive.
inreyen	meng-inreyen break in a motor or motorized vehicle.
insaf	insaf-akan realize, understand. meng-insaf-i realize, be aware of.
insan	man, human being. ke-insan-an being a person, o.'s humanity.
insang	fish gills.
insani	/insaniah/ human.
insektisida	insecticide.
inseminasi	insemination.
insentif	incentive.
insersi	insertion.
inseting	see insting.
insiden	incident.
insidensi	incidence.
insidentil	incidental.
insinuasi	insinuation. meng-insinuasi-kan insinuate.
insinye	badge, identifying button.
insinyur	engineer. ke-insinyur-an engineering.
insisi	incision.
inskripsi	inscription.
insolvensi	insolvency.
inspeksi	1 inspectorate. 2 inspection.
inspektorat	inspectorate.
inspektur	inspector.
inspirasi	inspiration. meng-inspirasi-kan inspire.
instalasi	1 installation (of the new chairman, etc.) 2 installation.
instalatur	installer, fitter, electrician.
instansi	1 (leg.) level of a court's jurisdiction, instance. 2 institute, agency.
insting,instink	instinct.
institusionalisasi	institutionalization.
institusionil	institutional.
institut	institute.
instruksi	1 instruction, directive. 2 briefing.
instruktur	instructor.
instrumen	instrument.
instrumental	instrumental.
instrumentasi	instrumentation.
insubordinasi	insubordination.
insya-allah	(islam) god willing.
insyaf	see insaf.
intai	meng-intai 1 spy on, watch surreptitiously. 2 lurk, lie in wait.
intaian	place from which o. can spy.
intan	diamond.
integraitas	integrity.
integral	integral.
integrasi	integration.
integratif	integrative.
integrir	meng-integrir integrate.
intel	1 intelligence (service). 2 intelligence agent, informer. 3 agent provocateur.
intelek	intellect.
intelektual	intellectual.
intelektualisme	intelectuallism.
intelektuil	intellectual.
inteligensi	/inteligensia/ intelligence.
intelijen	/intelijens/ 1 intelligence, intelligent. 2 intelligence service.
intendan	/intendans/ (mil.) quartermaster.
intens	intense.
intensi	intention.
intensif	intensive. meng-intensif-kan intensify.
intensifikasi	intensification.
intensitas	/intensitet/ intensity.
interaksi	interaction. ber-interaksi interact.
interdependensi	interdependence.
interen	see intern.
interes	interest in s.t.
interesan	interesting.
interferensi	interference.
interim	interim.
interinsuler	interinsular.
interiur	interior.
interjeksi	interjection.
interkom	intercom.
interlokal	(tel.) long distance call, make a long distance call.
intermeso	intermezzo.
intern	1 internal, domestic. 2 within the local school and not at national level (e.g. of examinations).
internasional	international. meng-internasional-kan make s.t. up to international standards. ke-internasional-an on an international scale.
internasionalisasi	internationalization.
internasionalisme	internationalism.
internat	dormitory, esp. in the colonial period.
internir	meng-internir intern, imprison.
interniran	1 internee. 2 internment camp.
internis	(med.) internist.
internit	see eternit.
interogaif	interrogative. 2 questioning.
interogasi	interrogation. meng-interogasi interrogate.
interpelan	(leg.) questioner.
interpelasi	(leg.) interpellation.
interpiu	see interviu.
interpolasi	interpolation. meng-interpolasi-kan interpolate.
interpretasi	interpretation. meng-interpretasi-kan interpret, construe.
intertip	intertype.
interupsi	interruption. meng-interupsi interrupt.
intervensi	intervention.
interviu	interview.
inti	1 kernel, nucleus. 2 gist, core. 3 filling, contents (of pie, etc.). meng-inti-sarikan make an abstract of.
intikad	(lit.) criticism.
intil	meng-intil follow on s.o.s' heels.
intim	intimate, close (friend, etc.).
intimidasi	intimidation. meng-intimidasi intimidate.
intip	meng-intip(i) spy on, pep at. peng-intip-an spying, surveillance.
intisari	see inti.
intoleran	intolerant.
intonasi	intonation.
intra	see intra-universiter.
intra-universiter	intrauniversity.
intransitif	(ling.) intransitive.
intrik	intrigue, conspiracy, plot. meng-intrik engage in intrigue.
intrikatif	full of intrigues.
introduksi	introduction.
introdusir	meng-introdusir introduce.
introspeksi	introspection.
introversi	introversion.
intrusi	intrusion.
intuisi	intuition.
intuitif	intuitive.
invalid	/invalide/ invalid, o. who is sickly.
invasi	invasion.
inventaris	inventory, list of stock in a store. peng-inventaris-an inventorying.
inventarisasi	stock taking. inventory, take stock.
inventarisir	meng-inventarisir to inventory.
inversi	inversion.
investasi	(fin.) investment. meng-investasi(kan) invest.
investigasi	investigation.
investor	investor.
invitasi	1 invitation. 2 (sport) invitational (tennis, golf, etc.).
inyeksi	see injeksi.
ionis	(chem.) ionic.
ionisasi	(chem.) ionization.
ionosfer,ionosfir	(phys.) ionosphere.
ipa	(ilmu pasti /alam) mathematical and natural sciences.
ipar	brother, sister, or cousin-in-law. per-an, ke-an relationship through marriage.
ipb	[institut pertanian bogor] bogor institute of agriculture.
ipeda	[iuran pembangunan daerah] land or crop tax for regional development.
ipil-ipil	k.o. tree, lamtoro, a rapidly growing leguminosa planted as a shade tree for coffee plants and for firewood and animal fodder.
iprit	1. meng-iprit run away out of fear. 2. (sunda) marry a beautiful woman who is in reality a supernatural snake that can make her husband rich.
ips	[ilmu pengetahuan sosial] social studies.
ipuh	1 k.o. tree, the sap of which is used as poison for weapon tips. 2 the poison from this tree. 3 vicious (of person). ber-ipuh having this poison applied to it.
ipuk	meng-ipuk grow, cultivate. ipuk-an seedling. peng-ipuk-an seedbed.
ir.	[insinyur] title of o. who has received an engineering degree.
ira	1 section (of lemon, orange, durian). 2 sinew (in meat). 3 grain (in wood).
iradah,iradat	(islam) willof god.
iram	change color, turn pale.
irama	rhythm, cadence.
iras	similar.
irasional	/irasionil/ irrational.
irat	thin strip (of bamboo, etc.).
irbar	[irian barat] indonesian (w.) new guinea.
ireda	[iuran rehabilitasi daerah] a tax on commercial properties for regional rehabilitation.
irelevan	irrelevant.
iri	jealous of s.o.'s attainment or status, full of envious resentment. peng-iri o. who easily becomes jealous.
irian	new guinea. irian-barat/jaya indonesian new guinea. irian-timur papua new guinea.
irid	see irit 1.
irigasi	irrigation. meng-irigasi-kan irrigate.
irik	meng-irik thresh by stamping with the feet. ter-irit get sifted out. peng-irit a fail.
iring	accompany, escort, go along.
irit	1. economical, frugal. meng-,meng-kan economize on, save. 2. see eret.
iritasi	irritation.
irja	[irian jaya] indonesian new guinea.
ironi	irony.
ironis	ironic.
irup	see hirup.
irus	1 ladle made of a coconut shell. 2 ladle.
isa	1. see sembahyang. 2. (coll.) see bisa 1. 3. (islam) jesus.
isak	sob.
isang	see insang.
isap	meng-isap 1 suck. 2 smoke. 3 absorb (liquid).
isapan	s.t inhaled or sucked .
isarah,isarat	see isyarat.
isbat	1 confirmation, ratification. 2 positive.
iseng	do s.t. for fun, do s.t. without any serious purpose. iseng-iseng 1 do s.t. just to amuse o.s. 2 casually, leisurely.
isi	1 contents. 2 volume, capacity, content 9of barrel, jar, etc.) 3 substance. 4 the people who live in a certain place. meng-isi fill up.
isim	1 (islam) o. of god's names or attributes. 2 (ling., in old or arab-style grammars) nominal.
isin	(java) shy, embarrassed, ashamed.
isit	gums.
islah	settlement of a dispute.
islam	islam.
islamisasi	islamization.
ism	see isim.
isme	ism.
isnin	see senen.
isolasi	1. cellophane tape. 2. isolation. isolate.
isolasionisme	isolationism.
isolemen	isolation.
isolir	meng-isolir-kan 1 isolate. 2 (elec.) insulate.
isomorfis	isomorphic.
isotop	(chem.) isotope.
israfil	(islam angel of great size who will blow the trumpet on the last day.
israk,isrok	(islam) muh.'s miraculous flight from mecca to jerusalem.
issue	see isu.
istal	horse barn, stable.
istana	palace, castle. ber-istana dwell in a palace.
istanggi	see setanggi.
isteri	see istri.
istiadat	custom, tradition. meng-istiadat-kan institute s.t. as a custom.
istibra	(islam) period of sexual abstinence for a woman after divorce or widowhood so that there may be no question of the paternity of a baby she might be carrying.
istigfar	utter astaghfirullah to ask god's forgiveness thereby. ber-istigfar utter this formula.
istilah	technical term. per-istilah-an terminology.
istimal	utilization.
istimewa	1 special, extraordinary, different from others. 2 special, better than normal.
istinja	(islam) cleansing after defecation and urination or before ritual ablution.
istiqlal	liberty, freedom, independence.
istirahat	1 rest. 2 pause, break, intermission, recess.
istri	wife, married woman. ber-istri have a wife, be married ( of a man).
isu	1 issue, problem. 2 rumors.
isya	see sembahyang.
isyarat	sign, signal.
isytihar	proclamation. meng-isytihar-kan proclaim.
isyu	see isu.
itam	see hitam.
itb	[institut teknologi bandung] bandung institute of technology.
itibar	/i'tibar/ (islam) lesson, example, comparison.
itidal	/i'tidal/ (islam) symmetry, equilibrium.
itik	1. duck. 2. meng-itik-air liur make s.o. drool for s.t., stimulate a desire to eat s.t.
itikad	/i'tikad/ 1 conviction. 2 determination, will. meng-itikad-kan convince s.o.
itil	(vulg.) clitoris.
itlak	acceptance of a theory without examination. meng-itlak-kan generalize.
ittifak	(islam) agreement, compromise.
itu	1 that, those. 2 the. 3 there. 4 hesitation word when o. cannot find the right word. 5 clause marker : when, if, in the particular case that, at the particular time that.
itung	see hitung.
iur	ber-iur contribute.
iuran	1 contribution. 2 subscription, levy. 3 premium (insurance, etc.) 4 dues.
iya	see ia 2, ya 1.
iyal	dependants.
iyuran	see iur.
izin	1 permission. 2 permit, license, franchise (to operate bus line, etc.) 1 permit, allow. 2 license s.o. or s.t.
j	j, the 10th letter of the alphabet.
ja	see saja.
jab	/jep/ (sport) jab (in boxing).
jabal	1. mountain. men-jabal loom large (of mountain, etc.) 2. men-jabal 1) rob, mug. 2) steal from s.o.
jabang-bayi	(java) 1 newborn baby. 2 exclamation of great surprise.
jabar	[jawa barat] west java.
jabat	ber-jabat(an) tangan shake hands.
jabatan	1 function is to take care of foreign visitors. 2 position, post.
jabel	see jabal 2.
jabil-jabil	ber-jabil slovenly, sloppy (of clothes).
jabotabek	[jakarta bogor tangerang bekasi] the megapolis of jakarta and its satellite cities.
jabung	resin.
jabur	see zabur.
jaburan	1 snaks, sweet tidbits. 2 (islam, java) light repast for congregation after evening prayers during fasting month.
jada	see juadah.
jadah	anak-jadah illegitimate child. men-jadah-kan anak father an illegitimate child.
jadajat	(zod.) capricorn.
jadam	k.o. strong laxative.
jadi	1 become, get. 2 so, therefore, thus, hence. 3 end up doing s.t. 4 work (out), become effective, come off. 5 finished, accomplished. 6 be, serve or work as.
jadi - jadian	1 an animal with supernatural powers which is owned by s.o and visible only to its owner 2 imitation .
jadinya	1 outcome 2 consequently .
jadwal	1 schedule. 2 table, list.
jaga	1 wake up. 2 guard, watchman. 3 be on duty (of physician, pharmacist, etc.). 4 preserve. 5 be on the lookout for.
jagabaya	(java) village constable.
jagad	see jagat.
jagal	1. small-scale trader. ber-jagal trade in retail goods, hawk wares. jagal-an small wares. 2. butcher, slaughterer. pe-jagal-an abatoir, slaughterhouse.
jagang	1. support, prop, stand, pole (used for support). 2. moat.
jagat	world. se-jagat universal, world-wide.
jago	1 cock, rooster. 2 gamecock. 3 champion, athlete. 4 (pol.) candidate. 5 charismatic leader of a group.
jagorawi	[jakarta bogor ciawi] expressway between jakarta and ciawi via bogor.
jagung	1. corn, maize. men-jagung sprout (of rice, acne, etc.). 2. [jaksa agung] attorney general.
jagur	robust, sturdy, big for o.'s age. ki-, si- jagur name of the sacred cannon in jakarta.
jahan	k.o. catfish.
jahanam	1 (rel.) hell. 2 (vul.) a strong oath.
jahat	bad, wicked, evil.
jahe	gingger.
jahid	see zahid.
jahil	1. 1) stupid, ignorant, unenlightened. 2) (islam) ignorance of religion's teachings. 3) cruel. 4) rascal, scamp. 2. see jail.
jahiliah	(islam) age of pagan ignorance preceeding the islam era.
jahit	sewing.
jail	/ja'il/ mischievous, sneaky. men-jail-i mistreat, pick on s.o.
jailangkung	device used in a seance : a straw man into whice the spirit of a departed person not personally familiar to the audience has entered: this is fitted with s.t. to write responses to questions.
jaitun	see zait.
jaiz	(islam) allowed but not required.
jaja	ber-, men-jaja hawk, peddle, vend. jaja-an merchandise that is peddled. pen-jaja hawker, peddler.
jajag	see jajak.
jajah	men-jajah 1 colonize, take over (a country). 2 traverse, tour. jajah-an 1 colony, subjugated territory. 2 (lit.) district. pen-jajah colonizer.
jajak	men-jajak-i probe, sound out. 2 (naut.) fathom, take soundings, plumb.
jajal	men-jajal try, test.
jajan	1 a sweet, anack. 2 eat snacks. 3 (humorous) patronize a prostitute (of married men). jajan-jajan-an various k.o. snacks.
jajar	1. row, line.
jajaran	1 row, line. 2 series. 3 array.
jajat	imitation. men-jajat imitate.
jaka	bachelor. jaka-tingting (java) young man who has never had sex. keper-jaka-an bachelorhood.
jakal	jackal.
jakar	see zakar.
jakas	k.o. pandanus tree.
jakat	see zakat.
jakbar	[jakarta barat] west jakart.
jaket	jacket, sport coat.
jakpot	jackpot.
jakpus	[jakarta pusat] central jakarta.
jaksa	(leg.) public prosecutor, district attorney.
jaksel	[jakarta selatan] south jakarta.
jaktim	[jakarta timur] east jakarta.
jakum,jakun	adam's apple.
jakut	[jakarta utara] north jakarta.
jala	net, esp. a hand-held casting net. men-jala fish with a casting net.
jalad	frost, cold air.
jalak	vrious k.o. starling and mynas.
jalan	1 road, path, street. 2 course s.t. follows. 3 way, manner. 4 course. 5 be going on, be approaching. 6 lineal family relation. 7 pass, go.
jalang	wild, untamed, undomesticated (of animals).
jalangkung	see jailangkung.
jalar	creeping (vines).
jalaran	climbing pole.
jali	see tajali.
jali-jali	1 k.o. grass which produces hard edible seeds : job's tears. 2 name of popular song of old batavia.
jalil	(islam, in fixed phrases only) sublime, exalted.
jalin	1 weave, plait together (into a rattan blind, wickerwork, etc.). 2 make s.t. be closer or more intense. 3 compose (stories, etc.).
jalinan	1 s.t. braided, wickerwork. 2 combination.
jalma	(java) creature.
jalu	cock's spur. ber-jalu have a spur.
jalur	1 strip, stripe. 2 traffic lane. 3 (r.r.) track. 4 space between two rows of plants, column between two lines. men-jalar-i provide with streaks, streak o,'s hair. jalur-an wake of a ship.
jalus	see jelus.
jalusi	jalousie, venetian blinds.
jalut	(bib.) goliath.
jam	1 hour. 2 o'clock. 3 time for doing s.t. 4 watch, clock. jam-jam-an on an hourly basis.
jamaah	see jemaah.
jamadah	inanimate.
jamah	men-jamah(i) 1 touch, feel, handle s.t. or s.o. 2 sleep with, have sexual relations with. 3 attack.
jamak	1. plural. 2. ordinary, customary. se-jamak-jamak-nya normally. men-jamak-kan make or cinsider s.t. customary.
jamal	(islam., in fixed phrases only) beauty.
jaman	period, epoch. se-jaman coeval. men-jaman be up-to-date.
jamang	1. diadem. 2. moment.
jambak	1. 1) bunch (of flowers, onions, keys, etc.). 2) tuft (of hair), plume (on horses). men-jambak pull, tear out hair, seize by the forelock. 2. k.o. fruit, jambu or rose-apple.
jambal	k.o. fish.
jamban	privy, toilet, latrine.
jambang	1. 1) vase, pot. 2) large earthen cooking pot. 2. see cambang.
jambar	1. shelter, temporary shed or hut. 2. serving, portion.
jambatan	see jembatan.
jambe,jambi	(lit.) areca nut.
jambian	k.o. fish.
jamblang	k.o. sweet-sour and astringent fruit, dark purple about the size of an olive.
jambore	jamboree.
jambret	o. who snatches purses, jewelry, etc.
jambrud	emerald.
jambrut	see jamrud.
jambu	k.o. fruit, the rose-apple.
jambu-jambu	tuft, tassel.
jambul	1 tuft, plume (on horse). 2 crest (on bird). 3 front wave (in hair), tuft of hair. jambul-jambul cowlick.
jamhur	(lit.) o. well-versed in religion.
jami	(islam) mesjid-jami principal mosque.
jamiah	/jamiat/ 1 gathering. 2 association.
jamik	see jami.
jamin	1 guarantor. 2 guarantee, security.
jamjam	see zamzam.
jamnas	[jambore nasional] national (boy or girl scout) jamboree.
jampang	see cambang.
jampi	magic formula or spell, incantation.
jampuk	1. k.o. owl. 2. men-jampuk interrupt s.o.
jamput	(vulg.) a harsh curse, screw you !
jamu	1. 1) guest. 2) meal, offering (in set phrases). jamu-an dishes and drinks served to guests. 2. tonic made of medicinal herbs.
jamung	torch.
jamur	fungus, mushroom, toadstool. ber-jamur be covered with mold. jamur-an moldy.
jan.	[januari] january.
jana	see jana bijana.
jana-bijana	(lit.) birthplace.
janabah,janabat	[islam] 1 impure, ceremonially unclean. 2 impurity after coitus.
janah,janat	see jannah.
janangau	k.o. rice bug.
jancuk	see ancuk.
janda	1 widow, (less commonly) widower. ke-janda-an widowhood.
jandal-jendul	bumpy, with bumps on skin.
jang	(sunda) form of address to small boys or waiters.
jangak	dissolute, licentious. libertine, rake.
jangan	1. 1) do not. 2 should not, ought not to. jangan-kan, jangan-pun let alone, much less. 2. (java) vegetables cooked with soup or gravy. jangan-an green vegetables.
jangar	vertigo.
jangat	1 skin, hide. 2 rind. 3 bark (of tree). 4 rawhide rope.
janggal	1 awkward, clumsy. 2 inelegant, displeasing (of sound or sight), discordant. 3 unbecoming, improper, indecent (of behavior).
janggel	(java) corncob, young corn on the cob.
janggelan	tentative, provisional.
jangger	see jangir.
janggi	1 black or exotic person. 2 s.t. bizarre or different from the usual.
janggo	cowboy, cowboylike.
janggut	1 beard. 2 chin.
jangir	1 balinese dancing girl. 2 k.o. balinese dance and music.
jangka	1 (tech.) compass for describing circles, etc. 2 period of time. 3 phase.
jangkah	step, stride.
jangkang	men-jangkang 1 straddle, stand with legs wide apart. 2 be wide apart (of legs).
jangkap	even.
jangkar	1 anchor. 2 roots that begin above ground (like mangrove roots).
jangkat	shallows, ford.
jangkau	1 reach. 2 reach to. 3 reach for. 4 reach out. 5 reach out, extend to.
jangkauan	1 reach. 2 extent, scope, range.
jangkerik	see jangkrik 1.
jangki,jankih	cords of a shoulder basket.
jangkih-mangkih	scattered around in a disorderly manner.
jangking	see jongkang 2.
jangkit	1 be contagious. 2 spread (of disease, fire). 3 contagious, infectious (of music, etc.).
jangkrik	1. cricket. 2. (java) exclamation used as a euphemism for diancuk.
jangkung	1 heron. 2 tall, long-legged (of a person). jangkung-an stilts.
janik	sea urchin.
janin	(biol.) fetus, embryo.
janjang	1. (java) long and slender (of the neck). 2. (m) see jenjang 1.
janji	1 promise, agreement, agree. 2 condition. 3 engagement, appointment. 4 delay, deferral. 5 dying hour.
janma	see jalma.
jannah,jannat	(rel.) paradise, heaven.
jantan	1 male, masculine (of animals). 2 bold, valiant. 3 dashing, valiant. 4 virile, manly, macho. pe-jantan stud. per-jantan-an pederasty.
jantang	1. ber-, men-jantang be clear, stand out (of blood vessels). 2. ter-jangkat blink from bright lights.
jantera	see jentera.
jantik	see jentik.
jantung	1 heart. 2 the heart as the seat of the emotions. 3 thick portion of hands, arms, legs, or feet. 4 heart-shaped ornament of necklace, watch.
jantungan	1 suffer a heart attack. 2 heart disease.
jantur	1 magic trick, sleight-of-hand. 2 magic spell.
janturan	puppeteer's narration in a shadow play.
januari	january.
janubi	see kutub.
janur	young coconut leaf.
jap	1 completed. 2 in agreement or accord.
japen	(jawatan penerangan) gvt. information office.
japit	tongs, clamp.
japu,japuk	k.o. small fish.
jara	small drill, auger. men-jara drill, bore.
jarab	scabies.
jarah	1. men-jarah plunder. jarah-an plunder, booty, spoils. 2. see zarah, ziarah.
jarak	1. distance between, gap. men-jarak-kan separate. pen-jarak-an spacing (of pregnancy, plants, etc.). 2. castor oil plant.
jaram	cold compress.
jarambab	see jerembab.
jaran	(java) horse.
jarang	1 rare, scare. 2 infrequently, rarely, seldom. 3 spaced, wide apart (of teeth, plants, etc.). 4 coarse in texture (cloth). 5 spare (of inhabitants), scanty (of hair).
jaras	1. bunch. 2 wicker basket.
jarem	beuised, black and blue.
jargon	jargon.
jari	1 digit (finger or toe). 2 digitlike projection (eg. wheelspokes, squid tentacles, etc.).
jariah,jariat	see amal.
jaring	dragnet or seine (not a casting net), net used in sports.
jaringan	1 net. 2 network (tv, road, radio). 3 (anat.) tissue.
jaro	bamboo lath or slat.
jarong	k.o. of tree.
jarot	fiber in fruit or vegetables.
jarum	1 sewing or hypodermic needle. 2 pin. 3 hand of clock, pointer. 4 trick, ruse.
jarwa	explanation of the meaning, exegesis. jarwa-dosok (ling.) associative etymology.
jas	coat.
jasa	1 merit. 2 service. 3 commendable or meritorious service.
jasad	(biol.) 1 body. 2 organism. jasad-renik microorganism.
jasadi	bodily, physical.
jasirah	see jazirah.
jasmani	body.
jasmaniah	bodily. kebutuhan-jasmaniah physical needs.
jasuka	[jawa, sumatera, kalimantan] java, sumatra, borneo.
jaswadi	see jas.
jatah	1 allotment, allocation. 2 quota. 3 bribe.
jateng	[jawa tengah] central java.
jati	1. k.o. hardwood tree, teak. 2. see sejati.
jatim	[jawa timur] east java.
jatmika	1 polite. 2 modest.
jatuh	1 fall. 2 fall (of prices, gvt.). 3 fall from a high position. 4 fail, flunk. 5 lead, reach, arrive. 6 related.
jauh	1. far, distant, remote. 2 far, by far. se-jauh as far as.
jauhar	1 jewel. 2 embryo.
jauhari	1 jeweler. 2 expert, specialist.
jauza	(zod.) gemini.
jaw.	[jawatan] office, division, bureau.
jawa	1 java, javanese. 2 (java) s.t of local origin rather than the imported or foreign kind. 3 (java) well-bred.
jawab	reply, answer, response.
jawahir	instrinsic.
jawanisasi	javanization.
jawat	se-jawat colleague. jawat-an office, division, bureau.
jawawut	(java) millet.
jawi	1.ox, cow. 2. 1) malaya or indonesia (as the homeland of indonesians or malays who are in mecca). 2) the script for writing malay or indonesian with arabic letters.
jawi-jawi	k.o. large ficus tree.
jawil	men-jawil touch s.o. in order to get attention.
jaya	1 victory. 2 victorious, glorious. 3 prosperous.
jazirah	peninsula.
jazz	/jes/ jazz.
jeans	/jin, jins/ 1 denim. 2 jeans.
jebah	1. full, broad (of face). 2. ber-jebah 1) profuse, copious, abundant. 2 assorted, various.
jebai	ber-jebai scattered, spread about.
jebak	trap.
jebakan	trap, snare.
jebang	long shield made of wood and covered with hide.
jebar-jebur	1 splashing of water while bathing. 2 pouring of water over o.s.
jebat	musk. men-jebat-i anoint. jebat-jebat-an fragrant aromas, perfumes.
jebik	thick or hanging (of lower lip). curl the lower lip down (to tease).
jeblok	1. muddy. ke-jeblok 1) be stuck, mired in mud. 2) be tricked, cheated. 2. sag, drop (of prices, inflation, etc.).
jeblos	give way.
jebobok	stand on end (of hair), ruffle (of feathers).
jebol	1 broken down. 2 perforated.
jebolan	1 dropout or graduate. 2 ex, former.
jebret	1. scratched, scrawled. men-jebret scratch, scrawl (o's signature). 2. sound of a staples.
jebrol	men-jebrol erupt.
jebuh	k.o. fish.
jebul	see jebol.
jebung	k.o. fish, the leatherjacket.
jeda	1 rest, respite, take a rest. 2 (poetry) caesura. 3 (ling.) juncture.
jedar-jedor	sound of a firearm.
jeding	1. (java) k.o. tub to store water. 2. curl upward (of lips).
jedul	(java) sudden appearance.
jegal	(java) men-jegal 1 stop, intercept s.o. 2 (sport) keep an opponent from winning.
jegang	1 stuff, inflexible. 2 tense, tight.
jegil	men-jegil 1 bulge (of eyes). 2 stab.
jegleg	(jakarta) sound of clicking.
jeglegan	staple for a stapler.
jeglong	have a hole in it. ber-jeglong bumpy, have bumps (of road). jeglong-an (java) pothole.
jegog	(java) men-jegog to bark.
jegrag	(java) men-jegrag stand on end (of hair).
jegung	(naut.0 sea chest, place for storing rigging, sails, etc.
jejadian	an invisible animal with supernatural powers, obedient to its human master.
jejak	1. 1) trail, track (of animal). 2) footstep, footprint. 3) (naut.) wake. 2. 1) straight, erect. 2) stable.
jejaka	1 youth, young man. 2 bachelor, unmarried young man.
jejal	ber-jejal 1 crowd, jam. 2 be jampacked (with spectators, etc.). ber-jejal(an) thronged, crowded. men-jejal stuff full.
jejala	network.
jejamu	herbs of various sorts.
jejas	lacerated, laceration, lesion.
jejawi	k.o. large ficus tree, the banyan.
jejek	stable, sound, firm (of a society, etc.).
jejel	see jejal.
jejenang	frame of door or window.
jejer	(java) a row of leather puppets arrayed in preparation for use in performance.
jejungkrak	(jejungkrakan) totally razed.
jek	(crd.) jack.
jeket	jacket.
jeksi	see injeksi.
jel	(coll.) jail.
jela	ber-(jela-jela) dangle, swing to and fro (of rope, etc.). dangling.
jeladan	k.o. bird that feeds on rice.
jelaga	carbon black, soot, lampblack.
jelai	1. 1) k.o. plant, job's tears. 2) barley. 2. jam, jelly.
jelajah	men-jelajah-kan analyze, examine, investigate.
jelak	1 bored, satiated. 2 be tired. ter-jelak full, stuffed (with food).
jelalat	glance. jelalat-an glance about, ogle.
jelang	1 call on, pay o,'s respects to. 2 visit. 3. to (used to address mail). 4 around, toward. 5 approach, come close to.
jelangak	look upward.
jelangkung	see jailangkung.
jelantah	oil that has been used for frying and will be reused.
jelapak	ber-, ter- jelapak flop down from weariness.
jelas	1 clear, distinct. 2 unequivocal, explicit (instructions, etc.).
jelata	see rakyat.
jelatang	1 stinging nettle. 2 agitator.
jelatik	see gelatik.
jeleh	(java) nj-jeleh-i disgusting, sickening.
jelek	1 ugly. 2 bad, evil (thoughts, etc.). 3 bad, poor in quality, not good.
jeleleh	dribble, slobber.
jelempah	lie scattered about.
jelengar	surprised, stunned into silence.
jelentik	tap or touch s.t. lightly.
jelepak	fall backward with a plop, lie.
jeli	1 charming, ravishing, beautiful 9of eyes). 2 sharp (in observation).
jelik	see jelek.
jelimet	hair-splitting, meticulous.
jeling	cast a sideways glance, ogle.
jelir	men-jelir project, protrude, stick out.
jelita	1 lovely, sweet. 2 graceful, charming, beautiful. loveliness.
jelititan	look around in a confused way.
jelma	men-jelma assume a form.
jelmaan	1 incarnation, creation. 2 thing into which s.t. has been transformed.
jelu	(java) 1 irked, piqued, annoyed. 2 dejected.
jeluak	vomit.
jeluang	bark cloth.
jeluat	protrude.
jelujur	1 baste (a hem). 2 tie or stitch together.
jeluk	cup, container.
jelum	ber-jelum bathe by wetting the body, but not showering. men-jelum give s.o. a sponge bath.
jelumat	men-jelumat mend with fine stitching. jelumat-an a darn (in socks, etc.).
jelungkap	men-jelungkap 1 spring loose. 2 recoil.
jeluntung,jeluntur	see cacar.
jelunut	viscous. men-jelunut adhere, cohere, stick.
jelus	(coll.) jealous, spiteful.
jelut	men-jelut 1 feel upset in the stomach. 2 be upset, annoyed, or irked.
jelutung	k.o. tree that produces milky sap from which a rubber substitute can be made.
jem	jam, jelly.
jemaah,jemaat	1 community, assembly. 2 (rel.) congregation.
jemah	later on, in the future.
jemala	1 head. 2 skull.
jemang	se-jemang a moment.
jemantung	heart.
jemari	finger.
jemawa	conceited, arrogant.
jemba	measure of lenght, two fathoms or about 2.4 meters. men-jemba reach out for, grab at. jemba-an two fathoms.
jembak	men-, ter-(jembak-jembak) flutter in the wind.
jembalang	k.o. supernatural creature, gnome.
jembatan	1 bridge. 2 bridge, bond between.
jembel	1 poor, shabby, squalid. 2 wanderer, hobo, tramp.
jember	(jakarta) dirty, muddy.
jembiah	k.o. dagger.
jemblem	k.o. confection of fried cassava.
jembrot	/jembrut/ see jambrud.
jembut	(java, jakarta) pubic hair.
jemeki	spangle, sequin.
jempalik,jempalit	1 turn a somesault, tumble over. 2 be upside down.
jemparing	(java) arrow.
jempol	1 thumb. 2 thumbs up, tops, first rate. men-jempol fingerprint s.o. jempol-an first-rate in quality.
jemput	1 a pinch. 2 a little bit of s.t.
jemputan	1 pick up service, limousine. 2 laundry on the line or in the sun. 3 invitation. 4(m) marriage proposal to a man.
jemu	1 tired. 2 sick of, fed up with.
jemuas	filthy, covered with dirt, mud, or food.
jemuju	1. caraway seed. 2. (sunda) k.o. timber tree.
jemur	1 sunbathe. 2 dry in the sun. 3 dried rice plant.
jemuran	1 items being dried. 2 the wash, laundry.
jen.	[jenderal] (mil.) general.
jenabah,jenabat	see janabah, janabat.
jenaha	/jenahar/ k.o. fish, red snapper.
jenak	1. a moment. se-jenak an instant.2. 1) comfortable, at o.'s ease. 2) sound asleep.
jenakawan	humorist, comic.
jenang	1. 1) doorframe or window frame. 2) doorpost. 2. 1) (sport) referee at cockfight. 2) (navy) steward. 3. 1) porridge, puddling, or any food which is thick and viscous. 2) molten metal or wet cement.
jenangau	k.o. rice bug.
jenasah,jenazah	corpse, mortal remains, cadaver. men-kan bury, inter. pen-an interment.
jendal-jendul	bumpy, with a bump on the skin.
jendela	window. jendela-geser sliding window.
jenderal	1 general (rank). 2 general, comprehensive.
jendol	swollen (from a bump). ber-, men- stick out (of s.t. round).
jendul	see jendal-jendul.
jeneng	(java) 1 name. 2 status.
jenewer	dutch gin.
jeng	(java) polite form of address for a woman the same age or younger than speaker.
jengah	1 embarrassed. 2 reluctant.
jengat	see jangat.
jengek	1. jengek-an mockery, ridicule. 2. (m) woman trader of smuggled or illegal consumer goods.
jenggar-jenggur	(jakarta) overgrown, overlarge, exceptionally big for o.'s age.
jengger	cock's comb. ber-jengger have a comb.
jenggot	beard. ber-jenggot have a beard.
jengguk	see jenguk.
jenggul	see jendol.
jenggur	see jenggar-jenggur.
jengiit-jengit	bob up and down (of dog's tail, head, etc.).
jengit	ber-jengit look starled.
jengkal	span (of the hand, about nine inches).
jengkang	ke-, men-, ter- 1 fall or topple backward. 2 lie on o.'s back. 3 (vulg.) die, kick the bucket.
jengkau	see jangkau.
jengkek	ber-jengkek 1 jump with joy. 2 walk on high heels.
jengkel	annoyed, irritated, irked.
jengkelit	men-jengkelit do a handspring, tumble.handspring, somersault.
jengkelitan	handspring, somersault.
jengkeng	1. ber-jengkeng-an sticking out in every direction. 2. see jingkat.
jengker	stiff, rigid 9of corpse).
jengkerik	see jangkrik 1.
jengket	see jingkat.
jengki	kind used by cowboy.
jengking	1. men-jengking lie with bottom up. 2. see kala 2.
jengkit	see jengking 1.
jengkol	k.o. tree the beans of which are eaten raw, the phithecolobium. jengkol-an suffer excessive urination from eating too many of these beans.
jengkolet	ber-, men-jengkolet capsize, turn turle, tumble over.
jengkot	ber-, men-jengkot 1 limp. 2 be lame.
jengkrik	see jangkrik 1.
jenguk	ber-jenguk-an look or peer out (of many people). men-jenguk-kan stick (the head) out.
jengul	men-jengul protrude. men-jengul-kan stick s.t. out.
jeni	1. genius. 2. see zeni 1.
jenial	brilliant, gifted, talented.
jenialitas	genius, talent.
jenis	1 kind, sort, genre. 2 (biol.) species, race.3 gender.
jenjam	tranquil, untroubled, secure.
jenjang	1. 1) ladder, scaffold, trellis. 2) stairs, staircase, flight of stairs. 3) stage, level. 2. see janjang 1. 3. see burung.
jenjeng	see jinjing 1.
jentai	ter-jentai be caught s.w., situated.
jentaka	(lit.) misery.
jentat	men-jentat leap, jump (of fleas, etc.).
jentat-jentit	(java) way of walking sexily.
jentelmen	sportsmanlike.
jentera	1 wheel in a machine or device. 2 mill, turbine. 3 spinning wheel.
