jentik	jentik-jentik mosquito larva.
jentret	(jakarta, java) row, line.
jenuh	1 surfeited, having had too much of s.t., sick and tired. 2 saturated.
jepang	japan, japanese.
jepet, jepit	1 tweezers. 2 clip, clamp.
jeprat	men-jeprat sprinkle, splash, splatter (of water). jeprat-jepret snap pictures.
jepret	sound of clicking or snapping . jepret-an stapler.
jepun	see jepang.
jeput	1. se-jeput hari all day long. 2. see jemput.
jera	1 be cured of a habit, learn o.'s lesson. 2 wary, chary, leery.
jerabai	ber-(jerabai-jerabai) with tattered edges, in tassels.
jeragan	see juragan.
jeragih	k.o. weed.
jerah	1. 1) abundant, plentiful. 2) prevalent (of disease, etc.). 2. learn a lesson, have had enough.
jerahak	ter-jerahak neglected, abandoned (of work, a problem, etc.).
jerahap	men-jerahap lie on o.'s stomach. ter-jerahak fall into a prone position.
jerait	ber-jerait(an) interwined, interwoven, intergrown (of plants, etc.).
jerajak	see jerjak.
jeram	1. rapids, cataracs. 2. see jaram.
jeramah	ber-jeramah tug or pull at. men-jeramah attack viciously, fall upon prey.
jerambab	see jerembab.
jerambah	platform terrace annexed to a house used for washing things.
jerambai	see jerabai.
jerambang	glow that sometimes appears at night over marshy areas.
jerami	1 dried rice stalks. 2 straw.
jeran	see jera.
jerang	men-jerang 1 heat s.t. 2 place s.t. on the fire or stove.
jerangau	the sweet flag, awild rush with pungent root stock and sweet-smelling flowers, widely used for medicinal purposes.
jerangkak	men-jerangkak crawl on hands and knees.
jerangkang	ber-jerangkang stick up, project upward. ter-jerangkang standing, in position projecting upward.
jerangkong	(java) skeleton.
jerap	men-jerap absorb. ter-jerap absorbed.
jerapah	giraflfe.
jerat	1 snate, lasso. 2 ruse, trick.
jeratan	noose, trap.
jerau	florid, deep red.
jeraus	nimble, sprightly.
jerawat	pimple, blackhead, acne.
jerbar	[jerman barat] west germany.
jerejak	adhere, stick.
jerembab,jerembap	men-jerembab throw o.s. down headlong.
jerembet	see jerepet.
jerembun	ter-jerembun suddenly become visible (of huge object).
jerempak	ber-, men-, ter- suddenly meet, suddenly come face to face with.
jereng	1. 1) squinting. 2) cross-eyed. 2. men-jereng spread s.t. out.
jerepet	1 linked together (of links in chain). 2 grown togheter (of fingers, etc.). jerepet-an coalescence.
jeri	1 frightened, afraid. men-jeri-kan fearsome.
jeriau	joists used to support floor or roof.
jerigen	see jeriken.
jerih	tired, weary. jerih-lelah/payah exertion, effort.
jeriji	1. finger. 2. see jeruji.
jeriken	jerrycan.
jering	1. pithecolobium tree, with edible seeds considered beneficial to kidneys. 2. k.o. cricket with strong chirping sound.
jerit	1 a scream, shriek. 2 clamor. 3 strong complaint.
jerjak	bars at window, grid, latticework.
jerkah	snarl, growl. men-jerkah snarl or snap at s.o.
jermal	fish trap conmsisting of closely spaced stakes behind which the fish get caught when the tide goes out.
jerman	german, germany.
jermang	props for boat on beach.
jernang	dragon's blood, red dye obtained from fruit of k.o. rattan.
jernih	1 clear (of water, air, eyes, etc.). pure (of liquids, etc.). make s.t. clear, clear up (a misunderstanding). 2 purify, cleanse. purification.
jeroan	(java) innards, entrails as food.
jerohok	ter-jerohok fall or sink into a hole.
jerojol	men-, ter-jerojol stick out.
jerongkang	jerongkang-korang head over heels. ter-jerongkang fall backward.
jerongkok	men-jerongkok sit with the chin on o,'s knees.
jerongkong	men-jerongkong lean forward and press chest against the knees. ter-jerongkong fall prostrate.
jerubung	awning, canopy, tarpaulin.
jeruji	1 trellis, grating, lattice. 2 grating, iron bars. ber-jeruji supplied with a grating or iron bars.
jeruju	k.o. small shrub.
jeruk	citrus fruit. jeruk-bali pomelo. jeruk-garut/kepruk tangering or orange that peels easly. jeruk-purut small fragrant k.o. lime used as medicine.
jerukun	men-jerukun cover or spread over.
jerukup	men-jerukup overarch.
jerumat	men-jerumat darn, mend.
jerumbai	tassle, fringe.
jerumun	1 lair of wild boar. 2 shelter, hide-out.
jerumus	men-jerumus-kan 1 drop s.t. on its face. 2 make s.t. fall down or into a hole.
jerung	k.o. large shark.
jerungkau	men-jerungkau hang down like hair over the face or branches of a willow tree.
jerungkis	bent upward. men-jerungkis damage, harm.
jerungkup	see jerukup.
jet	(av.) jet.
jetis	men-jetis make banging noise of firecracker.
jetisasi	replacing old fashioned aircraft with jets.
jetset	1 sophisticated, well trained. 2 (sl.) ugly but fashionable.
jewang	snatch s.t. up.
jewawut	see jawawut.
jewer	men-jewer 1 pull or tweak s.o.'s ear. 2 reprimand, scold s.o.
jiarah	see ziarah.
jiawang	k.o. monitor lizard.
jib	(naut.) jib sail.
jibaku	(japanese) 1 suicide attack. 2 make a suicide attack, participate in a suicide squad. ber-jibaku engage in a suicide attack.
jibakutai	(japanese) suicide squadron.
jiblah	aptitude, talent.
jibun	ber-jibun 1 pile (of work). 2 teem, swarm (of ants).
jicing	opium dust.
jidar	1 border around a letter or printed page. 2 wooden ruler.1 provide a line. 2 make a line with a ruler.
jidat	forehead.
jidor,jidur	see tanjidor.
jidwal	see jadwal.
jigo	(china) 25.
jigong	1 tartar, plaque, dirt on teeth. 2 dirty person, tramp. ber-jigong have dirt on it (of teeth).
jih	(lit.) target.
jihad	(islam) holy war. ber-jihad engage in a holy war.
jihat	side.
jihin	see jin 1.
jiitmeh	(china) twenty-first day of the first china month (end of the cap go meh celebration).
jijak	see jejak 1.
jijat	see jidat.
jijik	1 repugnant, abhorrent, nauseating. 2 disgusted, nauseated.1 loathe, abhor, abominate. 2 nauseating, loathsome.
jijit	see jinjit 2.
jika,jikalau	1 if. 2 when (future, general).
jilat	bootlicker.
jilat-jilat	men-jilat-jilat purr (of cat).
jilatisme	mental attitude characterized by seeking benefits by bootlicking.
jilbab	(islam) female headgear that exposes fase but not ears, neck, or hair.
jilid	volume. ber-jilid bound (of book, etc.). men-jilid bind (book, periodicals)
jimak	coitus. ber-, men- have sexual intercourse.
jimat	charm, talisman, amulet.
jimbit	se-jimbit a pinch, a small amount.
jin	1. 1) genie. 2) evil spirit. 2. gin.
jina,jinah	see zina.
jinak	1 tame, domesticated (animal). 2 gentle, docile, moderate. 3 (med.) benign (tumor).
jinawi	see gemah-ripah.
jinerap	absorbant.
jingau	men-jingau peer at.
jingga	colors ranging from orange to bright red. men-jingga become orange.
jinggering	1 high-heeled (shoes). 2 longstemmed (glass).
jingkat	ber-(2), bersi-, men-jingkat stand or walk on tiptoes. ter-jingkat be startled.
jingkek	1 tiptoe. 2 high-heeled shoes.
jingkik	ber-jingkik-jingkik hop on o. leg.
jingklak	/jingkrak/ 1. jump up and down (for joy). 2. straddle (horse, fence, etc.).
jinjang	1. slender and tapering (neck). 2. 1) leader. 2) necromancer. 3. se jenjang 1.
jinjing	1. men-jinjing carry s.t. light in o.'s hand. 2. k.o. fast-growing tree that yields cheap lumber. 3. ber-jinjing stand on tiptoes.
jinjit	1. stand on tiptoes. 2. men-jinjit carry in the hand. 3. men-jinjit 1) pull s.t. that is not stiff. 2) tweak (an ear).
jinsom	ginseng.
jintan,jinten	caraway seed. jintan-hitam cumin. jintan-manis anise seed. jintan-putih white cumin.
jip	jeep. ber-jip go by jeep.
jipang	1. branch, twig. 2. melon, gourd. 3. see bipang.
jiplak	men-jiplak 1 copy. 2 cheat on an exam, crib. 3 plagiarize, fake s.t. by copying it.
jiplakan	1 a copy. 2 plagiatism, imitation that pretends to be the real thing.
jiprat	men-jiprat splash, splatter.
jirak	k.o. tree with edible fruit.
jiran	1 neighbor. 2 kin, relative.
jirangkong	see jerangkong.
jirat	1. tomb, mousoleum. 2. jirat, jiret see jerat.
jirian	(med.) leucorrhea.
jirigen	see jeriken.
jirus	1. men-jirus sprinkle water on, pour a small amount of water over. 2. see tirus.
jisim	(anat.) body.
jit	(china) seven, in commercial transactions.
jitah	see akar.
jitak	men-jitak slap s.o.
jitpek	(china) 700 (used in commercial transactions).
jitu	accurate, precise, exact.
jiwa	1 soul, spirit. 2 spirit, the principle behind s.t. 3 inhabitant.
jiwani	psychic, psychological.
jiwasraya	name of gvt.-owned life insurance company.
jka	[jawatan kereta api] see pjka.
jkt.	[jakarta] jakarta.
jkta.	[jawatan kereta api] indonesia railways.
jl., jln.	[jalan] street, road.
jlimet	see jelimet.
jml.	[jumlah] amount.
jng.	[jatinegara] a district in jakarta.
jo.	[juncto] (leg.) connected with.
joang	see juang.
joanglo,joanlo	(china) chafing dish, food warmer.
joblos	see jeblos.
jobong	(jakarta) prostitute.
jodo,jodoh	1 marriage partner, mate. 2 match, be a match, be a mate (to). 3 be in agreement over.
jogar	game of checkers.
joget	1 k.o. classical java dance accompanied by the gamelan. 2 k.o. dance to lively music, us. for couples. 3 o. who performs a dance of this type.
joglo	(java) steep upper section of roof of traditional java mansion.
jogo	see kacang.
jogo-tirto	(java) officer in village in charge of distribution of water for irrigation.
jogrog	(jakarta) nge-, n-jogrog be in a place without moving. jogrok-kan thrust s.t. in front of o.
johan	1 world, universe. 2 champion.
johar	1. k.o. fast-growing shade tree the crown of which yields firewood. 2. see bintang, zohrah. 3. see jauhar.
johari	see jauhari.
joja,jojo	k.o simian.
jojol	piling, palisades.
jok	1 seat (of car, pedicab, etc.). 2 car upholstery.
joki	(sport) jockey.
jolak	ber-, men- jolak blaze.
jolek	men-jolek wrap s.t. in leaves.
joli	1 palanquin. 2 team of horses. se-joli a couple, twosome.
joli-joli	yawl, k.o. small boat.
jolok	men-jolok 1 prod at s.t. with a pole, etc., to knock it down. 2 probe, ferret out. 3 pole finger down throat, into nose, etc.
jolong	1. men-jolong project, protrude. 2. (m) see julung 2.
jolong-jolong	see ikan.
jolor	men-jolor 1 creep, crawl 9of snakes, etc.) 2 inch forward on o.'s belly.
jombang	(m) handsome, pretty, beautiful.
jompak	rear, prance (of horse, etc.).
jomplang	see jumplang.
jompo	(java) old, decrepit, infirm. rumah 0rang-jompo old folks' home.
jompong	pe-jompong-an rallying place.
jon-towel	(jakarta) young fellow that puts on airs.
jong	see jung.
jongang	see jongkang 2.
jonget	curved upward at the tip or side.
jonggol	representative, responsible person. jonggol-an responsibility.
jonghe	k.o. weed.
jongkang	1. k.o. boat. 2. protruding 9of teeth, upper lip, etc.). jongkang-jangking sticking out right and left. 3.
jongkar-jangkir	sticking out all over (esp. of teeth).
jongkat	see jungkat.
jongko	stall (in market).
jongkok	ber-, men- jongkok squat. ber-jongkok-jongkok be obsequious. ter-jongkok in a squatting position.
jongkong	k.o. dugout canoe.
jongos	(now considered derog.) houseboy, waiter.
jonjot	1 tuft (of hair). 2 flake. men-jonjot extract, pluck.
jontrot	men-jontrot poke, thrust s.t. by poking it.
jor-jor	(java) push, elbow aside. jor-jor-an vie with o. another, compete. jor-jor drumband marching band competition.
joran	fishing rod. joran ampai divining rod.
joreng	small piece (of cloth), small clod (of earth). men-joreng slice thin.
jori	team of horses.
jornalis	see jurnalis.
jorok	1. 1) slovenly, slipshod. 2) dirty, untidy. 2. men-jorok stick out, project, protrude.
jorong	1. ellipse, elliptical, oval-shaped.2 metal v-shaped holder for betel leaf. 3. a corner.
jotakan	(java) be on unfriendly terms.
jotos	fist.
jotosan	boxing, fisticuffs.
jrang-jreng	sound of plucking a guitar, banjo, etc.
jrangkung	see jerangkong.
jrawut	rumpled, disheveled, messed up.
jreng-jreng	sound of coins clinking, tinkling sound (of guitar, etc.).
jring-jring	sound of tinkling (of guitar, mandolin).
jrs.	[jurusan] 1 direction. 2 academic field.
jua	1 nothing or nobody but, only. 2 even if it is, no matter. 3 nevertheless. 4 also.
juadah	1 delicacy made of rice. 2 cake or cookies. 3 provicions, foodstuffs.
juak	1. ber-juak compete. men-juak incite, instigate 9a fight). pen-juak instigator. 2. men-juak be projecting upward. men-juak-kan hoist a sail, project s.t. upward.
jual	sell, sale.
juang	struggle. medan-juang battlefield. ber-juang fight, struggle. fighter, warrior, freedom fighter. sharing in the same struggle.
juang-juang	k.o. shrub.
juar	see johar 1.
juara	1 champion. 2 referee in a cockfight.
jubah	long flowing robe 9including religious habits, arabic garments, etc.). ber-juang wear such a robe.
jubal,jubel	ber-(2), ber-an, -an crowd around. men-jubal-kan cram, jam.
jubin	floor tile.
jubir	(jurubicara) spokesperson.
jubit	see cubit.
jublek	amazed, astronished.
jubur	(anat.) anus.
judas,judes	1 cruel, vicious (esp. in speech). 2 hars and rude, unmannered.
judi	gambling. pe(n)-judi gambler.
judo	(sport) judo. pe-judi expert in judo.
judoka	(sport) expert in judo.
judokang	(sport) judo hall.
judul	1 title (of book, etc.). 2 caption (under cartoon, etc.) 3 credits (in movie or on tv). 4 heading.
juga	1 also, too. 2 even if. 3 no matter what, how, who, etc. 4 rather. 5 anyway.
juhi	(china) dried squid.
juih	curled (of lips).
juita	sweet, lovely, beautiful.
juja	(zod.) gemini.
jujai	(lit.) ceaseless, incessant.
jujat	(lit.) slander, insult, (verbal) abuse.
juju	1. men-juju feed (a baby) pre-chewed food. 2. see tuju.
jujuh	ber-, men-jujuh be incessant, unceasing.
jujur	1. honest, on the level. ke-jujur-an honesty, integrity. 2. men-jujur-i present a bride-price to.
jujut	men-jujut pull, tug at (rope, etc.).
julai	slender end of stem of a creeping plant, runner of a creeping plant. men-julai-kan dangle s.t.
julak	see jolak.
julang	men-julang 1 soar, tower. 2 carry on the shoulder. 3 hold in high esteem, esteem highly.
julat	(lit.) range, reach. se-julat-mata as far as the eye can see.
juli	july.
julig	(java) cunning, sly (in negative sense).
juling	cross-eyed. men-juling-i steal a glance at, glance at a bit.
julir	harpoorr.
julita	see jelita.
julo	lottery played by neighborhood wives at monthly get-together. ber-julo play julo.
julu	ber-julu-an stretch out (in all directions). men-julu extend, stick out (of tongue, etc.). julu-an 1 stick, stave, bar. 2 line, row.
juluk	named, called. juluk-an sobriquet, nickname.
julung	1. (java) fated to be unlucky. 2. for the first time.
julung-julung	see ikan.
julur	stick out (of several things).
jumaah	/juma'ah/see jemaah.
jumaat	/juma'at/ see jumat, jum'at.
jumadilakhir	the 6th month of the arabic calendar.
jumadilawal	the 5th month of the arabic calendar.
jumantara	firmament, outer or upper atmosphere.
jumanten	emerald.
jumat	see jemaah.
jumbai	tassle, fringe. se-jumbai a bunch of s.t. that hangs down. ber-(jumbai-jumbai) 1 tassled, fringed. 2 frayed. 3 flutter.
jumblah	see jumlah.
jumblang	cesspool, septic tank.
jumbuh	similar, edentical.men-jumbuh-kan make s.t. compatible. ke-jumbuh-an identity.
jumlah	1 sum, amount, total. 2 number, quantity. 3 (ling.) number. men-jumlah-kan add or count up. men-jumlah-kan adding, totaling.
jumpa	meet.
jumpalit	ber-jumpalit turn a somersault.
jumplang	unbalanced, unequal.
jumpluk	pile. se-jumpluk a pile of.
jumpul	k.o. mullet.
jumput	a pinch of s.t.
jumud	1 stiff, rigid, unbending. 2 old-fashioned, resistant to change.
junam	men-junam 1 dive (of planem bird). 2 attack in flight.
juncto	/yungkto/ (leg.) in connection with.
jung	k.o. boat, china junk.
jungat	men-jungat tilt upward (of boat, cart, etc.).
jungkal	men-jungkal-kan 1 overturn s.t. 2 overthrow, bring down (a regime, etc.). ter-jungkal tumble forward.
jungkang	jungkang-jungkit bob up and down.
jungkar	men-jungkar project, protrude.
jungkat	jungkat-jungkit bob up and down. men-jungkat slant, tilt. jungkat-an seesaw.
jungkel,jungkil	see jungkal.
jungkir	jungkir-balik 1 upside-down, topsy-turvy. 2 turn a somersault. 3 be in a dither. men-jungkir flip over.
jungkit	see jungkang.
jungkrak	men-jungkrak raze (a building). men-jungkrak-an push s.t. aside.
jungkung	see jongkong.
jungur	1 snout, sword (of swordfish). 2 (navy) bow.
jungut	mountain spur.
juni	june.
junjung	ber-junjung-an have a husband .
junjungan	1 o. who is esteemed. 2 adoration. 3 pole for climbing plants. 4 (formal) o,'s husband.
junta	junta.
juntai	ber-, men-, ter- dangle.
juntrung	organized, orderly.
juntrungn	1 organization, unit. 2 purpose, aim.
junub	(islam) ritual impure or soiled (after coitus, giving birth, menstruation, etc.)
junun	possessed by a devil.
jup	(sl.) yep !
jura	men-jura how out of respect.
juragan	1 skipper (of small craft). 2 owner of an enterprise. 3 (in some regions only) respectful address by villager to man of nobility or higher class.
jurai	1 bunch. 2 row, sequence. ber-, ter-, men- dangle, hang down (of hair, tassels, etc.). ber-jurai-an hang down (in large numbers).
juran	see joran.
jurang	ravine, gorge, chasm. jurang-kenistaan the depths of misery. jurang-pemisah gap. jurang-juriat generation gap.
juri	(leg.) jury. men-juri be amember of the jury in a competition. pen-juri-an judging a case by a jury.
juriat	see zuriat.
juridiksi	see yyuridiksi.
juridis	see yuridis.
jurik	k.o. supernatural being.
juring,juringan	section, segment (of fruit).
juris	see yuris.
jurisprudensi	see yurisprudensi.
jurnalis	journalist, reporter.
jurnalistik	jurnalism.
juru	skilled worker. juru-bicara spokesman, spokeswoman. juru-damai peacekeeper, peacemaker. ke-juru-rawatan nursing.
jurus	1. step, movements in martial arts. 2. moment.
jus	1. sound of steam locomotive. 2. (tennis) deuce. 3. juice. men-jus make a drink out of. 4. see juz.
justa	see dusta.
justru	exactly, precisely.
juta	million. ber-(juta-juta) by the millions.
jutawan	millionaire.
juwang	see juang.
juz	(islam) section of the koran.
k	k, the 11th letter of the alphabet.
k.	[kaca] page.
k.s.	[kredit semester) (acad.) semester credit.
ka	see kah.
ka.	[kepala] head, chief.
kaabah	see kabah.
kab.	[kabupaten] regency (administrative unit].
kaba	(m) tale, story.
kabag	[kepala bagian] administrative section head.
kabah	1. (islam) the small cubicle shrine in the great mosque of mecca which contains the famous black stone of mecca. it represents the direction (kiblah) to which muslims turn in praying. 2. symbol of the islam political party.
kabal	see kebal.
kabar	news, report.
kabaret	1. (coll.) beret. 2. see malam 1.
kabarnya	kabarnya
kabat	see kebat.
kabe	see kb.
kabel	cable.
kabil	(islam) cain, abel's brother.
kabilah	nomadic tribe.
kabin	1. (naut.) cabin. kabin-pengemudi (av.) cockpit. 2. cream crackers.
kabinet	1 governmental cabinet. 2 cabinet (for medicine, etc.).
kabir	1. mighty (of god). 2. meng-kabir reverse the direction of a boat by paddling perpendicular to the hull.
kabisah	/kabisat/ leap year.
kabit	thief, pickpocket.
kabriolet	(auto.) convertible.
kabu-kabu	1 kapok. 2 fluffy material like kapok. ber-kabu-kabu fluffy, downy, cottony.
kabul	answered, granted (of a prayer, request).
kabuli	see nasi 1.
kabung	white mourning headband.
kabupaten	1 regency, area headed by a bupati. 2 residence or office of the bupati.
kabur	1. 1) hazy (view), vague, blurred, clouded (vision). 2) fading (of hopes), unclear (of handwriting, speech, etc.). 3) haze. 2. 1) bolt (of a horse). 2) run off, flee.
kabus	nebulous.
kabut	1. mist, haze, fog. 1) sprayer. 2) atomizer. 3) carburetor. 2. see kebut 2.
kaca	1. 1) glass. 2) mirror. 3) example. 2. page (of book, etc.).
kacak	1. 1) dashing, robust, vigorous. 2) conceited. 2. meng-kacak determine the weight or size of s.t. by holding it in the hand.
kacang	pea, bean, peanut. kacang-asin salted peanuts. kacang-buncis green beans. kacang kapri peas. kacang kedelai soybean. kacang-mede/mende cashew. kacang merah kidney bean.
kacapiring	gardenia.
kacapuri	main building of a palace.
kacar	line used to fish for squid and cuttlefish.
kacau	1 in disorder, in an uproar. 2 confused (mind, situation). 3 in disarray. kacau-balau/bilau chaotic, disorganized, in total confusion.
kacek	different, dissimilar.
kaci	k.o. white cotton cloth from india.
kacip	1 scissors used primarily for cutting areca nut. 2 gardening scissors.
kacir	see kucar-kacir.
kaco	see ngaco.
kacoa	/kacoak/ cockroach.
kacokan	see kacukan.
kacu	1. handkerchief. 2. coagulated areca nut juice used in leather tanning.
kacuk	meng-kacuk mix, put in disorder, muddle.
kacung	1 lad, boy. 2 errand boy, houseboy.
kada	(islam) 1 divine decree. 2 make up for unobserved days of fasting month or for missing o. of obligatory prayers.
kadal	k.o. lizard.
kadaluarsa	/kadaluwarsa/ see kedaluwarsa.
kadam	see khadam.
kadang	1. sometime. kadang-kala occasionally, once in a while. 2. meng-kadang-nasi skim water off the surface of rice to hasten cooking. 3. blood relationship.
kadar	1. 1) degree, content. 2) standard, level, amount. 3) value, quality. 4) fate. 2. meng-kadar sleep outdoors.
kadas	k.o. skin fungus causing white blotches.
kadaster	real estate registry.
kadaver	1 cadaver. 2 dead and uninspired.
kade	quay.
kader	1 cadre. 2 framework.
kadera	(e. indonesia) chair.
kaderisasi	forming of cadres.
kades	[kepala desa] village head.
kadet	1. 1) cadet. 2) midshipman. 2. pickpocket. 3. k.o. white bread or roll.
kadi	1 (islam) judge in religious court. 2 arbiter, referee.
kadim	1. eternal. 2. close, intimate.
kadin	[kamar dagang industri] the chamber of commerce and industry.
kadinda	[kamar dagang dan industri daerah] the provincial chamber of commerce and industry.
kadipaten	(in the colonial period) area ruled over by an adipati.
kadir	almighty.
kado	gift, present.
kadok	1. long pepper leaf used as a substitute for the betel leaf. 2. see kada.
kadung	(java) 1 go too far, overdo. 2 take an irrevocable step o. should not.
kadut	1 sack, bag. 2 sacking.
kaedah	see kaidah.
kaf	the letters k and q in the arabic alphabet.
kafan	see kapan 2.
kafarat	see keparat 1.
kafe	cafe.
kafein	caffeine.
kafetaria	small restaurant with a limited menu us. in a school or workplace.
kafilah	1 desert caravan. 2 (mil.) convoy, column, contingent.
kafir	infidel, unbeliever.
kaftan	k.o. cloak.
kagak	(jakarta) no, not.
kaget	startled, shocked.
kagok	1 clumsy, awkward (esp. in feeling o. is doing s.t. improper). 2 speaking a language with a foreign or dialectal accent.
kagol	frustrated.
kagum	amazed, struck with amazement and admiration.
kah	birdlime, glue.
kahaf	(lit.) cave.
kahan	proboscis monkey.
kahar	1. k.o. vehicle pulled by a draft animal. 2. all-powerful.
kahat	scarcity, famine.
kahin	soothsayer, diviner.
kahiyangan	see kayangan.
kahot	old-fashioned, ancient.
kahrab	amber.
kahwa	(lit.) the beverage coffee.
kahwin	see kawin.
kahyangan	see kayangan.
kaidah	1 norm, rule. 2 principle. 3 theorem.
kaifiat	quality.
kail	meng-kail fish with hook and line. peng-kail angler.
kail-kail	tonsilitis.
kaimat	quantity.
kain	1 cloth, fabric, material. 2 sarong.
kaing	yelp with (of dogs).
kais	scratch, scrape for food (of chickens, etc.).
kaisar	1 emperor. 2 caesar. ke-kaisar-an empire.
kaisaryah	1 imperial. 2 (med.) caesarean.
kait	1 hook, barb. 2 catch.
kaiwan	(astr.) saturn.
kajanah	see khazanah.
kajang	movable sunshade of bamboo laths, wickerwork or palm thatch.
kajat	see hajat.
kaji	1. knowledge, teaching (esp. religious). meng-kaji recite koranic verses. 2. mengk-kaji inspect, examine, investigate.
kak	1. k.o. glue used in bookbinding. 2. see kakak 1.
kakah	ber-kakah burst out laughing.
kakak	1. 1) older sibling or cousin. 2) term of address or reference (esp. as kak) for a person somewhat older than the epeaker. 3) term of address to o.'s husband (in some areas). 2. boisterous laughter.
kakaktua	see kakatua.
kakanda	(lit.) elder brother or sister (esp. in letters).
kakang	(java) elder brother.
kakao	cocoa.
kakap	1. 1) name given to many k.o. large fish. 2) big-time criminal, gangster. 3) large-scale (firm, operation). 2. meng-kakap patrol, scout. 3. meng-kakap 1) hold, grasp. 2) work a wet rice-field.
kakas	meng-kakas scratch, scrape.
kakatua	1 cockatoo. 2 pincers, pliers with pincer shape (like the beak of a cockatoo). 3 k.o. fish.
kakawin	k.o. old java poetry.
kakeas	doubletime, quicktime in marching, jogging.
kakek	1 grandfather or grand-uncle. 2 term of address for an old man. kakek-moyang ancestor.
kaken-kaken	kaken-kaken-ninen-ninen grow as old as grandparents.
kakerlak	(coll.) 1 cockroach. 2 s.o. as vile as a cockroach.
kaki	1. 1) foot, leg. 2) foot (measurement). 3) classifier for flowers or umbrellas. 4) edge of an area. 2. see kakek. 3. see khaki.
kakok	(m) hold.
kaktus	cactus.
kaku	1 stiff, rigid. 2 clumsy, awkward, ungainly.
kakung	(honorific, java) male.
kakus	((coll.) privy, latrine.
kala	1. 1) time, era, period, age. 2) (ling.) tense. 2. 1) scorpion. kala-lipan centipede. 2) (zod.) scorpio. 3. mare.
kala-kala	(naut.) sea anchor.
kalah	1 defeated. 2 lose. 3 inferior to.
kalai	1. meng-kalai 1) lie down. 2) lean. 2. meng-kalai rub, polish s.t. tarnished.
kalajengking	scorpion.
kalak	(math.) 1 reciprocal. 2 inverse.
kalakat	bamboo basket for moist cookies.
kalam	1. 1) pen made from a leaf rib. 2) (lit.) writing instrument. 2. word, saying. 3. see kalem.
kalang	transverse support, prop.
kalang-kabut	confused, chaotic.
kalangan	1 circle, arena. 2 realm. 3 circle.
kalap	1 possessed by an evil spirit. 2 be beside o.s. with anger.
kalas	1 thole-strap for an oar. 2 band around the hilt of a machete.
kalau	1 if. 2 when (future). 3 as for..., in the case of... 4 (coll.) whether (introducing an indirect question). 5 (coll.) that (introducing an indirect statement).
kalawarta	1 magazine, periodical. 2 bulletin.
kalbar	[kalimantan barat] west kalimantan.
kalbu	1 heart. 2 mind.
kaldera	caldera (of a volcano).
kaldron	cauldron.
kaldu	broth, stock (for soup).
kalelep	(java) 1 be submerged, lowered. 2 drowned.
kalem	calm, cool, patient, relaxed.
kalender	calendar.
kaleng	1 tin can. 2 tin. 3 tin plate.
kalerek	see kelerak.
kalesa	source of animal protein.
kali	1. river. 2. 1) time, times. 2) (math.) times. 3) fold (suffix). 3. (jkt) probably. 4. (jkt) very.
kalian	(pl.) you (form of address to equals, younger persons or persons of lower status).
kaliber	1 caliber (of gun). 2 importance, class.
kalibut	chaos.
kalifah	1 caliph. 2 caliphate.
kaligrafi	calligraphy.
kalimah	see syahadat.
kalimantan	borneo. kalimantan-utara sarawak and sabah.
kalimantang	1 pennant. 2 white beam of light.
kalimat	sentence, independent clause. kalimat-ingkar negative sentence. kalimat-majemuk setara compound sentence. kalimat-majemuk bertingkat complex sentence. kalimat-penjelas declarative sentence.
kalingan	(java) partially hidden, with obstructed view.
kalio	see klio.
kalis	1 dull, lacking luster (of a surface). 2 immune to disease, not allowing air, water, or some other extraneous substance to penetrate. 3 pure.
kalium	potassium.
kalkarim	/kalkarium/ wallpaint.
kalkir	meng-kalkir trace s.t. over s.t.
kalkulasi	calculation.
kalkulator	calculator.
kalkulir	meng-kalkulir calculate.
kalkun	turkey.
kalo	1. strainer. 2. kalo, kalok see kalau.
kalong	see keluang.
kalor	(phys.) heat.
kalori	calorie.
kalpataruh	1 (lit.) k.o. mythological tree that never dies. 2 annual prize awarded to o. who has made an outstanding contribution to preserving the environment.
kalsel	[kalimantan selatan] south kalimantan.
kalselteng	[kalimantan selatan dan tengah] south and central borneo.
kalsium	calcium.
kalteng	[kalimantan tengah] central borneo.
kaltim	[kalimantan timur] east borneo.
kalu	see kalau.
kalui	k.o. fish, gurami.
kalung	necklace.
kalurahan	see lurah 1.
kalut	confused, chaotic.
kalwan	(astr.) uranus.
kam	internment or prison camp.
kama	(lit.) love, passion.
kamadean	parasite.
kamar	1. room, chamber. 2. (lit.) moon. 3. ornamental sash around the waist, cummerbund.
kamariah	pertaining to the moon.
kamat	1. (islam) the call to begin prayer. 2. k.o. tree.
kambang	see ambang 2.
kambar	k.o. large sea turtle.
kambeh	gourd.
kambek	1 make a comeback. 2 (coll.) be reconciled (of lovers).
kambeli	k.o. woolen fabric.
kambi	1 rib, frame. 2 peneling, winscoting.
kambing	goat. kambing-domba sheep. meng-kambing-hitamkan place the blame on, make the scapegoat.
kamboja	k.o. tree, frangipani.
kambrat	1 comrade. 2 accomplice, party to a crime. 3 small party, get together.
kambuh	have or suffer a relapse.
kambus	blocked, stopped up (of drain).
kambut	k.o. woven basket.
kamera	camera.
kamerad	comrade.
kameraman	camera man.
kamerjas	/kameryas/ man's dressing gown.
kamfer	see kamper.
kamhar	camel hair wool.
kami	1 we, us, our (excluding the person addressed). 2 i (deferential).
kamil	perfect.
kamis	thursday.
kamisolen	/kamisosolen/ unable to speak properly from overexcitement.
kamit	see komat-kamit.
kamitua	deputy village chief in central java.
kamli	sewe kambeli.
kamling	[keamanan lingkungan] law and order of the neigborhood.
kamp	/kem/ see kam.
kampagne	see kampanye.
kampai	1. ber-kampai(an) lie supine, stretched out. 2. (japanese) cheers ! (on raising a toast).
kampak	adze. meng-kampak cut with an adze.
kampanye	campaign.
kampas	see kanvas.
kampemen	military encampment.
kamper	camphor, mothballs.
kampil	/kampit/ small sack.
kampiun	champion, very clever or skilled.
kampleng	meng-kampleng slap (s.o. in the face).
kampong	see kampung.
kampret	1. k.o. small bat. 2. shucks !
kampuh	1 shawl, wrap. 2 two thin strips of paper or cloth sewn together, seam. ber-kampuh see kain.
kampung	1 village. 2 quarter. 3 residential area for lower classes in town or city.
kampus	campus.
kamrat	camshaft.
kamsia	(china) thank you.
kamso	(java) rustic, provincial.
kamtibmas	[keamanan dan ketertiban masyarakat] peace and order in society.
kamu	you, your (familiar, singular and plural). kamu-sekalian all of you.
kamuflase	camouflage.
kamuflasering	camouflaging.
kamuflir	meng-kamuflir camouflage.
kamuplase	see kamuflase.
kamus	dictionary, lexicon.
kan	1. 1) it is the case, isn't it ? 2) because as you well know... 2. short form for akan 1. 3. container for boiling tea. 4. see kans.
kana	preserved olives.
kanak	child. kanak-kanak (lit.) small child.
kanal	1 canal. 2 channel.
kanan	1 right. 2 (pol.) rightist. kanan-luar (sport) outside right.
kanape	canape.
kanari	1. the canari tree or its nuts. 2. see kenari 2.
kancah	1 large pot for cooking rice. 2 s.t. figuratively comparable to a deep pot : depths (of despair), abyss (of misery).
kancana	see kencana.
kancap	filled to the brim.
kancil	1 mouse deer. 2 a clever individual.
kancing	button. kancing-jepret 1 snap. 2 push button. kancing-manset cufflinks. kancing-ritsleting/sorok zipper.
kancut	loin cloth, jockstrap.
kanda	see kakanda.
kandang	1 stable, stall, pen. 2 place to keep vehicles, boats, etc.
kandar	meng-kandar(kan) operate a vehicle. peng-kandar driver, operator.
kandas	1 run aground, founder (of a shiop etc.). 2 fail.
kandel	1 thick, heavy. 2 rich, well-to-do.
kandi	1. pouch, small bag. 2. see asam.
kandidat	candidate.
kandil	1 lamp. 2 chandelier, candelabra. 3 candlestick.
kandis	tree with small sour fruit.
kandung	1 womb, uterus. 2 pouch like part of the body.
kandungan	1.uterus,womb 2.contens 3.unborn child,fetus 4.pouch.
kang	1. large earthenware container. 2. see kakang. 3. see kekang.
kangen	(java) long for, miss s.t.
kangka	(china) gambier plantation.
kangkang	1. meng-kangkang 1) wide apart (of legs). 2) straddle, sit astride. 2. meng-kangkang strangle. meng-kangkang-i take by force or illegally.
kangker	see kanker.
kangkung	1. k.o. leafy vegetable, us growing in water. 2. large frog or toad.
kangmas	(java) 1 older brother. 2 term of address for o.'s husband.
kangsa	see gangsa 1.
kangsar	k.o. tall tree.
kangsen	appointment, have an appointment.
kangtau	(china) chance, opportunity (in business).
kanguru	kangaroo.
kanibal	cannibal.
kanigara	sunflower.
kanin	canine.
kanisah	see kenisah.
kanjang	ber-kanjang persevering, persistent.
kanjar	k.o. large dagger.
kanjeng	(java) form of address or reference for a high-ranking noble.
kanji	1. starch. 2. china characters used in japanese.
kanker	cancer. kanker-ganas malignant tumor.
kano	canoe.
kanon	1. cannon 2. rent for a plot of ground.
kanonisasi	canonization.
kanopi	canopy.
kanpas	see kanvas.
kans	chance, opportunity.
kanselir	chancellor.
kanta	lens.
kantang	mud flats.
kantih	thread, yard.
kantil	1. (java) the champac, k.o. magnolia. 2. see kontal-kantil.
kantin	canteen, us. attached to a workplace.
kantong	see kantung.
kantor	1 office. 2 office, agency.
kantuk	sleepiness, drowsiness. meng-kantuk feel sleepy.
kantung	1 pocket. 2 bag, pouch. 3 pouchlike part of body. kantung-buah zakar scrotum. kantung-empedu gall bladder. kantung-kemih/kencing bladder.
kanun	(rell.) canon law.
kanvas	1 canvas. 2 floor of boxing ring. 3 piece of tire or tube used in patching. 4 brake lining.
kanwil	[kantor wilayah] regional office.
kanya	(zod.) virgo.
kaok	1 cackle (of chickens). 2 yell, shout (of children).
kaoliang	sorghum.
kaolin	kaolin.
kaos	1 sock, stocking. 2 singlet, undershirt. ber-kaos wear an undershirt.
kap	1 (auto.) roof of a car. 2 shade (of lamp, etc.).
kapa-kapa	a sunshade on a boat, us. of palm thatch or a temporary sunshade, esp. in the yard for a wedding (or other) feast.
kapabel	capabel, able.
kapabilitas	capability.
kapah	ter-kapah-kapah 1 starled, trembling from fright. 2 gasping (for breath).
kapai	move as if wanting to clutch at s.t. ter-kapai-kapai flutter, fail around.
kapak	1. ax. 2. see kepak 1.
kapal	1. ship, boat, vessel. 2. 1) callous. 2) stubborn, insentive.
kapan	1. when ? kapan-saja 1) any time whatsoever. 2) exactly when. 2. shroud of unbleached cotton. 3. (jakarta) because, as you well know...
kapanewon	subdistrict of a kabupaten (county).
kapang	1 ship worm or worm that gets into rice. 2 mold, mildew.
kapar	flotsam, driftwood.
kaparat	see keparat 1.
kapas	1 cotton. 2 cotton plant. 3 fleece. 4 (med.) cotton, gauze.
kapasitas	/kapasitet/ capacity.
kapatihan	see patih 1.
kapbir	see kabir.
kape	1 spatula. 2 putty knife.
kapel	chapel.
kapelan	chaplain.
kaper	(java) moth.
kapi	1. (naut.) pulley block. 2. see kape.
kapilah	see kafilah.
kapin	(geol.) limestone.
kapir	see kafir.
kapiran	(java) 1 be neglected. 2 let down. 3 beyond help.
kapita	see per.
kapital	(fin.) capital.
kapitalis	capitalist.
kapitalisme	capitalism.
kapitan	1. leader for the china, arabs or certain other local ethnic leaders under the dutch. 2. /kapiten/ see kapten.
kapitulasi	capitulation.
kapling	see kaveling.
kaplok	kaplok-dadabeat o.'s breast.
kapoces	/kapocis/ condom.
kapok	1. learn o.'s lesson, be curred. 2. see kapuk 1.
kapol	see kapul.
kapolda	[kepala polisi daerah] head of the provincial police.
kapolres	[kepala polisi resort] head of the county police.
kapolri	[kepala polisi republik indonesia] head of the indonesian police.
kapolsek	[kepala polisi sektor] head of the district police.
kapolwil	[kepala polisi wilayah] head of the regional police.
kaporal	see kopral.
kaporit	chlorine.
kaprah	usual, ordinary.
kapri	snow peas.
kapsalon	beauty parlor.
kapstok	clothes hook, hatrack.
kapsul	1. capsule. 2. hair piece.
kapt.	[kapten] captain.
kapten	1 (mil.) captain, lieutenant (in navy). 2 see kapitan 1.
kapu-kapu	k.o. plant, the leaves of which resemble lettuce, formerly found in aboundance floating on slow-moving or stagnant water.
kapuk	1. 1) kapok. 2) kapok tree. 2. rice granary or barn.
kapul	/kapulaga/kapulogo/ cardamom.
kapung	see apung.
kapur	1. lime. kapur-barus 1) camphor. 2) mothballs. 2. calcium.
kapurancang	(java) stand with the hand cupped covering the genitals as a sign of deference (of men).
kar	map, chart.
kar.	1. [karangan] article. 2. [karesidenan] residency.
kara	1. see kacang. 2. see batang.
karaba	k.o. fish trap.
karaben	/karabin/ carbine.
karaeng	title of nobility in south sulawesi.
karaf	decanter.
karah	1 stain. 2 tartar (on teeth).
karak	see kerak.
karakter	character.
karakterdes	[kader penggerak teritorial desa] cadre of the golkar party assigned to rural areas.
karakterisasi	characterization.
karakterisir	meng-karakterisir characterize.
karakteristik	characteristic.
karam	1 be shipwrecked, founder, go under. 2 fail, founder.
karamba	basket put in a stream for raising fish.
karambol	/karambola/ billiards game.
karang	1. coral, coral reef, atoll. karang-gigi tartar (on teeth). karang-endapan encrustation. 2. karang-taruna neighborhood youth association. 3. stay, sojourn.
karangkitri	fruit-producing trees in a yard.
karantina	quarantine.
karap	shuttlecomb on a weaving loom.
karapan-sapi	bull race.
karar	1 calm, peaceful. 2 stable, steadfast, unchanging.
karas	aloes wood, camphor tree.
karas-karas	k.o. fried cookie made of wheat flour.
karat	1. stain, rust. 2. 1) carat. 2) quality, value.
karate	karate.
karateka	o. who engages in karate.
karau	ber-karau mixed. meng-karau mix, stir s.t.
karavan	(auto.) camper.
karawitan	(java, sunda) gamelan music and singing accompanied by a gamelan.
karbit	carbide.
karbohidrat	carbohydrate.
karbol	1. carbolic acid. 2. indonesian airforce cadet.
karbon	carbon.
karbonaci	/karbonacis/ baking powder.
karburator	carburetor.
karcis	1 ticket. 2 calling card.
kardamunggu	cardamom.
kardan	(auto.) differential (of gearing, transmision).
kardinal	cardinal.
kardiograf	cardiographs.
kardiografi	cardiography.
kardiogram	cardiogram.
kardiolog	cardiologist.
kardiologi	cardiology.
kardus	1 cardboard. 2 cardboard box.
kare	see kari.
karedok	(sunda) cooked vegetable salad.
karena	1 because, because of. 2 reason, cause.
kareseh-peseh	babble in dutch.
karesidenan	residency (administrative unit of the colonial period).
karet	1 rubber. 2 elastic. 2 condom.
kargo	freight.
kari	a dish of meat cooked in a spicy sauce. kari-ayam chicken curry.
karib	close, intimate friend.
karier	career.
karieris	o. who is ambitions for a career.
karierisme	out to promote o.'s career.
karih	mix, stir s.t.
karikatur	caricature.
karikatural	caricatural.
karikaturis	caricaturist.
karil	1. [karya ilmiah] scholarly paper. 2. rabbit.
karim	generous, magnanimous (of god).
karir	see karier.
karisma	charisma.
karismatik	/karismatis/ charismatic.
karitatif	charitable (institution).
karkas	carcass (of a slaughtered animal).
karma	s.t. (us. bad) that happens to o. because of deeds in a previous life.
karna	see karena.
karnaval	carnival.
karnivor	carnivore.
karo	[kepala biro] head of a department or division.
karosel	carousel.
karoseri	1 body of a car. 2 body shop.
karper	carp.
karpet	carpet.
karpus	see kerpus 2.
karsa	(lit.) wish, intention. karsa-dan karya will and work.
karsinom	/karsinoma/ carcinoma.
kartel	cartel.
kartika	(lit.) star. kartika-yudha/yudo (mil.) star wars.
kartini	raden ajeng kartini, a 19th-century java woman, who distinguished herself in fields where women were traditionally excluded.
kartografi	cartography.
karton	1 carton. 2 cardboard, hardboard.
kartotek	/kartotik/ card file.
kartu	1 card. 2 playing card.
kartun	cartoon. 2. see karton.
kartunis	cartoonist.
karu	1. meng-karu 1) interrupt s.o. 2) stir s.t. 2) karu-an see keruan.
karuhun	ancestor.
karun	see harta.
karung	bag, sack.
karunia	gift, grant from above. meng-karunia-i favor, reward s.o.
karusel	see karosel.
karut	1 confused, muddled. 2 chaotic.
karya	1 work, opus. 2 work, labor, activity. 3 creation (of a designer, etc.).
karyawan	white collar worker, official employee, functionary.
karyawati	female white collar worker, official employee, functionary.
kas	1. 1) cash, money supply.2) cashier's window. 3) treasury. 2. 1) (wooden) case, (watch) case. 2) wardrobe, armoire.
kasa	1. gauze. 2. see kassa.
kasab	[kepala staf angkatan bersenjata] chief of staff of the armed forces.
kasad	intention, purpose.
kasah-kosoh	sound of s.t. cracking against s.t. and breaking.
kasai	1 fragrant shampoo. 2 ointment for the skin. 3 lotion.
kasak	1. meng-kasak rub s.t. 2. meng-kasak persuade s.o.
kasak-kisik	/kasak-kusuk/ 1 whispering, whispers. 2 intrigue.
kasal	[kepala staf angkatan laut] navy chief of staff.
kasam	grudge, spite.
kasanah	see khazanah.
kasap	coarse, rough to the touch.
kasar	1 coarse, rough, rugged (of facial features). 2 crude. 3 coarse, uncouth.
kasasi	1 (leg.) the jurisdiction of the highest court beyond which there is no appeal. 2 appeal to the supreme court.
kasatmata	in plain view.
kasau	rafter.
kasava	cassava.
kasbi	see kaspe.
kasbon	cash receipt.
kasbuk	ledger.
kasemak	see kasemek.
kasemat	see kesumat.
kasemek	k.o. smooth-skinned sweet fruit the size of an apple and eaten fresh.
kasep	see kasip.
kaset	cassette.
kasi	1. (coll.) 1) give. 2) cause (allow) s.o. to. 3) put. 2. [kepala seksi] administrative section head.
kasian	see kasih 1.
kasiat	see khasiat.
kasidah	religious chant in arabic sung to the rhythm of a gambus.
kasih	1. love, affection. 2. see kasi 1.
kasim	castrated.
kasima	upset, discioncerted.
kasino	casino.
kasip	too late.
kasir	cashier.
kasmaran	(java) smitten with love.
kasno	[bekas cino] (derog.) china who adopts an indonesian name.
kaso	/kasok/ see kasau.
kaspe	cassava.
kassa	1 cashier, cashier's desk. 2 ticket or box office.
kasta	caste in society.
kastengel	cheese stick.
kasti	k.o. children's game similar to baseball.
kastil	castle.
kastroli	castor oil.
kasturi	see kesturi.
kasuari	cassowary.
kasumat	see kesumat.
kasur	mattress.
kasus	case (legal, medical, grammatical), example.
kasut	sandal, slipper.
kat	(coll.) playing card.
kata	1 word. 2 says, said.
katabelece	see katebelece.
katah	thrown.
katai	1 midget, dwarf, pygmy. 2 bantam chicken.
katak	frog, toad. 2 short, stocky, thick set.
katakombe	catacomb.
katalis	catalyst, catalystic (factor).
katalisasi	catalysis.
katalisator	catalyst.
katalog	catalog.
katalogisasi	cataloging of books.
katalogus	see katalog.
katam	see khatam.
katan	see khitan.
katang-katang	1. a climbing plant. 2. plaited basket carried on the back.
katapel	/katapuil/ see ketapel.
katarak	/katarakta/ (med.) cataract.
kate	see katai.
katebelece	informal note from o. powerful figure to another asking for action (to by pass bureaucracy or the like).
katedral	cathedral.
kategis	see katekis.
kategori	category.
kategoris	categorical.
katek	1. armpit. meng-katek-i tickle. 2. see katai.
katekese	catechism.
kateketik	catechetical.
katekis	catechist.
katekisasi	(rel.) confirmation class.
katekismus	catechism.
katekumen	catechumen.
katel	(java) k.o. large black spider.
katepel	see ketapel.
katering	catering.
kates	(java) papaya.
kateterisasi	cathetrization.
kati	catty (1/3 pounds or 617 grams).
katib	see khatib.
katifah	chenille.
katig	k.o. knapsack of plaited materials.
katik	see katai.
katil	1 sleeping platform of solid materials. 2 bier.
katimaha	k.o. beautifully grained wood used for making kris sheats and walking sticks.
katimumul	corn on o.'s foot.
katir	outrigger.
katistiwa	see khatulistiwa.
katoda	/katode/ cathode.
katok	(java) shorts, undershorts.
