unplug	kkt. (unplugged) mencabut seteker, melepaskan kawat.
unpolished	ks. kasar, tidak dihaluskan (stone).
unpolluted	ks. tidak kotor, (masih) bersih (water).
unpopular	ks. tak disukai/disenangi/populer.
unpopularity	kb. ketidakpopuleran.
unpopulated	ks. tidak berpenduduk (area).
unprecedented	ks. belum pernah terjadi sebelumnya. an u. amount of rain hujan yang belum pernah diperoleh sebanyak itu.
unpredictable	ks. tidak berpendirian tetap, tak dapat diramalkan.
unprejudiced	ks. tidak berpihak/berprasangka.
unprepared	ks. 1 tak dipersiapkan (speech). 2 tak bersedia. u. for the reaction to tak bersiap-siap terhadap reaksi itu untuk.
unpretentious	ks. 1 sederhana, bersahaja (house). 2 rendah hati (manner).
unprincipled	ks. 1 tak normal (behavior). 2 nakal, buruk (person).
unprintable	ks. tak patut ditulis.
unproductive	ks. tak menghasilkan.
unprofessional	ks. tidak pantas menurut kedudukan.
unprofitable	ks. tak menguntungkan.
unpronounceable	ks. tak dapat diucapkan.
unprotected	ks. tak terlindung/dilindungi.
unproved	ks. tidak terbukti (theory, accusation).
unprovoked	ks. tak beralasan/dipancing-pancing (attack).
unpublicized	unpublicized
unpublished	ks.tak diterbitkan.
unpunished	ks. tanpa hukuman, dengan tidak dihukum. to go u. bebas tanpa hukuman.
unqualified	ks. 1 tak memenuhi syarat. 2 lengkap, total. u. success sukses yang sesungguhnya/total.
unquenchable	ks. 1 tak terpuaskan, tak dapat dihilangkan ((thirst, spirit). 2 tak terpadamkan (fire).
unquestionable	ks. tak diragukan lagi, tak dapat disangkal. -unguestionably kk. tak dapat disangsikan.
unravel	kkt. 1 menyelesaikan kekusutan (string). 2 membongkar/membuka seluk-beluk (mystery). -kki. terurai, lepas-lepas.
unreadable	ks. tak dapat dibaca, tak terbaca.
unreal	ks. tidak menurut kenyataan. to lead an u. existence hidup dalam khayal.
unrealistic	ks. tak realistis.
unreasonable	ks. 1 rewel. 2 keterlaluan. 3 tak masuk akal. -unreasonably kk. tidak layak, tidak masuk akal.
unrecognizable	ks. tak dapat dikenal lagi.
unredeemed	ks. 1 yang tak dipenuhi (promise). 2 tidak seimbang/dikembalikan / dipenuhi. house of u. ugliness rumah yang kejelekannya tak dapat diimbangi.
unregenerate	ks. tetap ingkar. an u. criminal seorang penjahat yang tak mungkin berubah lagi.
unregulated	ks. tak diatur.
unrehearsed	ks. tanpa (diadakan) latihan persiapan (program).
unrelated	ks. tidak bertalian/bersangkutan.
unrelenting	ks. tak kenal henti, tak henti-hentinya.
unreliable	ks. tak dapat dipercaya.
unrelieved	ks. tak berkurang-kurang/henti-hentinya. u. boredom kebosanan yang tak berkurang-kurang.
unremitting	ks. tak berkurang, tak kunjung padam. u. efford usaha yang tak henti-hentinya.
unremunerative	ks. tidak memberi untung, kurang menguntungkan.
unrepentant	ks. tidak menyesal.
unrepresentative	ks. tidak representatip, tidak mewakili kepentingan golongan.
unrequited	ks. tak berbalas (love).
unreservedly	kk. dengan terang-terangan/terus-terang.
unresolved	ks. 1 belum mendapatkan penyelesaian, belum dipecahkan (problem). 2 yang belum dapat dihilangkan (doubt).
unresponsive	ks. tidak menjawab, tidak memperlihatkan ada reaksi, tidak ada reaksi.
unrest	kb. 1 kegelisahan. 2 ketidaktentraman. 3 kerusuhan. student u. kerusuhan mahasiswa.
unrestrained	ks. tak dikendalikan/terbatas, bebas.
unrestricted	ks. tak terlarang/tertutup (of an area).
unrewarding	ks. tak ada penghargaannya. u. task tugas yang tak ada ganjarannya.
unrighteous	ks. yang jahat/berdosa.
unripe	ks. mentah.
unrivaled	ks. tak ada taranya/tandingannya.
unroll	kkt. membuka gulungan.
unrounded	ks. phon.: tak dibulatkan. u. vowel huruf hidup yang diucapkan tanpa membulatkan bibir.
unruffled	ks. tenang.
unruliness	kb. kerusuhan, kekacauan, kekusutan.
unruly	ks. 1 tak mau patuh, tegar (of person). 2 sukar dikendalikan, tidak mau menurut (of a horse). 3 yang kacau/yang kusut (of hair).
unsafe	ks. membahayakan, tidak aman (of car, food, area). u. bridge jembatan yang tidak aman atau yang tidak cukup kuat.
unsaid	ks. tidak tanpa disebutkan. to leave s.t. u. membiarkan sesuatu tanpa disebutkan.
unsalaried	ks. tanpa digaji, sukarela (official).
unsanitary	ks. tak sehat, tak memenuhi syarat kesehatan.
unsatisfactory	ks. tak memuaskan.
unsatisfied	ks. tak puas.
unsatisfying	ks. tak memuaskan/mencukupi.
unsavory	ks. 1 tak enak, menjijikkan (of food). 2 buruk tak baik (of reputation).
unscathed	ks. tanpa cedera. to escape u. selamat/terhindar tanpa cedera.
unscholarly	ks. tidak layak bagi sarjana, tidak seperti seorang sarjana.
unscientific	ks. tak ilmiah.
unscramble	kkt. menguraikan (a telegram).
unscratched	ks. tanpa gores/luka/cedera. to emerge u. keluar tanpa gores.
unscreened	ks. tak berdinding kawat kasa (porch).
unscrew	kkt. melepaskan.
unscrupulous	ks. tak mengindahkan moral, jahat.
unseal	kkt. membuka segel.
unseasonable	ks. tak sesuai dengan musim (weather). -unseasonably kk. tidak menurut musimnya, tidak pada tempatnya. u. warm panasnya tidak menurut musim yang sebenarnya.
unseasoned	ks. 1 tak berbumbu (of food). 2 kayu yang tidak kering (of wood). 3 belum berpengalaman (of a person).
unseat	kkt. 1 menggeser dari kedudukan (in an election). 2 melempar dari pelana (from a horse).
unseaworthy	ks. tidak layak laut.
unseeded	ks. 1 tak disebari benih (land). 2 tak termasuk (pemain) pilihan (in a contest).
unseemliness	kb. ketidaklayakan.
unseemly	ks. tak pantas/layak (of behavior).
unseen	ks. tak kelihatan (error). 2 tak dapat dilihat (enemy).
unselfish	ks. tak mementingkan diri sendiri.
unselfishness	kb. sifat tak mementingkan diri sendiri.
unsettle	kkt. menggangu ketenangan, menggoncang. -unsettled ks. 1 tidak tentu/pasti, berubah-ubah. u. conditions keadaan yang tidak pasti. 2 tak padat penduduknya.
unshak(e)able	ks. tak tergoncangkan, teguh (faith).
unshaken	ks. tak goncang, teguh, tetap (of faith).
unshaven	ks. tak dicukur.
unsheathe	kkt. menghunus (a dagger, sword).
unshrinkable	ks. tidak menciut, tidak menjadi ciut.
unsightly	ks. tak sedap dipandang, menyakitkan mata.
unsigned	ks. tidak ditandatangani (letter).
unsinkable	ks. tak dapat ditenggelamkan/tenggelam.
unskilled	ks. tidak mahir/ahli. u. in carpentry tidak mahir dalam pertukangan. u. labor tenaga buruh bukan ahli.
unsnap	kkt. (unsnapped) melepaskan, membuka (a hook).
unsociable	ks. tak (pe)ramah.
unsoiled	ks. belum/tidak kotor.
unsold	ks. tak terjual.
unsolicited	ks. tak diminta.
unsolved	ks. belum terbongkar (mystery, murder).
unsophisticated	ks. bersahaja, sederhana, wajar.
unsound	ks. 1 tak waras. of u. mind tak waras otak. 2 tak kokoh (policy, firm). 3 tak nyenyak (of sleep). 4 yang tidak sehat (theory).
unsparing	ks. 1 royal, tak tanggung-tanggung (of praise, efforts). 2 tak kenal ampun (of justice). -unsparingly kk. royal, berlebih-lebihan, tanpa ampun/kasih. to use s.t. u. mempergunakan sesuatu dengan berlebih-lebihan.
unspeakable	ks. 1 tak terkatakan. 2 amat buruk (manner). -unspeakably kk. sungguh tidak terkatakan, dengan amat buruk.
unspecified	ks. tak ditentukan. an u. number sejumlah yang tak ditentukan banyaknya.
unspoiled	ks. 1 murni, tak berubah (area). 2 tak manja (child).
unspoken	ks. tidak dikatakan/diucapkan.
unsporting	ks. tidak sportip.
unsportsmanlike	ks. tidak sportip.
unstable	ks. 1 tak stabil (government). 2 yang goyah (footing). 3 tak tenang, mudah tersinggung. he's emotionally u. jiwanya mudah tersinggung. 4 yang tidak pasti (of weather). 5 yang mudah meledak (of a liquid).
unstamped	ks. tidak dicap.
unstatesmanlike	ks. ks. tidak diplomatis, tidak seperti yang dilakukan seorang negarawan.
unsteadiness	kb. keadaan tidak tenang/aman/pasti.
unsteady	ks. 1 goyah (of a regime). 2 yang mudah terombang-ambing (of a mind). 3 tak tegak/kokoh. to be u. on o's feet tak tegak berdirinya.
unstinted	ks. boros, murah hati, yang melimpah-limpah (of generosity).
unstinting	ks. tak/tanpa habis-habisnya, terus menerus. u. in praise of memuji tanpa habis-habisnya.
unstrap	kkt. (unstrapped) melepaskan tali, membuka ban (of a trunk).
unstressed	ks. phon.: tak diberi tekanan, tanpa tekanan.
unstrung	ks. lemah urat syaraf, gelisah.
unsubstantiated	ks. yang belum dibuktikan kebenarannya (report, charge).
unsuccessful	ks. tak berhasil, gagal, tak membawa sukses. -unsuccessfully kk. dengan tidak berhasil.
unsuitable	ks. tak cocok/sesuai/serasi (for untuk).
unsuited	ks. tak cocok/sesuai. she was u. for him ia tak cocok baginya.
unsullied	ks. tak tercela/bercacat (reputation).
unsupported	ks. tak didukung/disokong. an u. statement pernyataan yang tak ada dukungannya.
unsure	ks. tak percaya. to be u. of o.s. tak begitu percaya kepada diri sendiri. 2 tak pasti. an u. future hari depan yang belum pasti.
unsurpassed	ks. tak dapat dibandingi/dikalahkan.
unsuspected	ks. tidak seperti yang diduga, tak disangka-sangka.
unsuspecting	ks. yang tidak menaruh curiga (victim).
unsweetened	ks. tak diberi gula, tak dimaniskan.
unswerving	ks. 1 (tetap) teguh (in o's determination). 2 tak menyimpang (from o's course).
unsystematic	ks. tak sistematis. -unsystematically kk. tanpa sistim, tanpa susunan yang teratur.
untainted	ks. 1 bersih, murni. 2 tidak busuk (of food).
untamed	ks. 1 belum dijinakkan (of animals). 2 yang belum dibabat/ditundukkan (of a region).
untangle	kkt. menguraikan.
untapped	ks. tidak/belum dipergunakan/dimanfaatkan. u. resources sumber-sumber yang belum dimanfaatkan.
untarnished	ks. tak bernoda/bercacat.
untenable	ks. tak dapat dipertahankan.
untested	ks. belum diuji/dicoba.
unthinkable	ks. tak dapat dipertimbangkan, tidak mungkin.
unthinking	ks. yang membabi-buta. his u. action perbuatan-perbuatannya yang membabi buta itu.
unthought-of	ks. tak ada dipikir, tidak dipikirkan orang, tak terpikir.
untidy	ks. 1 tak teratur/rapi. 2 ropak-rapik, berantakan.
untie	kkt. membuka (tali). menguraikan. to come untied lepas.
until	kd. hingga, sampai. u. now hingga saat ini. -ksam. sampai. wait u. i finish tunggu sampai saya selesai.
untimely	ks. terlalu cepat, sebelum waktunya. his u. death wafatnya pada usia yang terlalu muda.
untiring	ks. tak kenal lelah, tak mengenal payah.
unto	kd. sampai. faithful u. death setia sampai mati.
untold	ks. 1 tak terhitung. there are u. stars tak terhitung banyaknya bintang. 2 tak terhingga. 3 tak terkira (of wealth). 4 yang tak deceritakan (story, account).
untouchable	kb. paria, orang yang diluar kasta, orang hina-dina. -ks. yang tak dapat disentuh, hina-dina.
untouched	ks. tidak disentuh. he left his food u. ia tak menyentuh makanannya.
untoward	ks. tak baik, tak menguntungkan (of developments, wreather). an u. accident kecelakaan yang sial.
untrained	ks. tak terlatih/terdidik.
untrammeled	1 lepas (luas) (of fields). 2 tak terhalang (of a mind).
untranslatable	ks. tak dapat diterjemahkan.
untranslated	ks. tidak diterjemahkan.
untraveled	ks. tak dilalui (orang) (path or road).
untried	ks. belum dicoba (recipe). u. troops tentara yang belum dicoba.
untroubled	ks. tak merasa terganggu/gelisah.
untrue	ks. 1 tak benar, bohong. 2 khianat, tak setia (to a couse).
untrustworthy	ks. tak dapat dipercaya.
untruth	kb. kebohongan, kedustaan. to tell an u. berdusta, berbohong.
untruthful	ks. tak benar, tak jujur.
untuned	ks. tak disetel, berbunyi sumbang (of a piano).
untutored	ks. tak terdidik. to my u. mind menurut cara berpikirku yang sederhana.
untwist	kkt. menguraikan.
unusable	ks. tak dapat dipakai.
unused	ks. 1 /an'yuwzd/ tak terpakai. an u. cup sebuah mangkok yang belum dipakai. 2 /an'yuwst/ u. to tak biasa. he is u. to hard work ia tak biasa bekerja keras.
unusual	ks. luar biasa. nothing u. occurred tak ada yang luar biasa terjadi. -unusually kk. luar biasa.
unvaried	ks. tidak berubah-ubah, tidak ada pilihan lain, itu-itu saja.
unvarnished	ks. 1 tak dipolitur (furniture). 2 yang sebenarnta (truth).
unvarying	ks. tidak berubah (of weather, of o's stand on a matter).
unveil	kkt. 1 membuka selubung. 2 memperkenalkan (a plan). -unveilling kb. pembukaan (selubung).
unventilated	ks. tak mendapat hawa.
unverified	ks. belum diteliti kebenarannya (laporan).
unversed	ks. belum berpengalaman, tak faham. to be u. in tak paham tentang.
unvoice	kkt. phon.: mengucapkan tanpa suara. -unvoiced ks. tak disuarakan. u. sound bunyi yang tak disuarakan.
unwanted	ks. tak dikehendaki (child).
unwarranted	ks. 1 tidak beralasan. u. assumption dugaan yang tidak beralasan. 2 tak berdasar, tak dapat dibenarkan. (interference).
unwary	ks. tak awas/hati-hati/waspada.
unwashed	ks. tak dicuci.
unwavering	ks. teguh, kokoh, tetap.
unwed	ks. tak dikawin, diluar perkawinan.
unwelcome	ks. tak disukai/dikehendaki (surprise, guest).
unwell	ks. sakit, tak enak badan, tak sehat.
unwholesome	ks. tak sehat (attitude, climate).
unwieldy	ks. susah dipakai, berat.
unwilling	ks. segan, enggan diajak,tak mau diajak, tidak berkemauan penuh. -unwillingly kk. dengan segan.
unwillingness	ks. keengganan, keseganan, ketidakmauan, ketidaksediaan.
unwind	kkt. (unwound) melepaskan, membuka (a rope). -kki. mengaso, beristirahat.
unwise	ks. tak bijaksana, bodoh.
unwitting	ks. 1 tanpa diketahui/disadari. -unwittingly kk. tanpa disadari, dengan tak disengaja.
unworkable	ks. tak dapat dilakasanakan (plan).
unworked	ks. belum diolah/dikerjakan (land).
unworldly	ks. tak mementingkan soal-soal duniawi.
unworthy	ks. 1 tak layak/penting/berguna. u. of consideration tak layak untuk diperhatikan dengan sungguh-sungguh. 2 tak pantas, memalukan (conduct).
unwound	lih unwind.
unwrap	kkt. (unwrapped) membuka.
unwritten	ks. tidak dituliskan.
unyielding	ks. keras hati/kepala, tak mau mundur.
unzip	kkt. (unzipped) membuka ritsleting.
up	kb. on the up and up 1 inf.: jujur, ikhlas. 2 maju terus. -ks. 1 memadai, mengimbangi. 2 habis, lampau. 3 naik. 4 bangun. -kk. 1 keatas. 2 ke. 3 terbit, keluar, naik. 4 kencang. 5 sudah sampai/tiba. 6 naik. 7 siap, selesai.
upbeat	kb. pukulan yang tidak keras.
upbraid	kkt. mencela, memarahi.
upbringing	kb. asuhan, didikan. what sort of u. has he had ? apakah (latar belakang tingkatan) pendidikannya.
upchuck	kkt., kki. inf.: muntah.
upcoming	ks. yang akan datang, mendatang.
upcountry	kb. (j. -ries) daerah udik/pedalaman. to live u. tinggal di daerah udik.
update	kkt. memperbaharui, membaharui.
updraft	kb. udara yang bergerak keatas, angin yang berhembus keatas.
upend	kkt. 1 mendirikan pada ujungnya. 2 membalikkan, meletakkan terbalik.
upgrade	kb. tanjakan, pendakian. to be on the u. menjadi baik, sembuh. -kk. naik. -kkt. mengupgrade, menatar. -upgrading kb. penataran.
upheaval	kb. 1 kehebohan, pergolakan. 2 geol.: pelengkungan.
upheld	lih uphold.
uphill	ks. sulit, berat. u. existence perjuangan yang berat. -kk. menanjak, mendaki.
uphold	kkt. (upheld) 1 menegakkan, mempertegak (the law). 2 membenarkan, menguatkan (decision of a lower court). 3 menjunjung tinggi (tradition).
upholder	kb. penegak (of the law).
upholster	kkt. melapisi dengan kain pelapis (furniture).
upholsterer	kb. tukang melapis perabot rumah.
upholstery	kb. (j. -ries) kain pelapis/pembalut/ salut.
upi, u.p.i.	[united press international] salah satu kantor berita.
upkeep	kb. 1 pemeliharaan, perawatan. 2 beaya pemeliharaan.
upland	kb. tanah tinggi. -uplands j. (daerah) pegunungan.
uplift	kb. 1 hal meninggikan (to morale). 2 peningkatan. -kkt. 1 mengangkat. 2 memajukan piiran (the mind). -uplifting ks. meringankan/menggembirakan pikiran.
upon	kd. = on.
upper	kb. 1 rr.: tempat tidur diatas. 2 sol sepatu lapis atas. -ks. 1 atas. 2 tinggi. upper-breacket ks. yang berpenghasilan tinggi. u. case huruf besar. u.-class ks. 1 dari golongan atas dalam masyarakat. 2 kelas tertinggi dalam sekolah.
upperclassman	kb. (j. -men) mahasiswa tingkat tiga dan emapt (di as).
uppercut	kb. pukulan (arah) keatas.
uppermost	ks. paling atas/penting (in o's mind).
uppish	ks. inf.: tinggi hati, sombong, angkuh.
uppity	ks. inf.: sombong, angkuh, tinggi hati.
upraised	ks. terangkat (arm, box lid).
upright	kb. piano biasa. -ks. 1 jujur, tulus (of a person). 2 tegak lurus (of a ladder). u piano piano biasa. -kk. tegak lurus. to stand u. berdiri tegak lurus.
uprising	kb. pemberontakan.
upriver	kk. dihulu.
uproar	kb. 1 kegemparan, kegaduhan (over the elections). 2 haru-biru, hingar-bingar, hiruk-pikuk (in the next room). to be in an u. over menjadi ribut karena.
uproarious	ks. 1 hiruk-pikuk, hingar-bingar (croud). 2 yang terbahak-bahak (laughter). uproariously kk. dengan terbahak-bahak. to laugh u. ketawa/mengetawai dengan terbahak-bahak.
uproot	kkt. menumbangkan (trees). to be uprootted from o's home diambil dari rumahnya.
upset	kb. 1 terbaliknya (of a boat). 2 gangguan. 3 sport : kekalahan yang tak disangka-sangka. -kkt. (upset) 1 menggangu, merusak (nerves, plans). 2 menumbangkan (a dish or pan). 3 sport: mengalahkan. 4 mengacaukan.
upsetting	1 ks. merepotkan (of a pill). 2 membingungkan (of behavior).
upshot	kb. kesudahan, hasil. the u. of the matter was that... hasil dari urusan itu ialah bahwa.....
upside	kk. u. down terbalik. to turn a room u. down membolak-balik seluruh isi kamar. to turn a pillow u. down membalikkan bantal.
upstage	kkt. 1 inf.: memperlakukan (secara) kasar. 2 bersikap sombong dan tinggi hati.
upstairs	kb. tingkat atas. -ks. di tingkat atas. u. living room kamar duduk di tingkat atas. -kk. diatas, di tingkat atas.
upstanding	ks. 1 tulus, baik dan terhormat (of a person). 2 berdiri tegak (of hair).
upstart	kb. 1 seorang yang baru naik. 2 orang kaya baru, okabe.
upstate	ks. bagian/daerah utara negara bagian. to live in u. new york tinggal di udik negara bagian new york.
upstream	kk. kehulu, ke udik.
upsurge	kb. kenaikan.
upswept	ks. disisir (melengkung) keatas (of hair).
upswing	kb. 1 golf : ayunan pukulan keatas. 2 bus.: pertambahan kemajuan.
uptake	kb. inf.: to be quick on the u. pintar, cepat mengerti, tajam otaknya, ringan kepala.
uptight	ks. sl.: gelisah, tegang, ciut hati.
uptown	ks., kk. dikota bagian atas (kota). the u. shopping center pusat tempat berbelanja di kota bagian atas.
upturn	kb. econ.: perbaikan, kemajuan.
upturned	ks. menengadah. with u. face dengan muka menengadah.
upward(s)	ks. (me)naik. u. trend kecenderugan yang menaik. -kk. keatas.
upwind	kk. melawan (arah) angin.
uranium	kb. uranium.
urban	ks. yang berkaitan dengan kota. u.area daerah kota. u. population penduduk kota. u. reneval pembaharuan kota.
urbane	ks. sopan (santun), berbudi bahasa.
urbanity	kb. (j. -ties) kesopanan, kehalusan budi.
urbanization	kb. urbanisasi.
urbanize	kkt. menjadikan kota, mengkota-kan.
urchin	kb. anak melarat/miskin.
ureter	kb. saluran kencing.
urethra	kb. saluran kencing (dan sperma) dalam kemaluan, pekencingan.
urge	kb. keinginan, dorongan. to feet/have the u. to ingin sekali. -kkt. 1 mendorong. 2 meminta, mendesak.
urgency	kb. (j. -cies) urgensi, keadaan yang mendesak. it's a matter of great u. keadaannya sangat mendesak.
urgent	ks. urgen, mendesak. u. need kebutuhan yang penting. the matter is u. hal ini genting. -urgently kk. amat, sangat. a doctor is u. needed seorang dokter amat dibutuhkan.
urinal	kb. tempat kencing, perkemihan.
urinalysis	kb. analisa air kencing.
urinary	ks. yang mengenai air kencing. u. tract jalan perkencingan,
urinate	kki. kencing, buang air kecil.
urine	kb. air kencing/seni.
urn	kb. pasu, semacam kendi, ceret, jambangan besar.
urologist	kb. penyakit-penyakit saluran kemih/kencing.
urology	kb. ilmu penyakit-penyakit saluran kencing.
ursa	kb. u. mayor bintang biduk/jung.
us	kg. kami, kita. go with us pergi dengan kami.
us, u.s.	[united states] kb. amerika serikat (as).
usable	ks. dapat dipakai/dipergunakan.
usaf	[united states air force] angkatan udara as.
usage	kb. 1 pemakaian. 2 (cara) pemakaian kata-kata.
uscc	[united states coast guard] pengawal pantai as.
usda	[united states department of agriculture] departemen pertanian as.
use	kb. 1 penggunaan. 2 kegunaan. 3 gunanya. -kkt. 1 menggunakan, mempergunakan, memakai (s.t.). -used ks. bekas. -used to 1 dulu, dahulu. we u. to be friends kami dahulu/pernah berkawan 2 biasa.
useful	ks. berguna, bermanfaat, berfaedah. make yourself u. usahakanlah supaya kamu berguna. -usefully kk. dengan berguna. u. employed dipekerjakan/dipakai dengan berguna.
usefulness	kb. kegunaan. to outlive o's u. meliwati kegunaannya.
useless	ks. 1 tak berguna/bermanfaat. u. invention penemuan yang tak berguna. 2 percuma. it's u. to ... percuma saja... 3 sia-sia.
uselessness	kb. ketidakgunaan.
user	kb. pemakai. that country is a heavy u. of rice negeri itu banyak menggunakan beras.
usher	kb. 1 pelayan, penjaga pintu (at theater). 2 penerima tamu (at wedding). -kkt. mengantar(kan). to u. s.o. to his seat mengantarkan seseorang ketempat duduknya.
usherette	kb. penunjuk jalan, penerima tamu, pelayan wanita.
usia	[united states information agency] kantor perwakilan penerangan amerika serikat.
usis	[united states information service] kb. jawatan penerangan as.
usma, u.s.m.a.	[united states military academy] akademi militer as.
usmc	[united states marine corps] kko angkatan laut as.
usn	[united states navy] angkatan laut as.
usna	[united states naval academy] akademi angkatan laut as.
usnr	[united states naval reserve] pasukan cadangan angkatan laut as.
uso	[united service organization] badan penghibur angkatan bersenjata.
uss	[united states steamship] kapal api amerika serikat.
ussr, e.s.s.r.	[union of soviet socialist republics] kb. uni republik-republik sovyet sosialis, uni sovyet (us).
usual	kb. biasa. i'll have the u. yang biasa saja. -ks. biasa, lazim. -usually kk. biasanya.
usurer	kb. lintah darat, tukang riba.
usurious	ks. luar biasa tinggi. a u. rate of interest nilai bunga yang keterlaluan.
usurp	kkt. merebut(kan), merampas kuasa.
usurpation	kb. perebutan/perampasan kuasa.
usurper	kb. perampas kuasa, pengambil-alih kuasa, perebut (kekuasaan).
usury	kb. (j. -ries) riba. to practice u. makan/menjalankan riba.
utensil	kb. alat, perkakas. household utensils alat/perabot rumah-tangga. writing utensils alat tulis-menulis.
uterine	ks. yang berkaitan dengan kandung (peranakan). u. kin saudara tiri seibu.
uterus	kb. rahim, kandungan (peranakan).
utilitarian	ks. berfaedah, bermanfaat.
utility	kb. (j. -ties) 1 keperluan. the tenant pays all utilities penyewa membayar segala keperluan (pemanas air, penerangan dan air (leding). 2 kegunaan.
utilization	kb. penggunaan, pemanfaatan.
utilize	kkt. menggunakan, memanfaatkan, mempergunakan. to u. the opportunity memanfaatkan kesempatan.
utmost	kb. to the u. sepenuhnya. -ks. yang sepenuhnya.
utopia	kb. negara khayalan/idaman / impian, utopia.
utopian	ks. berupa khyalan, tidak praktis.
utter	ks. sama sekali. it is u. chaos keadaan sama sekali kacau-balau. -kkt. 1 mengucapkan. 2 memanjatkan (a prayer). 3 melahirkan, mengeluarkan (o's thoughts). -utterly kk. samasekali.
utterance	kb. ucapan, ungkapan. to give u. to o's happiness mengungkapkan/melahirkan kebahagiaannya.
uttermost	= utmost.
uvula	kb. anak lidah/tekak.
uvular	ks. phon.: diucapkan dengan anak lidah.
v	kb. huruf ke -22 dalam abjad inggris. v-neck kb. leher berbentuk v (of sweater, shirt).
v.	1 [verb] katakerja. 2 [verse] sajak, bait. 3 [versus] lawan. 4 [vocative] vokatip. 5 vice] wakil. 6 [volume] jilid.
v.a.	1 [veterans administration] administrasi veteran. 2 [vice admiral] laksamana madya.
v.c.	kb. 1 [vietcong] vietcong. 2 [vice consul] wakil konsul.
v.i.	[virgin islands] kepulauan virgin.
v.p., vp	[vice-president] wakil presiden.
va	[veteran administration] administrasi veteran.
va.	[virginia] negarabagian as.
vacancy	kb. (j. -cies) lowongan. " no v." "penuh." "tiada kamar kosong," "tiada lowongan pekerjaan."
vacant	ks. 1 kosong (of a house). 2 lowong (of a job, post). 3 ngelamun, teringa-inga, kosong, hampa (of a look).
vacate	kkt. 1 mengosongkan (the premises, o's office, a room). 2 melowongi.
vacation	kb. liburan. to take a v., to be on v. berlibur. -kki. berlibur.
vacationist	kb. pelibur, orang yang berlibur.
vacationland	kb. daerah untuk berlibur.
vaccinate	kkt. mencacar (for smallpox).
vaccination	kb. pencacaran. v. certificate surat cacar.
vaccinator	kb. pencacar.
vaccine	kb. vaksin.
vacillate	kki. terombang-ambing (between antara). -vacillating ks. bimbang.
vacillation	kb. kebimbangan.
vacuous	ks. kosong.
vacuum	kb. pakum, kekosongan, ruangan hampa. v. bottle/flask botol pakum, tabung hampa udara. -kkt. membersihkan babut dengan alat penghisap debu (a room, rug). vacuum-packed ks. dimasukkan kaleng tak berhawa (coffee).
vagabond	kb. pengembara, (orang) gelandangan.
vagary	kb. (j. -ries) tingkah, tingkah-laku yang aneh, canda.
vagina	kb. liang peranakan, farji, puki, pukas.
vaginal	kb. yang berkaitan dengan liang peranakan.
vagrancy	kb. (j. -cies) pergelangan.
vagrant	kb. 1 orang gelandangan, pengembara. 2 tunawisma.
vague	ks. samar-samar, tidak jelas. i haven't the vaguest idea saya tak ada pengertian sedikitpun. -vaguely kk. samar-samar, tidak jelas.
vagueness	kb. kesamaran, ketidakjelasan.
vain	kb. in v. dengan sia-sia. -ks. 1 sombong (person). 2 sia-sia (hope, effort). -vainly kk. dengan sia-sia, gagal.
vainglorious	ks. sombong, angkuh, besar kepala.
valance	kb. renda kelambu/seprei.
vale	kb. lembah. this v. of tears mayapada, dunia ini.
valedictory	kb. (j. -ries) pidato perpisahan.
valence	kb. valensi.
valentine	kb. tanda kasih. valentine's day tanggal 14 pebruari.
valet	kb. pelayan pria.
valiant	ks. (gagah-) berani. -valiantly kk. dengan keberanian/kepahlawanan.
valid	ks. 1 sah, syah, absah, sahih (contract, excuse). 2 benar (statement). no longer v. tidak berlaku lagi.
validate	kkt. mensyahkan, mengsahkan.
validation	kb. pengesahan.
validity	kb. (j. -ties) 1 kebenaran (of a statement). 2 keabsahan, berlakunya (of a passport).
valise	kb. kopor kecil.
valley	kb. lembah.
valor	kb. keberanian.
valuable	kb. valuables j. barang-barang berharga. -ks. berharga.
valuation	kb. 1 penilaian. 2 penaksiran.
value	kb. nilai. -values j. nilai-nilai. -kkt. 1 menilai (o's jewelry) (at pada). 2 menghargai (s.o's opinion). -valued ks. yang dihargai (of a friend).
valueless	ks. tanpa nilai/harga.
valve	kb. klep, katup, pentil. heart v. katup jantung. v. of an oyster katup tiram.
vamoose	kki. sl.: pergi, mengundurkan diri dengan cepat.
vamp	kb. perempuan nakal, penggoda.
vampire	kb. 1 mayat pengisap. 2 pemeras. 3 wanita yang menggoda lelaki karena uang atau pujian.
van	kb. 1 mobil gerbong. furniture v. mobil gerbong pengangkut perkakas rumah. 2 barisan depan. to be in the v. menjadi pelopor.
vandal	kb. perusak.
vandalism	kb. perusakan, sifat suka merusak.
vane	kb. baling-baling.
vanguard	kb. barisan depan. to be in the v. dibarisan depan.
vanilla	kb. panili. u. extract sari panili.
vanish	kki. lenyap, menghilang. to dwindle to the vanishing point berkurang hingga titik yang habis/hilang sama sekali.
vanity	kb. (j. -ties) 1 kesombongan (of a person). 2 kesia-siaan (of the world). v. case kotak/peti barang-barang rias.
vanquish	kkt. menaklukkan, mengalahkan, menundukkan. -vanquished kb. j. orang-orang yang kalah. -ks. yang tewas (people).
vantage	kb. v. point tempat yang menguntungkan.
vapid	ks. hambar, tawar (smile, drink).
vapor	kb. asap, uap air, kukus.
vaporize	kkt. menguapkan. -kki. menguap.
vaporizer	kb. alat penguap.
var.	1 [variation] variasi, selingan. 2 [variety] keanekawarnaan. 3 [various] beraneka, bermacam.
variable	kb. faktor tak tetap. -ks. berubah-ubah (cloudiness).
variance	kb. perbedaan (in antara). at v. 1 berbeda (with dengan). 2 bertengkar, berselisih.
variant	kb. sesuatu yang berlainan (of dari). -ks. berbeda. v. spelling ejaan yang berbeda.
variation	kb. 1 perbedaan (in temperature). 2 variasi, selingan (in music, speech).
varicose	ks. v. vein urat darah terentang, pembuluh mekar.
varied	lih vary.
variegated	ks. beraneka-warna, aneka ragam.
varies	lih vary.
variety	kb. (j. -ties) 1 macam. 2 keseragaman, keanekawarnaan, keanekaragaman. 3 selingan 4 variasi.
various	ks. bermacam, pelbagai, berbagai. of v. kinds berbagai corak. to talk about v. things berbicara tentang berbagai hal. -variously kk. dengan berbagai cara.
varnish	kb. pernis, minyak rengas. -kkt. mem(p)ernis, merengas.
varsity	kb. (j. -ties) regu universitas.
vary	kkt. (varied) 1 merubah (the food). 2 merubah-rubah, mengubah-ubah (the speed/tempo). 3 menyelang-nyelingkan (the music). -kki. 1 berubah-ubah. 2 berbeda-beda (in brightness). -varied ks. banyak macam. -varying ks. yang bermacam-macam.
vascular	ks. yang berkaitan dengan pembuluh darah. v. system sistim pembuluh darah.
vase	kb. jambangan, pot bunga.
vasectomy	kb. (j. -mies) vasektomi.
vaseline	kb. semacam salep/pelumas dibuat dari minyak tanah kental yang lunak.
vassal	kb. 1 budak. 2 pengikut.
vast	ks. 1 luas (plains). 2 sangat banyak (a mounts, sums of money). -vastly kk. sangat. v. overrated sangat dilebih-lebihkan mutunya.
vastness	kb. keluasan.
vat	vat
vatican	kb. vatikan.
vaudeville	kb. komidi bangsawan.
vault	kb. 1 kubah (in a church). 2 ruangan besi (in a bank). 3 kolong (for wine). -kkt. 1 meloncat galah. 2 lih pole v. - kki. melompati ( a fence or stream).
vb.	[verb] katakerja.
vd	[veneral disease] kb. penyakit kelamin/kotor.
veal	kb. daging anak lembu.
vector	kb. panah/garis vektor.
veep	[vice president] kb. sl.: wakil presiden.
veer	kb. belokan, tikungan. to make a sudden v. membelok tiba-tiba. -kki. membelok. to v. sharply membelok dengan tajam.
vegetable	kb. sayur(an), sayur-mayur. v. soup sop sayuran. -vegetables sayur mayur yang hijau, sayur-mayur daun-daunan. -ks. nabati. v. fat lemak nabati.
vegetarian	kb. orang yang hanya makan sayuran.
vegetate	kki. hidup seperti tumbuh-tumbuhan, hidup tanpa guna.
vegetation	kb. tumbuh-tumbuhan.
vehemence	kb. sifat berapi-api, kehebatan. to speak with v. of berbicara dengan berapi-api tentang.
vehement	ks. penuh semangat, berapi-api. to be v. in berapi-api dalam. -vehemently kk. dengan birahi, dengan suara keras, dengan penuh nafsu/gairah.
vehicle	kb. 1 kendaraan, wahana. 2 pembawa, sarana. language serves as the v. of ideas bahasa berfungsi sebagai pembawa buah pikiran. 3 kapal. space v. kapal ruang angkasa.
vehicular	ks. yang mengenai kendaraan. v. traffic lalu lintas kendaraan.
veil	kb. 1 kudung, kerudung. 2 tudung. 3 selubung. 4 kabut. -kkt. mengerudungi, menyelubungi. -veiled ks. diselubungi.
vein	kb. 1 anat.: urat darah halus. 2 barik-barik (in wood, marble). 3 nada. 4 lapisan (of coal).
velar	ks. phon.: yang berkaitan dengan bagian belakang langit-langit.
vellum	kb. naskah yang ditulis pada kulit binatang.
velocity	kb. (j. -ties) kecepatan.
velum	kb. phon.: bagian belakang langit-langit, bagian langit-langit yang lunak.
velvet	kb. beledu, beludru.
venal	ks. dapat disuap/disogok (conduct).
vend	kkt. menjual keliling, menjaja.
vendetta	kb. dendam (yang turun-temurun) terhadap anggota keluarga yang membunuh anggota keluarganya sendiri.
vendor	kb. penjaja, penjual keliling.
veneer	kb. lapisan (kayu halus) (on furniture). a thin v. of civilization lapisan peradaban yang tipis. -kkt. 1 mem(p)ernis). 2 melapisi dengan lapisan kayu halus.
venerability	kb. sifat terhormat, keagungan.
venerable	ks. yang patut dimuliakan.
venerate	kkt. memuliakan. -venerated ks. mu'tabar, mu'tabir, terhormat.
veneration	kb. pemujaan (for s.t). to look upon s.o. with v. memandang seseorang dengan rasa hormat.
venereal	ks. v. disease penyakit kelamin/kotor.
vengeance	kb. balas dendam. to take v. on membalas dendam terhadap. with a v. dengan sekuat tenaga, bersungguh-sungguh, dengan sepenuh hati.
vengeful	ks. menaruh (rasa) dendam.
venial	ks. ringan, yang dapat diampuni (of a sin).
venison	kb. daging rusa/menjangan.
venom	kb. 1 bisa (of a reptile). 2 kesengitan.
venomous	ks. 1 berbisa (of reptiles). 2 sengit (attack on s.o.).
venous	ks. yang berkaitan dengan urat darah halus.
vent	kb. lubang (angin). keep the v. open biarlah lubang angin terbuka. -kkt. melepaskan. to v. o's anger melepaskan kemarahannya.
ventilate	kkt. menukar udara (a room). to v. o's anger melontarkan kemarahannya.
ventilation	kb. ventilasi, peranginan, peredaran hawa. the v. of (s) o's affairs membeberkan persoalan-persoalan pribadi.
ventilator	kb. kipas angin.
ventral	ks. yang mengenai perut. v. fin sirip perut.
ventricle	kb. kamar (jantung).
ventriloquist	kb. pembicaraan perut, ahli bicara perut.
venture	kb. 1 perbuatan yang mengandung risiko atau bahaya. 2 spekulasi. 3 usaha. -kkt. mengajukan (an opinion, a guess). -kki. pergi.
venturesome	ks. berani, suka berpetualang.
venue	kb. tempat terjadinya kejahatan atau kejadian (penting). a chang of v. perubahan tempat pengadilan.
venus	kb. bintang johar, zohral.
veracious	kb. 1 benar (of testimony). 2 jujur (person).
veracity	kb. (j. -ties) 1 kejujuran (of a witness). 2 ketelitian (of an instrument).
veranda(h)	kb. beranda, serambi.
verb	kb. katakerja.
verbal	ks. 1 lisan. v. agreement persetujuan lisan. 2 yang berkaitan dengan katakerja. v. ending akhiran katakerja. -verbally kk. secara lisan.
verbalize	kkt. mengungkapkan dengan kata-kata.
verbatim	ks., kk. secara kata demi kata, secara harfiah.
verbiage	kb. terlalu banyak kata-kata yang tak berguna.
verbose	ks. berbicara bertele-tele.
verdant	ks. hijau, yang menghijau.
verdict	kb. putusan. to bring in, to return, a v. of guilty memberi putusan bersalah.
verge	kb. 1 pinggir (of a cliff). 2 ambang. -kki. berbatasan dengan.
verification	kb. vertifikasi, pembuktian, tahkik.
verifies	lih verify.
verify	kkt. (verified) 1 memeriksa, menguji (the accuracy of s.t.). 2 membuktikan, mentahkikkan (a theory, a report).
verily	lih very.
veritable	ks. benar-benar. he's a v. reservoir of information ia benar-benar merupakan sumber keterangan.
verity	kb. (j. -ties) kebenaran. the eternal verities kebenaran-kebenaran yang abadi.
vermicelli	kb. semacam bihun atau mi.
vermilion	kb., ks. merah terang.
vermin	kb. (j. -min) 1 bintang kecil yang mengganggu seperti kutu-kutu dsb. 2 orang hina.
vermouth	kb. semacam air anggur yang putih atau agak kuning warnanya.
vernacular	kb. bahasa daerah, logat asli. as we say in the v. seperti dikatakan dalam bahasa sehari-hari. -ks. yang berkaitan dengan bahasa rakyat. v. style gaya bahasa sehari-hari.
vernal	ks. yang berkaitan dengan musim semi.
versatile	ks. 1 cakap dalam berbagai hal (of a person). she's a v. writer ia seorang penulis yang kesanggupannya meliputi berbagai bidang. 2 serbeguna, aneka guna (of instruments).
versatility	kb. (j. -ties) kepandaian yang beraneka ragam, kepandaian dalam banyak hal.
verse	kb. 1 sajak, syair. 2 bible : ayat (kitab suci).
versed	ks. benar-benar mengetahui, berpengalaman, benar-benar mengenal. to be well v. in benarbenar mengetahui tentang.
versification	kb. penggubahan/pengarangan syair.
versifies	lih versify.
versify	kki. (versified) mengarang/mengubah syair.
version	kb. 1 versi (of a story). 2 terjemahan.
versus	kd. (me)lawan. ohio university v. miami universitas ohio melawan universitas miami.
vertebra	kb. (j. -rae) tulang-belakang/ punggung.
vertebrate	kb. binatang/hewan bertulang belakang.
vertex	kb. (j. -texes, -tices) puncak.
vertical	ks. 1 tegak lurus, vertical. 2 menurun. 3 dari atas. -vertically kk. dengan tegak lurus.
vertices	lih vertex.
vertigo	kb. kepentingan, rasa pusing, kepusingan.
verve	kb. semangat, kegairahan hati.
very	ks. itu juga. the v. day pada hari itu juga. -kk. sekali, amat, sangat. v. good baik sekali. v. soon dengan sangat segera. -verily kk. bahwasanya, dengan sesungguhnya.
vesicle	kb. gelembung.
vespers	kb., j. kebaktian malam/senja.
vessel	kb. 1 nav.: kapal. 2 tempat, bejana (for liquids). 3 anat.: pembuluh.
vest	kb. rompi. v. pocket saku rompi. -kkt. memberi. vest-pocket ks. saku. -ks. tetap, bagi pribadi.
vestibule	kb. ruang depan.
vestige	kb. bekas, sisa.
vestment	kb. pakaian kegerejaan, jubah.
vestry	kb. (j. -ries) 1 kamar tempat menyimpan barang-barang dan pakaian-pakaian keagamaan dalam gereja. 2 tempat bersekolah atau berdoa.
vet	kb. inf.: 1 dokter hewan. 2 veteran.
vet.	1 [veteran] veteran. 2 [veterinarian] dokter hewan.
veteran	kb. 1 mil.: veteran. 2 kawakan, orang yang berpengalaman. v. reporter wartawan kawakan.
veterinarian	veterinarian
veterinary	kb. (j. -ries) dokter hewan. v. medicine kedokteran hewan. v. service jawatan kehewanan.
veto	kb. veto. right of v. hak veto. -kkt. memveto.
vex	kkt. menyakiti/menyakitkan hati, menjengkelkan, mendongkolkan. -vexing ks. menjengkelkan, mengesalkan.
vexation	kb. kekesalan, kejengkelan hati.
vexatious	ks. menjengkelkan.
via	kd. lewat, melalui, via, melewati.
viability	kb. kelangsungan hidup (of people, the economy).
viable	ks. 1 dapat hidup (terus), dapat berjalan (of the economy, of a government). 2 bersemangat, bergairah, aktip, giat.
viaduct	kb. jembatan diatas jalan.
vial	kb. botol kecil.
viands	kb., j. bahan makanan (yang terpilih).
vibrant	ks. 1 bergetar (tones). 2 bersemangat (spirits).
vibrate	kki. menggetar, bergetar.
vibration	kb. getaran.
vibrator	kb. alat penggetar.
vicar	kb. vikaris, paderi, pendeta yang mewakili paus.
vicarious	ks. seolah mengalami sendiri, dialami orang lain, dilakukan untuk orang lain.
vice	kb. 1 sifat buruk. what's your worst v.? apakah sifatmu yang paling buruk ? 2 perbuatan jahat. v. squad polisi susila.
vice-	aw. wakil, muda. vice-admiral laksamana madya. vice-chairman wakil ketua.
viceroy	kb. raja muda.
viceversa	kk. sebaliknya.
vicinity	kb. (j. -ties) sekitar, hampiran. to live in the v. of tinggal disekitar. bogor and its v. bogor dan (daerah) sekitarnya.
vicious	ks. 1 ganas, jahat (person, animal). 2 keji, buruk (remark). 3 hebat sekali (tootache). 4 kejam (criticism). v. circle lingkaran setan, lingkaran yang tak berujung-pangkal. -viciously kk. jahat, kejam, tidak benar.
viciousness	kb. sifat jahat, kejahatan, kekejaman.
vicissitude	kb. pergantian, perubahan.
victim	kb. korban. v. of circumstances korban keadaan. to fall v. to menjadi korban.
victimization	kb. penipuan, pembohongan, pengorbanan.
victimize	kkt. menjadikan korban.
victor	kb. pemenang, juara.
victorious	ks. yang menang. v. team regu yang menang. to be v. over menang/jaya dalam, mencapai kemenangan dalam.
victory	kb. (j. -ries) kemenangan.
victuals	kb. inf.: makanan-makanan.
video	ks. v. (transmission) penyiaran atau penerimaan gambar (pada tv).
videotape	kb. siaran ulangan tv dari pita gambar.
vie	kki. (vying) bersaingan, berlomba-lomba. to v. for bersaingan mencapai. to v. with s.o. bertanding dengan seseorang.
vietnam	kb. vietnam.
vietnamese	kb. 1 orang vietnam. 2 bahasa vietnam. -ks. vietnam.
view	kb. 1 pemandangan. 2 pandangan, pendapat. 3 maksud. 4 gambaran. 5 pandangan, tinjauan. -kkt. 1 melihat. 2 melihat, menonton (a film). 3 memandang, menganggap.
viewer	kb. 1 penonton (of films). 2 pirsawan (of tv). 3 alat untuk melihat film slide, peneropong (for viewing slides).
viewpoint	kb. sudut, pandangan, segi pendapat.
vigil	kb. berjaga(-jaga). to keep v. tetap berjaga(-jaga) / siap-siaga.
vigilance	kb. kewaspadaan.
vigilant	ks. waspada.
vigilante	kb. anggota panitia siap siaga.
vignette	vignette
vigor	kb. 1 kekuatan, tenaga. 2 kegiatan. to do s.t. with v. melakukan sesuatu dengan giat.
vigorous	ks. 1 giat. 2 penuh semangat. to make a v. attempt berusaha dengan bersemangat. 3 hebat-hebatan. v. campaign kampanye hebat-hebatan. -vigorously kk. dengan penuh semangat, dengan dahsyat.
vile	ks. 1 busuk (odor). 2 kotor, keji (words, person). 3 buruk (weather). 4 hina (work, task). 5 buruk sekali (temper).
vileness	kb. keburukan (of the weather, smell, language).
vilification	kb. fitnahan, pencemaran.
vilify	kkt. (vilified) memfitnah, memburuk-burukkan, menjelek-jelekkan, mencemarkan.
villa	kb. villa, rumah indah (diluar kota).
village	kb. 1 desa, dusun. the whole v. turned out seluruh penduduk desa keluar. 2 kampung. indian v. perkampungan orang indian.
villager	kb. orang desa/udik/dusun.
villain	kb. 1 penjahat, bajingan. 2 (movie) peranan penjahat.
villainous	ks. keji, kejam.
villainy	kb. (j. -nies) kejahatan, kekejian.
vim	kb. 1 kekuatan. v. and vigor kekuatan dan kegiatan. 2 kegiatan, semangat.
vindicate	kkt. 1 membersihkan (a claim, o's rights).
vindication	kb. 1 usaha mempertahankan nama baik, pembersihan nama, pemulihan nama baik. 2 pertahanan.
vindictive	ks. ingin membalas dendam.
vine	kb. 1 tumbuh-tumbuhan yang merambat. 2 tanaman anggur. to wither on the v. gagal, gugur, berakhir sebelum waktunya.
vinegar	kb. cuka.
vineyard	kb. kebun anggur.
vintage	kb. model tahun, hasil buatan/panen pada sesuatu tahun.
viola	kb. biola alto.
violate	kkt. 1 melanggar (a law). 2 mengganggu (s.o's privacy). 3 memperkosa, memperogol (a woman). 4 menghina (a church).
violation	kb. 1 pelanggaran (of a law, of o's privacy). 2 perkosaan (of a woman).
violator	kb. pelanggar. 2 pemerkosa (of a woman).
violence	kb. 1 kekerasan, kehebatan (on the picket line). 2 kekejaman (of war).
violent	ks. 1 gerang, bengis (temper). 2 sengit (argument). 3 hebat (storm). 4 keras (of exercise, a blow). 5 berat sekali (headache). 6 kasar (of a mental patient, language). -violently kk. 1 dengan keras. 2 dengan hebat.
violet	kb. bunga violet. -ks. warna lembayung. v. rays sinar lembayung.
violin	kb. biola.
violinist	kb. pemain biola.
violoncello	kb. selo.
vip	[very important person] kb. inf.: pembesar, tokoh penting.
viper	kb. 1 (snake) ular berbisa. 2 orang jahat/busuk.
viral	ks. disebebkan kuman virus. v. pneumonia radang paru disebabkan kuman virus.
virgin	kb. perawan, anak dara. v. mary perawan suci. v. territory daerah terbuka yang belum dibuka. v. wool wol murni.
virginity	kb. keperawanan, kegadisan.
virgo	kb. zod.: sunbulat. 2 astr.: bintang mayang.
virgule	kb. garis miring (/).
virile	ks. jantan, bersifat laki-laki. 2 kuat.
virility	kb. (j. -ties) 1 kejantanan. 2 kekuatan.
virtual	ks. sebetulnya. -virtually kk. sebenarnya.
virtue	kb. 1 kebaikan, kebajikan. 2 sifat (baik).
virtuosity	kb. (j. -ties) keahlian/kepandaian dalam tehnik.
virtuoso	kb. ahli pemain (alat musik).
virtuous	ks. 1 berbudi tinggi/luhur. to lead a v. life menjalani hidup suci. 2 saleh.
virulence	kb. 1 sifat amat berbisa (of a disease). 2 kejahatan (of s.o's temper). 3 kedahsyatan (of an attack upon s.o.).
virulent	ks. 1 yang dapat mematikan, membinasakan (of a poison). 2 jahat (of a disease, temper).
virus	kb. virus, badi. v. pneumonia radang paru-paru karena kuman virus.
vis-a-vis	ks. sebagai lawan, ber(hadap)-hadapan.
visa	kb. visum, visa.
visage	kb. wajah, roman muka.
viscera	kb., j. jeroan, isi rongga perut.
visceral	ks. mendalam (reaction).
viscosity	kb. (j. -ties) sifat merekat/kental.
viscount	kb. gelar kebangsawanan di inggris (diantara pangeran dan baron).
viscous	ks. melekat, merekat, kental, liat.
vise	kb. ragum, catok.
visibility	kb. (j. -ties) jarak penglihatan.
visible	ks. kelihatan, tampak. v. to the naked eye dapat dilihat dengan mata belaka. -visibly kk. nampak.
vision	kb. 1 penglihatan, daya lihat. he has good v. penglihatannya baik. 2 pandangan. 3 impian, bayangan (of a great future).
visionary	kb. (j. -ries) pengelamun, penghayal kosong.
visit	kb. kunjungan. -kkt. mengunjungi, berkunjung. 2 inf.: omong-omong. -kki. 1 singgah, bertamu, berkunjung.
visitation	kb. 1 kunjungan resmi, perkunjungan. 2 rahmat atau hukuman tuhan. 3 wabah, pengamukan (of a pestilence).
visitor	kb. pengunjung, tamu. visitors not permitted tamu-tamu dilarang masuk.
visor	kb. kelep pici. windshield v. kelep kaca depan.
vista	kb. 1 pemandangan (through trees). 2 pandangan. to open up new vistas membuka pandangan-pandangan baru.
visual	ks. visuil. v. acuity ketajaman mata. v. aids alat-alat peraga. -visually kk. yang dapat dilihat, dengan cara yang tampak/yang dapat disaksikan.
visualize	kkt. membayangkan, menggambarkan dalam khayalan.
vita	kb. riwayat hidup.
vital	ks. 1 hayati, hidup. 2 membahayakan, mematikan. 3 sangat penting, amat diperlukan (problem). -vitally kk. amat. v. interested in amat menaruh perhatian terhadap.
vitality	kb. (j. -ties) 1 daya/tenaga hidup. 2 kekuatan, tenaga.
vitamin(e)	kb. vitamin, pitamin.
vitiate	kkt. merusak, melemahkan meniadakan.
vitreous	ks. seperti kaca.
vitriolic	ks. sangat tajam.
vituperation	kb. makian dengan kata-kata kasar. to heap v. on s.o. memaki-maki seseorang dengan kata-kata yang kasar, mengata-ngatai seseorang.
vivacious	ks. 1 (peng)gembira, (pe)riang. 2 bersemangat.
vivaciousness	= vivacity.
vivacity.	kb. (j. -ties) 1 kegembiraan hidup. 2 semangat.
vivavoce	kk. dengan lisan.
vivid	ks. 1 hidup. v. description gambaran yang hidup. 2 gamblang. 3 bersemangat, giat. v. personality pribadi yang bersemangat.
viviparous	ks. melahirkan anak hidup.
vivisection	kb. pembedahan hidup-hidup.
vixen	kb. rubah betina.
viz.	kk. yaitu, yakni.
voa	[voice of america] suara amerika.
vocabulary	kb. (j. -ries) perbendaharaan kata, daftar kata-kata, kosa kata. v. entry kata yang dimasukkan dalam daftar kata.
vocal	ks. 1 yang berkaitan dengan suara. v. cord pita suara. 2 suka mengeluarkan pendapat of voters, strikers). -vocally kk. dengan lisan, diucapkan, dinyanyikan.
vocalic	ks. yang berkaitan dengan suara. v. sound huruf hidup.
vocalist	kb. 1 biduan, penyanyi. 2 (female) biduanita, penyanyi.
vocalize	kkt. 1 membunyikan (a sound). 2 menyuarakan (o's feelings). -kki. menyanyi.
vocation	kb. lapangan kerja, pekerjaan. to miss o's v. kehilangan lapangan kerjanya.
vocational	ks. kejuruan. v. education pendidikan kejuruan. v. guidance bimbingan kejuruan. v. school sekolah kejuruan.
vocative	kb. gram.: vokatip, bentuk penyeru. v. case kasus vokatip.
vociferous	ks. riuh, hiruk-pikuk.
vogue	kb. mode. in v. sedang digemari.
voice	kb. suara. 2 bentuk. 3 gram.: ragam gramatikal. 4 penyanyi. 5 pengaruh. -kkt. 1 menytatakan (an opinion). 2 menyuarakan (sound). v. vote pemungutan suara secara lisan. -voiced ks. phone.: disuarakan, bersuara. -voicing kb. penyuaraan.
voiceless	ks. phon.: tak bersuara.
void	kb. kekosongan, kehampaan. to fill the v. mengisi kelowongan. -ks. tidak berlaku lagi 9of passport, ballot). -kkt. 1 membatalkan (a contract). 2 berak, buang air.
voile	kb. kain pual.
vol.	[volume] jilid.
volatile	ks.1 mudah menguap (of gasoline). 2 berubah pendirian (of disposition).
volcanic	ks. yang berkaitan dengan gunung api. v. ash abu gunung berapi. v. eruption letusan gunung berapi.
volcano	kb. 1 gunung (ber) api. 2 ketidakstabilan (in society).
volition	kb. kemauan. of o's own v. atas kemauannya sendiri.
volley	kb. 1 berondongan (of shots). 2 tenn.: pukulan bola sebelum bola itu jatuh ke tanah. -kkt., kki. tenn : memukul bola sebelum jatuh ketanah.
volleyball	kb. bola voli.
vols.	[volumes] jilid-jilid.
volt	kb. volt, pol.
voltage	kb. tegangan volt, voltasi.
volubility	kb. kesukaan mengomong, kepanjangan lidah, keramahan mulut.
voluble	ks. fasih, dapat berbicara lancar. -volubly kk. dengan ketangkasan berbicara, dengan mulut( nya) yang bocor, karena suka mengomong.
volume	kb. 1 (book) jilid. 2 banyak. 3 suara, bunyi. 4 volume, volume, isi. 5 gumpalan.
voluminous	ks. sangat besar (works, overcoat). he was a v. correspondent ia banyak melakukan surat-menyurat.
voluntary	ks. 1 sukarela. 2 fakultatif. 3 sengaja. -voluntarily kk. dengan sukarela.
volunteer	kb. 1 mil.: sukarelawan, sukwan (male), sukarelawati, sukwati (female). 2 pekerja sukarela (at hospital). -kkt. 1 menyampaikan secara sukarela. 2 bersukarela.
voluptuous	ks. menggairahkan, menggiurkan.
vomit	kb. muntahan. -kkt. memuntahkan. -kki. muntah.
voodoo	kb. guna-guna, ilmu sihir.
voracious	ks. 1 rakus, lahap. she's a v. reader ia rakus (betul) membaca. 2 besar sekali (of appetite).
vortex	kb. 1 (whirlpool). pusaran air. 2 pusat kisaran, pusaran (of a storm).
votary	kb. (j. -ries) pecandu, penggemar.
vote	kb. 1 suara. 2 hak memilih. 3 mosi. 4 pemilihan. -kkt. 1memberikan suara untuk. 2 (declare) menyatakan. 3 mengusulkan. vote-getter orang yang pandai memikat hati pemilih. -voting kb. pemungutan suara.
voter	kb. pemilih, pemberi suara.
votive	ks. yang memenuhi nazar. v. offering persembahan untuk memenuhi nazar.
vouch	kkt., kki. menjamin. to v. for s.o. menjamin seseorang.
voucher	voucher
vouchsafe	kkt. bersedia memberikan (information).
vow	kb. 1janji. marriage vows janji kawin. 2 kaul. to swear a v. bersumpah. he swore a v. never to marry ia bersumpah tak akan kawin selama-lamanya. -kkt. bersumpah, mengangkat sumpah.
vowel	kb,. huruf hidup, vocal.
voyage	kb. perjalanan, pelayaran. -kki. mengadakan perjalanan.
voyager	kb. orang yang mengadakan pelayaran.
vs.	[versus] (me)lawan.
vt.	[vermont] negarabagian di as.
vulcanize	kkt. mempulkanisir.
vulcanologist	kb. ahli gunung (ber)api.
vulcanology	kb. ilmu gunung berapi.
vulgar	ks. 1 kasar. v. manners tingkahlaku yang kasar. 2 tidak sopan. 3 kasar, cabul, carut (language).
vulgarity	kb. (j. -ties) kekasaran, ketidaksopanan.
vulgate	kb. terjemahan injil dalam bahasa latin.
vulnerability	kb. sifat mudah kena serang atau luka.
vulnerable	ks. 1 mudah diserang, mudah kena serang. v. to ridicule mudah diejek. 2 mudah mendapat kritikan, mudah kena kecaman. 3 bridge : dapat kalah lipat.
vulture	kb. burung heriang.
vulva	kb. pukas, puki, kemaluan wanita.
vying	lih vie.
w	kb. huruf ke-23 dari abjad inggris.
w.	1 [west(ern)] sebelah barat, barat. 2 [with] dengan.
w. va.	[west virginia] negarabagian di as.
w.c.	[water closet] kb. wese, kakus, jamban, w.c.
w.i.	[west indies] hindia barat.
w.w.	1 [wednesday] hati rabu. 2 [west] barat. 3 [western] (di bagian sebelah) barat. 4 [washington] washington.
wa(a)c	[women's army auxiliary) corps ] kb. korps wanita angkatan darat.
wackiness	kb. sl.: kesintingan, keedanan.
wacky	ks. sl.: sinting, edan, sendeng, singit.
wad	kb. 1 gumpal. a w. of cotton segumpal kapas. 2 berkas. -kkt. (wadded) to w. up menggulung, menggumpal(kan). -wadding kb. gumpalan, bahan kapas (untuk pengisi).
waddle	kb. goyangan, guncangan. to walk with a w. berjalan terkedek-kedek/tergoyang-goyang (seperti bebek). -kki. berjalan terkedek-kedek, bergoyang-goyang.
wade	kb. seberangan, penyebrangan. -kkt. menyeberang, mengarungi (a stream). -kki. to w. in 1 datang menyeberangi air. 2 inf.: datang menyerbu (of the police). inf.: to w. into menyerang (s.o).
waf	[women's air force] kb. korps wanita angkatan udara.
wafer	kb. 1 semacam biskit tipis. 2 semacam tablet berisi bubuk obat.
waffle	kb. kue sepit/wafel. w. iron cetakan kue sepit/wafel.
waft	kkt. membawa, menghembus.
wag	kb. 1 pelawak, orang jenaka. 2 kebaran, kibasan (of the tail). -kkt. (wagged) mengibas-ngibaskan (the tail). -kki. 1 mengibaskan (of a tail). 2 mengobrol, bergunjing, menggunjing (of tongues).
wage	kb. gaji, upah. -kkt. to w. war berperang.
wager	kb. taruhan, petaruh(an). to make a w. bertaruh. -kkt., kki. berani bertaruh. to w. on a horse memasang taruhan pada seekor kuda, bertaruh pada/atas seekor kuda.
waggish	ks. jenaka, suka bersenda-gurau/ bercanda.
waggle	kkt. mengibas-ngibaskan (the tail). -kki. mengibas.
wagon	kb. 1 gerbong, kereta. w. train iring-iringan kereta berkuda. 2 (battle-) kapal perang. 3 mobil stasion-wagon.
wagonload	kb. muatan sekereta penuh.
wahoo	kseru, horee.
waif	kb. anak terlantar.
