glamorous	ks. sangat menarik dan mempesonakan.
glamour	kb. daya tarik.
glance	kb. pandangan sekilas. -kki. melihat sekilas. to g. over membaca secara sepintas lalu. glancing blow pukulan sipi, pukulan yang luput.
gland	kb. kelenjar.
glandular	ks. yang berhubungan dengan kelenjar. g. tissue jaringan kelenjar.
glare	kb. 1 cahaya yang menyilaukan. 2 pandangan sorotan. -kki. membelalang, membelalak. -glaring ks. 1 yang menyilaukan. 2 yang menyolok.
glass	kb. 1 kaca. 2 gelas. 3 cermin. 4 (spy-) teropong. -glasses j. 1 kacamata. 2 (spy-) teropong. to see s.t. through rase-colored glasses melihat sesuatu secara amat optimistis.
glassful	kb. segelas penuh.
glasshouse	kb. = greenhouse.
glassmaker	kb. pembuat barang-barang elok dari gelas.
glassmaking	kb. pembuatan gelas.
glassware	kb. barang pecah-belah.
glassworks	kb. paberik kaca.
glassy	ks. 1 seperti kaca. g. sea laut seperti kaca. 2 tolol, dungu. he had a g. look pandangannya seperti orang tolol. g. stare tatapan hampa dan dungu.
glaucoma	kb. glaukoma.
glaze	kb. 1 lapisan (of ice). 2 upaman (on a china cup). -kkt. mengacai, memasang kaca (a window, picture).
glazier	kb. tukang kaca.
gleam	kb. 1 pancaran cahaya. 2 sekilas. -kki. 1 berkilat, berseri-seri. 2 bersinar.
glean	kkt. mengumpulkan sedikit. to g. all available data mengumpulkan sedikit demi sedikit semua keterangan yang ada.
glee	kb. riang, gembira. g. club paduan suara (disekolah).
gleeful	ks. dengan riang-gembira. -gleefully kk. dengan gembira-ria, dengan sangat gembira.
glen	kb. lembah kecil, celah-celah gunung.
glib	ks. lincir mulut/lidah, fasih.
glide	kb. 1 gerakan yang luwes. 2 phon.: huruf atau bunyi semivokal. 3 av.: peluncuran (tanpa memakai motor), penerbangan layang. -kki. 1 meluncur. 2 berlalu. 3 masuk dengan lemah-gemulai. 4 av.: terbang layang. -gliding kb. meluncur dengan pesawat terbang.
glider	kb. 1 (pesawat) peluncur, pesawat terbang layang. 2 furn.: kursi ayunan.
glimmer	kb. 1 cahaya yang samar-samar. 2 cahaya redup. -kki. berkelip redup (of a candle, fire).
glimpse	kb. penglihatan/pandangan sekilas. to catch a g. of s.o. melihat seseorang sekilas. -kkt. memandang melihat sepintas lalu.
glint	kb. 1 kilatan. the g. of silver kilatan perak. 2 cahaya yang menyilaukan mata.
glisten	kki. berkilau-kilauan. the diamond glistened in the light intan itu berkilau-kilauan kena cahaya.
glitter	kb. kegemilapan, kemegahan. the g. of the occasion kegemilapan peristiwa. -kki. berkerlap, berkerlip, gemerlapan.
gloat	kki. merenungkan dengan hati senang, melihat dengan tamak. to g. over o's wealth melihat dengan tamak kepada kekayaannya.
glob	kb. gumpal, selekeh.
global	ks. sedunia, sejagad. g. war perang (se)dunia.
globe	kb. 1 barang bulat/bundar seperti bola. 2 geog.: bola (peta) bumi. 3 elec.: lampu bola.
globetrotter	kb. pengeliling dunia.
globular	ks. bulat, bundar, berbentuk bola.
globule	kb. percikan, tetesan. globules of sweat percikan keringat.
gloom	kb. 1 kesuraman, kemurungan. 2 kegelapan.
gloomy	ks. 1 suram, muram, murung. to have a g. disposition sikap bermuram-durja. 2 mendung. g. day hari mendung.
glorification	kb. pemujaan.
glorify	kkt. (glorified) 1 memuja. 2 mengagungkan. 3 memuliakan. -glorified ks. dipuja. the house is a g. shack rumah itu adalah pondok yang diperindah.
glorious	ks. 1 mulia, agung. 2 meriah. 3 gilang-gemilang. g. weather cuaca cerah. -gloriously kk. senang. g. happy sangat senang.
glory	kb. (j. -ries) 1 kemuliaan keagungan. 2 semarak, cahaya kemuliaan. inf.: to be in o's g. merasa puas, bangga. -kki. to g. in merasa bangga dalam.
gloss	kb. permukaan yang halus (of furniture). 2 terjemahan, komentar, keterangan. -kkt. membubuhi catatan atau keterangan.
glossary	kb. (j. -ries) daftar kata-kata. g. of technical terms daftar istilah-istilah tehnik.
glossy	ks. yg megkilat. g.photo foto yg mengkilap. g. magazine majalah yg dicetak pd kertas yg mengkilap.
glottal	ks. yg berh. dgn celah suara. g.stop hamzah, penghentian suara dlm celah suara.
glottis	kb. celah suara.
glove	kb. sarung tangan. to fit like a g. cocok benar. g. compartment laci kecil didekat setir mobil.-gloved ks. bersarung.
glow	kb. sinar (of sunset, happiness).2 cahaya (of fire).3 suasana.-kki.1 memancarkan cahaya.2 berpijar.-glowing ks.1 yg bersemangat.2 menyala-nyala.-glowingly kk. dgn bersemangat.
glower	kkt. memandang,menatap dgn tajam. to g. at memandang dgn marah kpd.
glowworn	kb. ulat kelap-kelip.
glucose	kb. glukosa,sakar,gula anggur.
glue	kb. lem,perekat.-kkt.1 menempelkan.2 merapatkan. to be glued 1 terpaku.2 terpancang.3 tertambat.
glum	ks. muram, suram, murung.
glut	kb. persediaan yg melimpah-limpah. kkt (glutted) memakan dgn lahap.
gluten	kb. zat perekat (dlm ketan), perekat.
glutinous	ks. lengket, leceh, melekat.
glutton	kb. seorang rakus, pelahap, seorang gelojoh. he's a g. for punishment ia sudah kebal terhadap hukuman-hukuman.
gluttony	kb. (j. -nies) kerakusan.
glycerin(e)	kb. gliserin.
gmc	[germanic] yang berhubungan dengan bahasa-bahasa jerman.
gmt, g.m.t.	[greenwich mean time] waktu greenwich.
gnarled	ks. monggol, berkenjal-kenjal.
gnash	kkt. mengertakkan, mengeritkan. to g. o's teeth menggertakkan gigi. -gnashing kb. gertakan/kertakan gigi.
gnat	kb. agas yang suka menggigit. to strain at a g. menaruh keberatan terhadap hal kecil.
gnaw	kkt. menggerogoti. to g. a hole in a wall menggerogoti lubang di dinding. -kki. 1 menggerogoti lubang di dinding. 2 mengerkah. 3 mengganggu. -gnawing kb. there was a g. in his stomach perutnya rasanya. ks. perih sekali.
gneiss	kb. gneiss.
gnome	kb. jembalang, orang cebol/katai.
gnp, g.n.p.	[gross national product] hasil kotor nasional.
go	kb. 1 kesempatan. 2 giliran. -kki. (went, gone) 1 pergi. 2 berangkat. 3 hancur. 4 meninggal. 5 hilang. 6 berjalan. 7 (ber)bunyi. 8 jatuh. 9 lari. 10 naik. 11 putus. 12 menuju. 13 diperhentikan. 14 boleh. 15 diatur. 16 menjadi. -gone ks. terpesona.
goad	kb. tongkat/galah untuk menghalau. -kkt. mendorong. he was goaded beyond endurance by... dia didorong dengan tidak tertahan-tahan oleh..
goal	kb. 1 gawang. 2 cita-cita. 3 gol. 4 tujuan, sasaran.
goalie	kb. = goalkeeper.
goalkeeper	kb. kiper, penjaga gawang, penggawang.
goat	kb. 1 kambing. 2 bandot (tua). 3 orang yang dipersalahkan. sl.: to get s.o's g. membuat marah/kesal.
goatee	kb. janggut seperti janggut kambing.
gob	kb. 1 gumpal. 2 nau.: sl.: kelasi as.
gobble	kb. kokok (kalkun). -kkt. 1 melahap. to g. down/up o's food menelan makanannya dengan cepat. 2 membeli habis (bargains). -kki. berkokok (of a turkey).
gobbledygook	kb. inf.: uraian yang berbelit-belit dan sulit untuk dipahami.
gobbler	kb. kalkun jantan.
goblet	kb. gelas minum berbentuk piala.
goblin	kb. hantu, setan, jin, jembalang, peri.
gocart	kb. kereta beroda untuk anak-anak
god	kb. dewa. g. tuhan (yang maha esa). -god-fearing ks. saleh, taqwa. -god-given ks. yang diberikan tuhan.
godchild	kb. bayi yang di baptiskan digereja dan bersama itu juga diwalikan kepada orang lain.
goddaughter	kb. bayi perempuan yang dibaptiskan di gereja dan bersama itu juga diwalikan kepada orang lain.
goddess	kb. dewi.
godfather	kb. wali laki-laki seorang bayi.
godforsaken	ks. terkutuk. g. town kota yang terkutuk.
godhead	kb. kedewaan. the g. ketuhanan.
godlike	ks. ilahi(yah) kedewaan.
godliness	kb. 1 keilahian, ketuhanan. 2 kesalehan.
godly	ks. saleh. g. life kehidupan yang saleh.
godmother	kb. wali wanita seorang bayi.
godown	kb. gudang.
godparent	kb. seorang laki-laki atau perempuan yang menjadi wali atas seorang bayi.
godsend	kb. sesuatu yang tak terduga dan menggembirakan
godson	kb. seorang bayi laki-laki yang dibaptiskan di gereja dan bersama itu juga diwalikan kepada orang lain.
godspeed	kb. semoga saudara berhasil.
goes	lih = go.
goggle	kki. terbeliak mata, melotot, membelalak. -goggles j. kacamata debu. goggle-eyed ks. dengan mata terbeliak.
goiter, goitre	kb. gondok, gondong, beguk.
gold	kb. (e) mas, kencana. gold-bearing ks. yang mengandung emas. g. mine a) tambang emas. b) sumber kekayaan. g. standard standar emas.
goldbrick	kki. inf.: malas-malasan.
golden	ks. 1 terbuat dari emas. 2 keemas-emasan 3 sangat baik/bagus. g. aniversary ulang tahun kelimapuluh. g. jubilee hari ulang tahun setengah abad. g, rula kaidah kencana. g. wedding ulang tahun kelimapuluh hari perkawinan.
goldfish	kb. ikan mas. g. bowl bak kaca untuk ikan emas. to live in a g. bowl menjadi tontonan orang.
goldsmith	kb. pandai/tukang emas.
golf	kb. golf. g. club a) tongkat/ketokan/ getokan golf. b) perkumpulan. g. course/links lapangan golf.
golfer	kb. pemain golf.
golly	kseru. astaga !
golosh	= galosh.
gone	lih go.
goner	kb. inf.: yang mati/amblas. we're goners if we can't escape kita akan menjadi korban kalau tak dapat melarikan diri.
gong	gong ,gung.
goniometry	kb. goniometri. ilmu ukur sudut.
gonorrh(o)ea	kb. kencing nanah, gonorea.
goo	kb. bahan yang pekat dan melengket seperti perekat.
good	kb. kebaikan, kebajikan. -goods j. 1 harta benda, barang-barang. 2 sl.: kesanggupan, potensi. -ks. (better, best) 1 baik. 2 baik, budiman. 3 baik, susila. 4 enak, sedap. 5 utuh. 6 manis, dapat diminum. 7setia. 8 lumayan. 9 layak. 10 cakap, pintar.
goodly	ks. 1 yang lumayan. a g. crowd sejumlah orang yang lumayan. 2 berlimpah-limpah. a. g. harvest panen yang berlimpah-limpah.
goodness	kb. kebaikan, kebajikan. -kseru. waduh, masya allah.
goody	kb. (j. -ies) inf.: makanan yang lezat, kueh-kueh, gula-gula. a goody-goody seorang yang usahanya untuk berbuat baik berlebih-lebihan sehingga memualkan.
gooey	ks. sl.: liat dan melengket.
goof	kb. sl.: kesalahan. -kki. keliru. i goofed saya keliru. to g. off membuang-buang/menyia-nyiakan waktu.
goofy	ks. sl.: bodoh, dungu, tolol.
gook	kb. sl.: kotoran yang melengket.
goon	kb. sl.: 1 orang jahat. 2 orang yang bodoh sekali.
goose	kb. (j. geese) angsa. g. feathers bulu-bulu angsa. g. egg a) telor angsa. b) sl.: angka nol.
gooseberry	kb. (j. -ries) semacam buah frambus.
goosebump	kb. inf.: tegak bulu roma.
gopher	kb. semacam tikus tanah.
gordian	ks. to cut the g. knot mengambil keputusan dengan cepat untuk mengakhiri keraguan.
gore	kb. darah kental. -kkt. melukai dengan tanduk.
gorge	kb. jurang, ngarai kecil yang curam. -kkt. makan dengan rakus. to g. o.s. on beans mengisi perut sepenuh-penuhnya dengan buncis.
gorgeous	ks. indah, permai.
gorilla	kb. gorila.
gory	ks. yang penuh dengan lumuran darah, berdarah.
gosh	kseru. wah !
gosling	kb. anak angsa.
gospel	kb. ajaran. the g. of hard work ajaran bekerja keras. the g. kitab injil, pewarta rahayu. the g. truth kebenaran mutlak.
gossamer	kb. siratan benang yang halus, jaringan laba-laba, jaringan yang tipis lagi halus, kain tipis serta halus, sutera yang tipis.
gossip	kb. 1 guncing, kabar angin, buah mulut. the g. is that... kabar anginnya ialah bahwa... 2 (a person) penggunjing, tukang fitnah. -kki. menggunjing, memfitnah, bergunjing. g. column isi pojok.
got	lih get. got up in berpakaian dalam. i've g. to go saya harus pergi.
gotten	lih get.
gouge	gouge ,kkt. 1mencungkil ( s.o' s eyes ).2 inf:menipu,mengeksploitasi ( s.o.)
goulash	kb. gulai daging.
gourd	kb. labu (manis), kendur.
gourmet	kb. ahli pencicip makanan.
gout	kb. encok, sengal.
gov.	[governor] gubernur.
gov. gen.	[governor general] gubernur jenderal.
govern	kkt. 1 memerintah (a country). 2 menguasai (o's temper). 3 menentukan (a decision). 4 berpengaruh atas . -kki. memerintah. -governing ks. yang memerintah.
governable	ks. bisa dikuasai/diperintah. his temper is g. perangainya dapat dikuasai.
governess	kb. seorang wanita yang digaji untuk mengajar anak-anak di rumah.
government	kb. 1 pemerintah. 2 pemerintahan. 3 ilmu pemerintahan/politik.
governmental	ks. yang berhubungan dengan pemerintah. g. committee panitia pemerintah.
governor	kb. 1 gubernur. g. general gubernur jenderal. 2 (alat) pengatur (on an engine).
governorship	kb. jabatan gubernur.
govt., govt.	[government] pemerintah(an).
gown	kb. 1 pakaian wanita. 2 gaun. 3 (academic, judicial, religious) jubah. 4 baju panjang.
gpo,  g.p.o.	[government printing office] kantor percetakan negara.
gr.	[greek] yunani.
gr. brit.	[great britain] britannia raya.
grab	kb., j. sl.: up for grabs (sudah) tersedia, tinggal (meng)ambil. -kkt. (grabbed) 1 merebut, menjambret, menyerobot. 2 menangkap. 3 mengambil. g. bag karung undian.
grace	kb. 1 gaya lemah gemulai, keanggunan, keapikan. 2 (perpanjangan) waktu, waktu kelonggaran 3 doa kecil (sebelum makan). -kkt. 1 menghormati. 2 menyemarakkan.
graceful	ks. lemah-gemulai, anggun.
gracious	ks. sangat ramah. she's a g. hostess ia nyonya rumah yang sangat ramah. -kseru. g., what's happened ? astaga, ada apa ? good g., no ! ya allah, tidak/jangan !
graciousness	kb. keluwesan, keanggunan.
grad	kb. inf.: tamatan, lulusan. = graduate.
gradation	kb. gradasi. the range of g. is wide jarak gradasi itu besar.
grade	kb. 1 (mark) angka. 2 kelas. 3 kelas, kwalitas. 4 tanjakan. -the grades j. sekolah dasar. -kkt. 1 memberi angka (papers). 2 memeriksa. 3 menggolong-golongkan. 4 meratakan. grade- a ks. yang bermutu tinggi.
grader	kb. 1 penilai, pemberi angka. (of papers). 2 murid. a fifth g. murid kelas lima.
gradient	kb. tinggi/curam tanjakan, lereng.
gradual	ks. berangsur-angsur, sedikit demi sedikit, setahap demi setahap. -gradually kk. secara berangsur-angsur. her health is g. improving kesehatannya berangsur-angsur pulih.
graduate	kb., ks. tamatan, lulusan. -kki. tamat sekolah. to g. from mendapat gelar (sarjana muda dsb) dari. g. studies pelajaran tingkat sarjana. -graduated ks. yang dibagi dalam kelas-kelas. g. flask botol yang memakai tanda ukuran.
graduation	kb. 1 tamat sekolah. 2 upacara tamat sekolah. g. day (university or college) hari sarjana/wisuda.
graft	kb. 1 sogok- menyogok, korupsi, permainan sogok. 2 med.: pemindahan (kulit). -kkt. mengenten, mencabangkan. -grafting kb. okulasi, cangkokan.
grafter	kb. koruptor, pencoleng.
graham	g. cracker biskit yang seluruhnya terbuat dari tepung terigu.
grain	kb. 1 butir padi, buah/biji padi-padian. 2 urat/kembang kayu (in wood). 3 kesatuan berat di inggris. -graining kb. urat/kembang kayu.
gram	kb. gram.
grammar	kb. 1 tatabahasa. 2 buku tatabahasa. g. school sekolah dasar/rendah/rakyat.
grammarian	kb. ahli tatabahasa.
grammatical	ks. dari atau berhubungan dengan tatabahasa. -grammatically kk. dipandang dari sudut tatabahasa. it's g. correct tatabahasanya benar.
gramophone	kb. gramopon, peti bicara/nyanyi, rekor-cenjer.
granary	kb. (j. -ries) lumbung.
grand	kb. sl.: seribu dolar. -ks. 1 agung. 2 menyenangkan. 3 inf.: hebat. g. prize hadiah pertama. g. duke adipati. g. jury dewan juri. g. larceny pencurian besar-besaran. g. old party partai republik(en) di as. g. opera opera yang bersifat drama.
grandchild	kb. cucu.
granddad(dy)	kb. (j. -dies) kakek.
granddaughter	kb. cucu perempuan.
grandeur	kb. kemuliaan, kebesaran, kehebatan, keagungan.
grandfather	kb. kakek, embah/eyang lelaki. g. clock jam besar yang berdiri.
grandiloquent	ks. penuh dengan kata yang muluk-muluk/melangit.
grandma	kb. inf.: nenek, embah/eyang perempuan.
grandmother	kb. nenek, (e)mbah eyang perempuan.
grandnephew	kb. cucu lelaki.
grandniece	kb. cucu perempuan.
grandpa	kb. inf.: kakek, embah/eyang lelaki.
grandparent	kb. eyang, embah.
grandson	kb. cucu lelaki.
granite	kb. granit, batu besi.
granny	kb. (j. -nies) inf.: nenek.
grant	kb. dana/uang bantuan. -kkt. 1 mengabulkan (a request). 2 memberi (a charter). 3 mengakui. 4 tanggung. grant-in-aid bantuan uang. -granted boleh, silakan. to take for granted 1 diterima selaku benar. 2 menganggap pasti. granting that sungguhpun.
grantee	kb. penerima beasiswa, siswa tugas belajar.
granular	ks. terjadi dari atau berisi butir-butiran yang kecil.
granulated	ks. berbentuk butir-butiran. g. sugar gula pasir.
granule	kb. biji, butir.
grape	kb. buah anggur.
grapefruit	kb. semacam jeruk yang besar.
grapevine	kb. tanaman anggur. inf.: to hear via the g. mendengar melalui selentingan.
graph	kb. grafik(a). g. paper kertas grafik.
graphic	ks. 1 jelas seperti keadaan yang sebenarnya. g. description uraian/penuturan yang jelas sekali. 2 yang berhubungan dengan grafik. 3 yang berhubungan dengan tulisan tangan.
graphite	kb. grafit.
graphology	kb. ilmu tulisan tangan.
grapple	kki. 1 bergulat, memegang erat-erat. to g. with a thief bergulat dengan pencuri. 2 berjuang, menghadapi. grappling hook/iron jepitan/penggenggam besi.
grasp	kb. genggaman. -kkt. 1 merenggut. 2 memegang. 3 menyambar, merebut. 4 mengerti ,memahami. -grasping ks. tamak, loba.
grass	kb. 1 rumput. a) menghalaukan ternak ke padang rumput. b) mempensiunkan, memberhentikan. 2 sl.: mariyuana, ganja. g. widow janda, seorang wanita yang sudah diceraikan. g. widower seorang lelaki yang sudah bercerai, duda.
grasshopper	kb. belalang. inf.: kneehigh to a g. amat pendek.
grassland	kb. padang rumput.
grassy	ks. yang ditutup/penuh dengan rumput. grassy-green ks. hijau rumput.
grate	kb. salaian, garangan, panggangan. -kkt. memarut (coconut, cheese). -kki. berciut. grated cheese keju parutan.-grating kb. kisi, jeruji. ks. mengganggu, menjengkelkan.
grateful	ks. berterima kasih.
grater	kb. parutan. cheese g. parutan keju.
gratification	kb. kepuasan, kegembiraan.
gratify	kkt. (gratified) 1 memberi kebahagiaan/kepuasan, memuaskan. 2 memenuhi. -gratified ks. puas, bahagia, senang. -gratifying ks. memuaskan.
gratin	kb. keju parutan. potatoes au g. kentang yang dimasak dengan diberi parutan keju diatasnya.
gratis	kk. dengan percuma, cuma-cuma, perdeo, gratis. the job was done g. pekerjaan itu gratis.
gratitude	kb. terimakasih. to express g. to bersyukur kepada.
gratuitous	ks. serampangan, yang tidak beralasan. g. assumption dugaan yang tidak beralasan. g. insult penghinaan yang tidak pada tempatnya.
gratuity	kb. (j. -ties) persen.
grave	grave , kb. kuburan ,g.robber :perampok kuburan.to have a watery g .terkubur di dlm air.
gravedigger	kb. penggali kuburan.
gravel	kb. (batu) kerikil. g. pit tambang batu kerikil.
graven	ks. g. image patung berhala.
graveside	kb. sisi kuburan.
gravestone	kb. (batu) nisan.
graveyard	kb. makam, pekuburan, pusara. car g. timbunan mobil-mobil tua.
graving	ks. g. dock dok galian.
gravitate	kki. 1 mengendap. to g. to the bottom mengendap ke dasar. 2 condong, cenderung. he is gravitating towards chemistry ia condong pada ilmu kimia.
gravitation	kb. 1 gravitasi. 2 kecenderungan, kecondongan.
gravitational	ks. mengenai daya tarik bumi. g. pull daya-tarik bumi.
gravity	kb. (j. -ties) 1 phys.: gaya berat. 2 kegawatan (of a situation).
gravy	kb. (j. -ies) 1 kuah daging, saus. g. boat mangkuk kuah. 2 sl.: keuntungan yang mudah didapat. sl.: to ride the g. train menikmati kekayaan dan kemewahan tanpa bersusah payah.
gray	kb. (warna) abu-abu, kelabu. -ks. 1 abu-abu, kelabu. g. suit stelan abu-abu. 2 mendung. g. day hari mendung. -kki. beruban, menguban. gray-haired, gray headed ks. beruban. inf.: g. matter otak kecerdasan.
grayish	ks. keabu-abuan.
graze	kkt. 1 menggembalakan / mengangon ternak (cattle). 2 menyerempet. 3 menyentuh. -kki. makan rumput. grazing animal angonan, ternak yang sedang makan rumput. g. land tanah penggembalaan.
grease	kb. 1 lemak, lumas, minyak semir. 2 vet, gemuk. -kkt. 1 menggemuki, melumas, meminyaki. 2 memulas. g. gun pistol gemuk, alat penyemprot gemuk
greasy	ks. 1 berminyak. g. food makanan yang berminyak. 2 yang bermanis mulut. his g. way caranya yang bermanis mulut. sl.: g. spoon rumah makan murah dan kotor.
great	kb. jago, juara. -ks. 1 besar. 2 terkenal, termasyur. 3 hebat. 4 tinggi. 5 baik. 6 akrab. 7 agung. 8 inf.: senang. -greatly kk. sangat, amat. g. distressed sangat sedih.
greatness	kb. kebesaran, kejayaan, kemegahan.
grecian	ks.yang berhubungan dengan yunani.
greece	kb. negeri yunani.
greed	kb. ketamakan, kelobaan, kerakusan.
greediness	= greed.
greedy	ks. tamak, loba, rakus. g. for money lapar uang. -greedily kk. dengan rakus/lahap/tamak/loba.
greek	kb. 1 orang yunani. 2 bahasa yunani. it's g. to me saya tidak mengerti sama sekali. -ks. yang berhubungan dengan yunani. the g. church gereja yunani kuno.
green	kb. 1 (warna) hijau. 2 golf : lapangan green. 3 (food) sayuran berwarna hijau (seperti bayam). -ks. 1 hijau. 2 muda, hijau. 3 yang belum berpengalaman. g. light a) lampu hijau. b) izin, permisi. g. pepper cabe(hijau).
greenback	kb. uang kertas.
greenery	kb. (j. -ries) tumbuh-tumbuhan hijau.
greenhorn	kb. orang yang belum berpengalaman, orang yang masih hijau.
greenhouse	kb. rumah/ruang kaca.
greenroom	kb. kamar tempat seniman-seniman beristirahat.
greenwich	kb. g. time waktu greenwich.
greet	kkt. menyambut (the guests). -greeting kb. 1 sambutan. warm g. sambutan yang hangat. 2 salam. to send greetings to berkirim salam kepada g. card kartu ucapan selamat.
gregarious	ks. 1 seorang yang suka berteman, yang suka sekali berkumpul-kumpul. 2 yang suka hidup berkelompok (of cattle, sheep).
grenade	kb. granat.
grew	lih grow.
grey	= gray.
greyhound	kb. sejenis anjing yang tinggi dan langsing (biasanya dipakai untuk pacuan).
grid	kb. 1 kisi tempat pemanggangan (ikan, daging). 2 jaringan (listrik, gas dsb).
griddle	kb. wajan ceper.
griddlecake	kb. kue dadar.
gridiron	kb. 1 alat masak berupa kisi, alat pemanggang. 2 sport : lapangan football/hijau.
grief	kb. dukacita, kesedihan. to come to g. mendapat kesulitan, gagal, mengalami kegagalan. grief-stricken ks. berdukacita, tertimpa kesedihan.
grievance	kb. keluhan.
grieve	kkt. berdukacita, bersedih hati (over atas).
grievous	ks. yang menyedihkan/memilukan. g. error kesalahan yang menyedihkan.
grill	kb. 1 alat pemanggang, tempat pembakar. 2 panggangan. -kkt. 1 memanggang (food). 2 memeriksa terus-menerus, menanyai dengan keras. to g. a suspect menanyai terdakwa dengan keras. grilled steak daging panggang.
grille	kb. kisi-kisi, jerejak, terali.
grillwork	kb. jerejak besi, terali dari besi, kisi- kisi.
grim	ks. 1 suram, seram, cemberut. 2 teguh, kuat. grim-visaged ks. bermuka cemberut.
grimace	kb. geringsing (muka). to (make a ) g. meringis, menyeringai.
grime	kb. lumur, debu yang melekat, kotoran.
grimy	ks. sangat kotor.
grin	kb. seringai, ringis. -kkt. (grinned) to g. approval tersenyum lebar tanda setuju. -kki. meringis, menyeringai. to g. and bear s.t. sanggup menahan sesuatu tanpa mengeluh.
grind	kb. 1 inf.: pekerjaan yang berat dan membosankan. 2 inf.: seorang yang tekun dalam belajar. -kkt. (ground). 1 menggerinda. 2 menggertakkan (teeth). 3 menggiling(wheat,grain). 4 mengisar, memutar. 5 mengasah. 6 menggilas-gilaskan. 7 melindas.
grinder	kb. 1 (alat) penggiling. 2 gerinda.
grindstone	kb. batu asahan, gerinda. to keep o's nose to the g. bekerja lama dan berat, bekerja keras dan tekun.
grip	kb. 1 pegangan. 2 genggaman, cengkaman. 3 cengkeraman. 4 koper kecil. -kkt. (gripped) 1 memegang erat-erat (an arm, railing, etc). 2 menarik sekali, memikat. 3 menyepit. -kki. pakem. -gripping (of a story, experience). ks. yang sangat menarik perhatian.
gripe	kb. keluhan. -kki. inf.: mengeluh, mengomel. -griping kb. omelan, keluhan, keluh-kesah.
griper	kb. tukang mengeluh.
grippe	kb. penyakit inpluensa.
grisly	ks. yang mengerikan. the g. remains sisa-sisa yang mengerikan.
grist	kb. biji padi-padian yang hendak atau telah digiling. everything he says is g. for his opponent's mill semua yang dikatakannya menguntungkan bagi pihak lawannya.
gristle	kb. tulang muda/rawan.
gristly	ks. liat.
grit	kb. 1 pasir atau kerikil yang halus. 2 ketabahan. -grits j. jagung giling kasar, bubur jagung. -kkt. (gritted) menggertakkan (the teeth).
gritty	ks. berpasir, seperti pasir. the spinach tastes g. bayam itu rasanya berpasir.
grizzled	ks. beruban.
grizzly	ks. g. bear semacam beruang yang sangat besar dan buas.
groan	kb. rintihan, erangan, resah. -kki. 1 merintih, mengerang. 2 berkeluh keberatan. -groaning kb. suara mengerang/merintih, erang, rintihan.
grocer	kb. penjual bahan makanan/ pangan.
grocery	kb. (j. -ries) toko penjual bahan makanan, toko pangan. = g. store. -groceries j. bahan makanan.
grogginess	kb. kepeningan, kepuyengan.
groggy	ks. pening, puyeng, terhuyung-huyung. i feel g. saya merasa puyeng.
groin	kb. kunci paha.
groom	kb. 1 pengantin/mempelai laki-laki. 2 tukang kuda. -kkt. mengurus, merawat (a horse). he is always well-groomed dia senantiasa kelihatan rapi sekali.that horse is well-groomed kuda itu dipelihara baik-baik.
groomsman	kb. (j. -men). laki-laki pengiring penganten laki-laki.
groove	kb. 1 alur, galur, lekuk. the grooves in a dirt road galur-galur pada jalan tanah.2 lurah. sl. in the g. berjalan baik. to get out of the g. meninggalkan pekerjaan sehari-hari. -kkt. menggalur, membuat alur. -grooved ks. beralur, berlekuk-lekuk.
groovy	ks. sl. menyenanglkan., manis (potongannya).
grope	kkt. 1 meraba-raba. to g. for a hand meraba-raba mencari tangan. 2 mencari-mencari. to g. for the proper word mencari-cari kata yang tepat.
gross	kb. 12 lusin, gros, 144. -ks. 1 kotor. 2 besar. 3 kasar. 4 bruto. 5 yang menyolok. -kkt. mendapat keuntungan kotor. g. ton = long ton. -grossly kk. terlalu, nyata sekali.
grotesque	ks. fantastis, aneh sekali.
grotto	kb. gua, ngalau.
grouch	kb. penggerutu, perengut. -kki menggerutu, mengeluh, merengut.
grouchy	ks. bersungut-sungut, yang menggerutu.
ground	lih grind.
groundbreaking	kb. pencangkulan pertama. g. -ceremony upacara pencangkulan (tanah) pertama.
groundless	ks. 1 tanpa dasar. her fears were g. ketakutannya tanpa dasar. 2 isapan jempol. that story is g. cerita itu isapan jempol belaka.
groundskeeper	kb. perawat gelanggang olahraga.
groundwork	kb. dasar. to lay the g. for... meletakkan dasar-dasar untuk..
group	kb. 1 kelompok, golongan. 2 grup. -kkt. menggolong-golongkan, membagi-bagi atas kelompok-kelompok. -kkt. berkumpul, mengelompok (around disekeliling, mengelilingi). -grouping kb. pengelompokan, penggrupan.
grouse	kb. sejenis burung belibis. -kki. mengomel. he's always grousing about s.t. ia senantiasa mengomel/menggerutu mengenai sesuatu.
grove	kb. belukar, hutan kecil. orange g. rumpun tanaman jeruk.
grovel	kki. merendahkan diri, menyembah-nyembah. to g. before s.o. menyembah-nyembah kepada seseorang, merendahkan diri dihadapan seseorang.
grow	kkt. (grew, grown) 1 menanam (vegetables). 2 memelihara. -kki. 1 tumbuh. 2 bertambah. 3 menjadi. -grown ks. yang sudah dewasa. grown-up kb. orang dewasa. -growing kb. pertumbuhan. ks. semakin meningkat.
grower	kb. penanam. rice g. penanam padi. that plant is a rapid g. tanaman itu tumbuhnya cepat.
growl	kb. belasut. to utter a g. at s.o. menggeramkan kepada seseorang. -kki. 1 menggeram. 2 berkata dengan marah, membelasut. 3 terkelik (of the stomach). his stomach is growling perutnya berbunyi.
grown	lih. grow.
growth	kb. 1 pertumbuhan. 2 pertumbuhan, perkembangan. 3 kutil.
grub	kb. 1 tempayak. 2 inf,: makanan. -kkt. (grubbed). to g. up mencungkil, membongkar.
grubby	ks. kotor.
grudge	kb. dendam. -kkt. iri hati. to g. a friend any profit iri hati akan tiap-tiap keuntungan temannya. -grudgingly kk. dengan enggan/segan. she g. accepted the invitation dengan enggan dia menerima undangan itu.
grueling	ks. sangat meletihkan. g. race perlombaan yang sangat meletihkan.
gruesome	ks. yang mengerikan. g. sight pemandangan yang mengerikan.
gruff	ks. keras, kasar. g. voice suara yang keras/kasar. -gruffly kk. dengan keras. to speak g. bercakap dengan keras pedas.
grumble	kb. keluhan, omelan. -kki. menggerutu, mengeluh. to g. about s.t. menggerutu tentang sesuatu. -grumbling kb. pengomelan, pengeluhan. ks. yang menggerutu. in a g. tone of voice dengan suara menggerutu.
grumbler	kb. penggerutu, pengeluh.
grumpy	ks. galak, marah-marahan.
grunt	kb. 1 dengkur (of hogs). 2 bunyi ngorok. -kkt. to g. o's assent memberikan persetujuan dengan menggerutu. -kki. mendengkur, mengorok.
gsa	[general service administration] jawatan pelayanan umum.
gt. br., gt. brit	[great britain] britannia/inggris raya.
guano	kb. pupuk dari tahi burung atau kelelawar.
guar.	[guaranteed] dijamin.
guarantee	kb. jaminan, garansi. -kkt. 1 menjamin. 2 memberi garansi. -guaranteed ks. dijamin, terjamin.
guarantor	kb. penjamin. to act/stand as g. for his debt bertindak sebagai penjamin utangnya.
guaranty	kb. (j. -ties) penjaminan.
guard	kb. 1 pengawal, penjaga. 2 penjagaan. 3 kunci. -kkt. 1 menjaga. 2 berhati-hati, berjaga-jaga. 3 melindungi. -kki. to g. against berhati-hati terhadap. -guarded ks. berhati-hati. -guardedly kk. dengan berhati-hati.
guardhouse	kb. gardu, rumah jaga, rumah monyet.
guardian	kb. wali. g. angel malaikat pelindung.
guardianship	kb. perwalian.
guardrail	kb. pagar.
guardsman	kb. (j. -men) 1 pengawal. 2 tentara as.
guava	kb. jambu biji/lutuk, biawas.
gubernatorial	ks. yang berhubungan dengan gubernur. g. contest perebutan kedudukan gubernur.
guer(r)illa	kb. gerilya. g. fighter gerilyawan. g. warfare perang gerilya. (fem.) gerilyawati.
guess	kb. 1 perkiraan, taksiran. 2 terkaan. 3 dugaan. -kkt. menerka. -kki. kira. guessing game tebak-tebakan, teka -teki.
guesstimate	kb. sl.: (angka) kira-kira, angka perkiraan.
guesswork	kb. cara kira-kira, terkaan, tebakan. the new machine takes the g. out of the problem mesin baru itu menghilangkan cara kira-kira dari soal itu.
guest	kb. tamu. g. list daftar tamu. g. towel handuk tamu. g. room kamar tamu.
guesthouse	kb. pasanggrahan,pondok/wisma tamu.
guff	kb. sl.: bantahan, sangkalan, protes, sanggahan.
guffaw	kb. tertawa terbahak-bahak.
guidance	kb. 1 pimpinan, bimbingan. 2 pedoman, petunjuk. g. counselor penasihat (di s.m.a.). g. system sistim pengendalian.
guide	kb. 1 buku pedoman. 2 pandu, pemandu. -kkt. 1 mengemudikan (a car, boat). 2 menuntun. 3 menjadi penunjuk jalan. 4 mempedomani. g. word kata penunjuk. -guided ks. kendali. -guiding ks. yang menuntun. g. principle asas/prinsip sebagai pedoman/penuntun.
guidebook	kb. buku pedoman/tuntunan/penuntun.
guideline	kb. garis pedoman.
guidepost	kb. tonggak penunjuk jalan.
guild	kb. serikat sekerja.
guilder	kb. rupiah (belanda).
guile	kb. akal bulus, tipu muslihat.
guileless	ks. tanpa akal bulus, terus-terang.
guillotine	kb. alat pemenggal kepala. -kkt. menghukum dengan pemenggalan kepala.
guilt	kb. kesalahan. g. by association kesalahan disebabkan perhubungan.
guilty	ks. bersalah. to plead g. mengaku bersalah.
guinea	kb. guinea. g. fowl ayam mutiara. g. pig a) marmot. b) orang atau binatang yang dipakai dalam percobaan, orang coba.
guise	kb. samaran. to come in the g. of a policeman datang menyamar sebagai polisi. under the g. of dengan berkedok sebagai.
guitar	kb. gitar. g. player pemain gitar.
guitarist	kb. pemain gitar, gitaris.
gulch	kb. ngarai yang sempit, jurang yang terjal.
gulf	kb. 1 teluk. g. of mexico teluk meksiko. g. stream arus teluk. 2 jurang pemisah.
gull	kb. burung camar (laut).
gullet	kb. kerongkongan.
gullible	ks. mudah tertipu.
gully	kb. (j. -lies) selokan.
gulp	kb. teguk. a g. of water seteguk air. -kkt. menelan, meneguk. -kki. he gulped ia menahan napasnya.
gum	kb. 1 gusi. i bit my g. gusi saya tergigit. 2 permen karet. 3 getah. -kkt. (gummed) sl.: to g. up the works mengacaukan semuanya. g. arabic getah arab. g. tree pohon para/getah. gummed label etiket yang ditempelkan.
gumdrop	kb. gula-gula permen karet.
gummy	ks. bergetah.
gumption	kb. inf.: enersi, inisiatif.
gun	kb. senapan, bedil, meriam. -kkt. (gunned) 1 mempercepat. 2 menambah gas mesin. to g. down 1 memberondong, menembak rubuh. 2 menembak mati. to g. for 1 memburu. 2 mulai berkampanye.
gunboat	kb. kapal meriam.
gunfight	kb. tembak-menembak.
gunfire	kb. tembakan.
gunk	kb. segala macam sampah/kotoran.
gunman	kb. (j. -men). 1 perampok bersenjata api. 2 ahli senjata api. 3 jago tembak.
gunner	kb. tentara/pelayan meriam, penembak.
gunnery	kb. keahlian membuat dan memakai meriam. g. officer perwira meriam.
gunny	kb. g. sack karung goni.
gunplay	kb. tembak-menembak, perkelahian senapan.
gunpoint	kb. ujung laras senapan. at g. dengan todongan pistol.
gunpowder	kb. serbuk mesiu.
gunrunner	kb. penyelundup senjata api dan amunisi.
gunrunning	kb. penyelundupan senjata api dan amunisi.
gunshot	kb. suara tembakan. g. wounds luka-luka kena tembakan.
gunshy	ks. takut akan bunyi tembakan.
gunsight	kb. pemitar, butir-butir.
gunsmith	kb. pandai senjata ringan, tukang senapan.
gunstock	kb. batang/popor senapan bedil.
gunwale	kb. bibir perahu, pinggiran lambung perahu.
gurgle	kki. berdeguk, mendeguk. the baby gurgled happily bayi itu mendeguk dengan gembira.
gush	kb. pancaran (of blood, water) -kki. memancar, mencurat, menyembur. -gushing ks. 1 yang memancar/menyembur. 2 dengan perasaan yang tak terkendalikan.
gusher	kb. pancuran/semburan minyak.
gushy	ks. cengeng, mudah tersinggung perasaannya.
gust	kb. hembusan yang keras. g. of wind hembusan angin.
gusto	kb. nafsu, semangat. to eat with g. makan dengan bernafsu. to do s.t. with g. melakukan sesuatu dengan penuh semangat.
gusty	ks. berangin ribut.
gut	kb. 1 anat.: 2 tali yang dibuat dari usus binatang. -guts j. 1 sl.: anat.: usus. 2 sl.: keberanian, ketekunan. -kkt. (gutted) 1 memusnahkan. 2 mengeluarkan isi perut.
gutsy	ks. sl.: berani, gagah.
guttapercha	kb. getah perca.
gutter	kb. 1 got, pancuran atap. 2 selokan.to be raised in the g. dibesarkan sebagai anak gelandangan. language of the g. bahasa pasaran.
guttersnipe	kb. anak jembel.
guttural	kb. suara tekak/garau.
guy	kb. sl.: orang. good g. orang yang baik. 1 orang yang jahat. 2 then.: peranan penjahat/bandit. g.-wire tali bubut, bubutan.
guzzle	kkt. minum dengan rakus.
gym	inf.: = gymnasium.
gymnasium	kb. ruang/gedung olah raga.
gymnast	kb. pesenam, ahli senam.
gymnastics	kb. olahraga senam.
gynecologist	kb. dokter ahli yang mengobati wanita.
gynecology	kb. ilmu bidanan. ilmu penyakit wanita, ginekologi.
gyp	1 kb. sl.: tipuan. 2 sl.: penipu. -kkt. (gypped) sl.: menipu.
gypsum	kb. gips, batu tahu.
gypsy	kb. (j. -sies) orang jipsi.
gyrate	kki. berputar.
gyration	kb. gerakan berputar, putaran.
gyrocompass	kb. kompas giro, pedoman gasing.
gyroscope	kb. giroskop.
h, h	kb. 1 huruf yang kedelapan dari abjad inggris. 2 setiap bunyi yang digambarkan dengan huruf ini. h-bomb bom zat air.
h.i.	[hawaiian island] kepulauan hawaii.
h.p. hp	[housepower] daya kuda.
h.q., hq	(headquarters) markas besar.
h.r., h. res., hr	[house of reprensetatives] dewan perwakilan rakyat a.s.
h.r.h.	[his or her royal highness] p.j.m. [paduka yang mulia].
ha	kseru. ha ! (menyatakan keheranan, kecurigaan, keriangan).
habeas corpus	kb. hak untuk diperiksa dimuka hakim.
haberdasher	kb. penjual pakaian laki-laki.
haberdashery	kb. (j. -ries) toko pakaian laki-laki.
habit	kb. 1 kebiasaan. i'm in the h. of getting up early kebiasaan saya bangun pagi-pagi benar. 2 pakaian. riding h. pakaian naik kuda. habit-forming ks. yang mencandukan.
habitat	kb. tempat kediaman/tinggal.
habitation	kb. tempat tinggal. fit for h. cocok/layak untuk dijadikan tempat tinggal.
habitual	ks. yang dilakukan karena kebiasaan. he's a h. criminal dia sudah biasa menjadi pejahat. a h. reader seorang yang sudah membiasakan diri membaca.
habitue	kb. penggemar, pencandu.
hack	kb. 1 orang yang diupah untuk mengerjakan kerja-kerja kesusasteraan. 2 inf.: taksi. -kkt. 1 menetak. memakuk, memarang. 2 melukai seseorang dengan kasar. sl.: to h. around ngeluyur. hacking cough batuk pendek.
hackles	kb., j. kecurigaan, kemarahan/kegusaran. inf.: to raise s.o's hackles menimbulkan/membangkitkan kegusaran seseorang.
hackneyed	ks. sudah usang, sudah basi. h. phrase kalimat yang sudah usang.
hacksaw	kb. gergaji logam/besi.
hackwork	kb. pekerjaan yang bermutu rendah, karangan picisan, pekerjaan yang bersifat buru-buru.
had	lih have.
haddock	kb. semacam ikan di atlantik utara.
hades	kb. alam barzach, neraka.
hadn't	[had not] lih have.
hag	kb. seorang wanita tua yang rupanya sangat jelek (dan hatinya biasanya busuk).
haggard	ks. kurus dan cekung.
haggle	kki. tawar-menawar. to h. over prices tawar-menawar mengenai harga.
hagridden	ks. kemasukan setan, suka ngawur.
hail	kb. 1 hujan batu es. 2 hujan (of bullets). -kkt. 1 berteriak kepada. 2 mengelu-elukan (the winner). 3 memanggil(kan) (a cab). 4 menerima, menyambut. 5 menghujani. -kki. hujan (batu) es. to h. from berasal dari. sl.: h. columbia teguran, celaan.
hailstone	kb. batu hujan es.
hailstorm	kb. hujan es disertai angin ribut.
hair	kb. rambut, bulu. to do o's hair merias rambut. hair -raising ks. mengerikan, menakutkan. h. shirt kemeja kasar terbikin dari bulu kuda. h. restorer obat menumbuhkan rambut. h. stylist ahli penata/rias rambut.
hairbreadth	kb nyaris, sangat sempit. to have a h. escape from death nyaris mati.
hairbrush	kb. sikat rambut.
haircut	kb. potong/pangkas rambut. to get a h. memotong rambut, berpangkas.
hairdo	kb. cara susunan rambut, tata/rias rambut.
hairdresser	kb. ahli rias rambut wanita, penata rambut.
hairiness	kb. keadaan berbulu.
hairline	kb. batas tumbuh rambut di kepala.
hairpiece	kb. rambut palsu.
hairpin	kb. jepit rambut. 2 tusuk konde, pasak sanggul. h. curve tikungan tajam.
hairsplitting	kb. amat/terlampau teliti.
hairy	ks. berbulu. hair-chested ks. berbulu dada.
halcyon	ks. tenang dan damai, bahagia. h. day hari-hari yang tenang dan damai.
hale	ks. kuat dan sehat. h. and hearty sehat dan segar, sehat wal'afiat. -kkt. memaksa pergi.
half	kb. (j.halves). 1 paruhan, separuh. 2 tengah. 3 separuh. 4 sport : babak. -ks., kk setengah. half-and-half ks. campuran. inf.: half-baked ks. setengah matang. half-blooded ks. peranakan. half-hearted ks. ragu-ragu, tanggung-tanggung.
halfback	ksb. gelandang tengah (soccer).
halfway	kk. separuh jalan. we are h. there kita sudah separuh jalan kesana.
halibut	kb. semacam ikan perak.
halitosis	kb. nafas berbau, mulut busuk.
hall	kb. 1 ruang(an) the front h. ruang depan. 2 aula/ruang. 3 gang. h. of justice gedung pengadilan.
hallelujah	ks. 1 pujian kepada tuhan (kristen). 2 nyanyian pujaan untuk tuhan.
hallmark	kb. tanda (resmi). politeness is the h. of a gentleman kesopanan adalah tanda orang yang berbudi.
hallow	kkt. menyucikan, mempersucikan. hallowed be thy name sucikan namamu. -hallowed ks. keramat. h. ground tanah keramat, tanah yang suci.
hallowe'en	kb. malam 31 oktober.
hallucination	kb. (peng)khayalan, minyak, maya.
hallway	kb. 1 gang. 2 (entrance) ruang masuk.
halo	kb. 1 lingkaran cahaya, pagar bulan. (around moon). 2 lingkaran kekeramatan. she seems to wear a h. dia seakan-akan memakai mahkota keagungan.
halt	kb. penghentian, perhentian. to call a h. memberhentikan.-kkt. memberhentikan. -kki. berhenti. -halting ks. terhenti-henti, tertegun-tegun his speech is h. dia berbicara terputus-putus.
halter	kb. tali leher kuda. 2 oto, pakaian penutup dada, diikatkan pada belakang leher dan punggung.
halve	kkt. membagi dua. i'll h. this candy bar with you saya akan membagi dua batang gula-gula ini dengan kau.
halves	lih half.
ham	kb. 1 daging (paha) babi (yang biasanya diasinkan). 2 sl.: pemain sandiwara yang jelek. 3 sl.: pelayan radio amatir. -kkt. (hammed) sl.: to h. it up bermain berlebih-lebihan.
hamburger	kb. 1 perkedel daging. 2 (sandwich) roti pakai perkedel daging.
hamlet	kb. dusun kecil.
hammer	kb. palu, martil. -kkt. memalukan, memukul. -kki. to h. at menekankan kepada. -hammered ks. tempaan, yang sudah ditempa. h. metal logam yang sudah ditempa. -hammering kb. pukulan palu.
hammock	kb. tempat tidur gantung, buaian.
hamper	kb. keranjang. clothes h. keranjang pakaian. -kkt. 1 menghambat (progress). to be hampered without a car terhambat karena tidak ada mobil. 2 merintangi. heavy rains hampered rescue efforts hujan-hujan lebat merintangi usaha-usaha pertolongan.
hamster	kb. semacam tupai.
hamstring	kb. urat-urat lutut. -kkt. (hamstrung) 1 melumpuhkan, memotong.
hand	kb. 1 tangan. 2 agri.: buruh tani. 3 nau.: anak kapal. 4 bridge : susunan kartu. 5 sisi. 6 (measure) empat inci (lebar tangan). 7 jarum (of watch, clock). 8 tulisan tangan. 9 (applause) tepukan tangan. 10 sisir, tandan.
handbag	kb. tas (tangan).
handball	kb. bola tangan.
handbill	kb. surat sebaran/edaran.
handbook	kb. buku penuntun, pedoman.
handclasp	kb. jabatan tangan (yang hangat).
handcuff	kb. belenggu, borgol, gari. -kkt. membelenggu, memborgol.
handful	kb. 1 segenggam. by the h. segenggam/bergenggam-genggam. 2 orang yang sukar diurus. 3 sedikit. only a h. attended the rally hanya sedikit orang menghadiri rapat itu.
handicap	kb. 1 rintangn, sesuatu yang merugikan. 2 golf : handikap. -kkt. (handicapped) menghalangi, merintangi. -the physically handicapped orang-orang yang cacat jasmaniah. ks. cacat. h. child anak cacat.
handicraft	kb. pertukangan/kerajinan/ keprigelan/ketrampilan tangan.
handily	lih handy.
handiness	kb. ketangkasan, kecekatan, ketrampilan.
handiwork	kb. 1 pekerjaan tangan. 2 hasil perbuatan.
handkerchief	kb. saputangan.
handle	kb. 1 tangkai (of a broom, spoon). 2 pegangan (of a bag, basket). 3 gagang (of a knife, tennis racket). 4 sl.: nama, gelar, pangkat. -kki. dikemudikan. -handling kb. 1 pemeliharaan, perawatan, perlakuan. 2 penanganan (of a case).
handmade	ks. buatan/karya tangan. that tablecloth is h. taplak meja itu dibuat dengan tangan.
handout	kb. inf.: 1 sedekah, pemberian. 2 (news story) berita surat selebaran.
handrail	kb. susuran tangan/tangga.
handsaw	kb. gergaji tangan.
handshake	kb. jabatan tangan.
handsome	ks. 1 ganteng, gagah, tampan, rupawan. 2 bagus, banyak. 3 cantik.
handspring	kb. jengkelit, jengkolet, jempalit. to do a h. menjengkelit.
handstand	kb. jungkir. to do a h. menjungkir, berdiri diatas tangan.
handwringer	kb. orang putus asa.
handwriting	kb. tulisan tangan. h. on the wall alamat buruk.
handy	ks. 1 cekatan, ringan tangan. 2 berguna. 3 dekat. -handily kk. dengan mudah.
handyman	kb. (j. -men) tukang.
hang	kb. cara bergantung.-kkt. (hung;hanged kalau dihukum mati). 1 menggantung. 2 menggantungkan 3 menundukkan (o's head). 4 melekatkan, menempelkan. (wallpaper). -hanging kb. 1 mati di gantungan, hukuman gantung. 2 hiasan yang digantungkan.
hangar	kb. (h) anggar.
hangdog	ks. malu, hina. he has a h. look mukanya suram.
hanger	kb. gantungan. hanger-on kb. (j. hangers-on) pengikut-pengikut.
hangker	kki. ingin sekali, rindu. to h. after ingin sekali, menginginkan sangat, rindu sekali. -hangkering kb. keinginan yang sangat.
hangman	kb. (j. -men) algojo, tukang gantung.
hangnail	kb. bintil kuku.
hangout	kb. sl.: 1 tempat diam, tempat yang sering dikunjungi. 2 tempat berkumpul, markas (sering untuk penjahat).
hangover	kb. s.: perasaan sakit pada waktu bangun pagi setelah minum minuman keras terlalu banyak.
hank	kb. gulung(an), gumpal(an). a h. of hair segumpal/segulung rambut. a h. of yarn segulung benang.
hanky-panky	kb. inf.: tipu daya, sikut-menyikut.
haphazard	ks. sembarangan, serampangan, sembrono. -haphazardly kk. dengan sembrono.
happen	kki. 1 terjadi. 2 kebetulan saja. to h. (up)on menemukan. -happening kb. kejadian, peristiwa.
happenstance	kb. kejadian dengan/secara kebetulan.
happily	lih happy.
happiness	kb. kebahagiaan. we wish you h. kami doakan semoga kau berbahagia.
happy	ks. gembira, senang, bahagia. happy-go-lucky ks. yang tak kenal susah, suka bersenang-senang. -happily kk. dengan gembira, dengan riang.
harangue	kb. pidato (yang panjang dan penuh gembar-gembor). -kkt. berpidato panjang-lebar kepada.
harass	kkt. menggoda, menggangu, mengusik. to be harassed da[pat godaan, tergoda.
harassment	kb. gangguan, godaan, usikan.
harbinger	kb. pertanda, alamat.
harbor	kb. pelabuhan. -kkt. 1 mempunyai. 2 mengandung. 3 menyembunyikan.
hard	ks. 1 keras. 2 sukar, susah. -kk. 1 keras. 2 lebat. 3 dalam-dalam, baik-baik. 4 dengan tajam. hard-driving ks. gesit dan suka bekerja keras. -hardly kk. hampir tidak.
harden	kkt. mengeraskan, memperkeras. -kki. mengeras, menjadi keras. -hardened ks. dijadikan keras. -hardening kb. 1 pengerasan (of metal, attitude). 2 pembekuan. h. of the artery pembekuan/penyempitan pembuluh nadi.
hardiness	kb. ketahanan, ketabahan hati, daya tahan.
hardness	kb. kekerasan.
hardship	kb. kesukaran, penderitaan. to work a h. upon s.o. menimpakan kesulitan pada seseorang.
hardtop	kb. mobil yang kapnya dibuat dari logam yang kelihatannya dapat dilipat.
hardware	kb. 1 barang-barang dari logam/besi. 2 mil.: senjata atau perlengkapan seperti tank-tank, meriam-meriam dll. 3 setiap mesin atau komponennya yang lengkap.
hardwood	kb. kayu keras.
hardy	ks. tahan, tabah. h. pioneer pelopor yang tahan. h. plants tanaman-tanaman yang tahan.
hare	kb. kelinci, terwelu. mad as a march h. gila betul.
harebrained	ks. bodoh, kurang pikiran (of a plan).
harelip	kb. (bibir) sumbing.
harem	kb. harem, tempat kediaman selir-selir sultan.
hark	kki. mendengar. to h. back to berhubungan dengan, memperingatkan kepada.
harlot	kb. perempuan sundal, wanita wts.
harm	kb. kerugian, kejahatan, kerusakan, kesalahan. -kkt. 1 merugikan, mengganggu. 2 membahayakan akan. 3 melukai, mencelakakan.
harmful	ks. berbahaya. h. to the teeth berbahaya terhadap gigi, merusak gigi. 2 membahayakan. this medicine is h. obat ini membahayakan.
harmless	ks. tak berbahaya.
harmonica	kb. harmonika (mulut).
harmonious	ks. rukun, seia-sekata. h. relationship hubungan yang rukun.
harmonize	kki. berpadanan, seimbang, cocok, berpadu. these colors h. beautifully warna-warna ini berpadanan secara indah.
harmony	kb. (j.-nies) keselarasan, keserasian, kesesuaian, kecocokan, kerukunan.
harness	kb. pakaian kuda. to die in h. mati dalam pekerjaannya. -kkt. 1 memasang pakaian kuda. 2 mempergunakan, memanfaatkan, mengekang (a river). to h. the ocean's power memanfaatkan tenaga samudera.
harp	kb. semacam kecapi. -kki. to h. on berbicara berulang-ulang tentang.
harpoon	kb. seruit. -kkt. menyeruit.
harries	lih harry.
harrow	kb. sisir tanah, garu, penggaruk. -kkt. menyisir tanah, menggaru, menggaruk. -harrowing ks. yang mengerikan/menyiksa. h. experience pengalaman yang mengerikan.
harry	kkt. (harried) mengganggu, merusakkan, menggarong. to h. shipping mengganggu pelayaran.
harsh	ks. 1 kasar (towel, expression, statement). 2 keras. 3 parau (of voice). 4 tajam. h. coast pantai yang gundul dan berbukit. -harshy dengan kasar. to treat h. memperlakukan dengan kasar.
harshness	kb. kekerasan (of a verdict, weather)
harum-scarum	ks. inf.: 1 sembrono. 2 lupa daratan.
harvest	kb. 1 hasil panen. 2 pemungutan, panen. -kkt., kki. memungut hasil panen. to h. rice memotong/memanen padi.
has	lih have.
has-been	kb. inf.: seorang tokoh yang pernah dulu/penting.
hash	kb. 1 campuran daging dan kentang yang dicencang halus dan digoreng/dipanggang. 2 membunuh. -kkt. inf.: to h. out membicarakan, mendiskusikan, memperbincangkan (problems, matters). inf.: to h. over mengobrol (tentang masa lampau).
hashish	kb. ganja.
hasn't	[has not] lih have.
hasp	kb. sangkutan, kaitan, pengait.
hassle	kb. perkelahian, percekcokan. legal h. pertengkaran secara hukum.
hassock	kb. bantal lutut/kaki.
haste	kb. kegopohan. in h. dengan tergesa-gesa, terburu-buru, tergopoh-gopoh.
hasten	kkt. mempercepat. to h. the fall of the cabinet mempercepat jatuhnya kabinet. -kki. bersegera, cepat-cepat. i h. to reply to your letter saya cepat-cepat menjawab suratmu
hasty	ks. 1 terburu-buru, tergesa-gesa. 2 sebentar, singkat.3 gegabah. -hastily kk. dengan tergesa-gesa.
hat	kb. topi. h.in hand 1 dengan rendah hati. 2 dengan hormat. to take off o's h. to 1 mengangkat topi terhadap. 2 menghormati.
hatband	kb. pita/sekeliling topi.
hatbox	kb. kotak/tempat topi.
hatch	kb. lubang palka. down the h.! selamat! -kkt. 1 menetaskan (chickens). 2 merencanakan. (a scheme). -kki. menetas.
hatchery	kb. (j. -ries) kb. tempat/perusahaan penetasan.
hatchet	kb. kapak kayu, beliung, kampak. to bury the h. melupakan yang sudah-sudah (berdamai), hidup damai.
hate	kb. rasa benci, kebencian. -kkt. membenci. -kki. 1 segan, tidak suka. 2 tidak senang.
hateful	ks. penuh/merasa benci. 2 membangkitkan benci.
hatpin	kb. jepitan/tusuk topi.
hatrack	kb. rak topi.
hatred	kb. kebencian, rasa benci.
haughtiness	kb. kesombongan, keangkuhan, kecongkakan, kekibiran.
haughty	ks. sombong, angkuh, kibir, congkak, tinggi hati, tekebur. -haughtily kk. dengan tinggi hati.
haul	kb. 1 hasil tangkapan (of fish, robbery). 2 muatan (of trucks, etc). -kkt. 1 menarik, menyeret, menghela (by/with horses, elephants). 2 mengangkut.
haulage	kb. daya tarik/seret/angkut, ongkos/biaya penarikan/penyeretan/pengangkutan.
haunch	kb. pangkal paha, (daerah) pinggang.
haunt	kb. tempat yang sering dikunjungi. -kkt. 1 terbayang, sering membayang. 2 sering mendatangi. -haunted ks. berhantu, angker. -haunting ks. yang sering timbul
have	kb. haves j. the haves and the have-nots si-kaya dan si-miskin. -kkt. (had) 1 mempunyai. 2 memiliki 3 memegang. 4 memperoleh. 5 mengizinkan. 6mengalami. 7 ada, punya. 8 merasa. 9 mendapat. 10 ingin.11 ber-. 12 memberi. 13 menyuruh. 14 menyimpan, memegan
haven	kb. 1 tempat berlindung/berteduh. 2 tempat singgah.
haven't	[have not] lih have.
havoc	kb. kerusakan, malapetaka. to play/raise/wreak h. with merusakkan.
haw-haw	kb., kseru, tertawaan terbahak-bahak.
hawk	kb. burung elang. he has eyes like a h. matanya tajam. penglihatannya tajam. hawk-eyed ks. bermata-tajam. -kkt. menjajakan. to h. up mengeluarkan.
hawker	kb. penjaja.
hawsepipe	kb. ulup, lubang rantai jangkar, ungkak.
hawser	kb. kabel/tambang kapal.
hay	kb. 1 rumput kering, jerami. sl.: to hit the h. pergi tidur. 2 inf.: pal.: keuntungan. 3 sl.: sedikit uang. to make h. menarik keuntungan, mengambil manfaat. to make h. while the sun shines mempergunakan kesempatan sebaik-baiknya.
hayfield	kb. padang rumput.
hayloft	kb. loteng jerami.
hayseed	kb. sl.: petani, kampungan, orang udik/desa.
haystack	kb. timbunan rumput kering. like looking for a needle in a h. sama dengan mencari jarum dalam timbunan rumput kering, mengerjaklan pekerjaan yang sia-sia.
haywire	ks. sl.: to go h. 1 menjadi rusak (of machinery). 2 menjadi gila, rusak ingatan (of people).
hazard	kb. bahaya, risiko. -kkt. mengambil risiko. to h. a guess coba-coba menebak. to h. an opinion berani mengemukakan pendapat.
hazardous	ks. berbahaya, penuh risiko. risiko.
haze	kb. kabur. -kkt. memperlakukan mahasiswa-mahasiswa baru sewenang-sewenang, memperplonco. -hazing kb. perlakuan sewenang-wenang terhadap mahasiswa baru, perpeloncoan, pemapraman.
hazelnut	kb. semacam buah kemiri.
haziness	kb. kekaburan.
hazy	ks. 1 berkabut, kabur. the view is h. pemandangan berkabut. 2 tidak jelas. i'm h. about last night tidak jelas bagi saya apa yang terjadi semalam.
hdbk.	[handbook]buku pedoman/ penuntun.
hdqrs.	[headquarters] markas besar.
he	kg. dia, ia. inf.: he-man jantan betul.
he'd	[1 he had 2 he would]. 1 ia telah. 2 ia akan.
he'll	[1 he will 2 he shall]. 1ia akan. 2 ia hendak.
he's	[1 he is. 2 he has]. 1 ia adalah. 2 ia ada.
head	kb. 1 kepala. 2 bungkul, bongkol.4 ujung kepala. 5 ekor. 6 busa. 7 bagian depan.head-to-toe ks. dari kepala sampai ke kaki. heads up ks. berhati-hati, waspada.-heading kb. kepala, bagian atas.
headache	kb. 1 sakit kepala. 2 inf.: soal. if he throws his money away, that's not my h. jika ia menghamburkan uangnya, itu bukan soal saya.
headband	kb. destar, ikat kepala.
headboard	kb. papan di ujung kepala tempat tidur.
headdress	kb. hiasan kepala.
header	kb. inf.: to take a h. jatuh tersungkur.
headfirst	kk. dengan kepala lebih dahulu, dengan kepala kebawah.
headgear	kb. tutup kepala.
headland	kb. tanjung.
headlight	kb. lampu besar.
headline	kb. pokok/kepala berita. -kkt. 1 menempatkan sebuah cerita di halaman muka. 2 membintangi (a show, revue).
headlong	kk. segera, tidak pikir panjang lagi, langsung. to fall h. jatuh dengan kepalanya dahulu.
headman	kb. (j. -men), penghulu, lurah, kepala kampung.
headmaster	kb. kepala sekolah.
headphone	kb. telepon kepala.
headquarters	kb. markas besar. police h. markas besar polisi.
headstone	kb. 1 batu kubur, nisan. 2 batu pertama.
headstrong	ks. keras kepala, degil, kepala batu.
headwaiter	kb. kepala pelayan, pelayan kepala.
headwaters	kb., j. daerah hulu. h. of the amazon huku sungai amazon.
headway	kb. kemajuan. to make h. (bergerak) maju.
heady	ks. 1 keras, lekas memabukkan. a h. wine anggur keras. 2 sengit lekas panas hati, gegabah. h. talk percakapan yang sengit. 3 gegabah. h. speculation spekulasi yang gegabah.
heal	kkt. menyembuhkan. -kki. menjadi sembuh. -healing kb. penyembuhan.
healer	kb. pengobat, dukun, penyembuh.
health	kb. kesehatan. to be in poor h. sakit -sakitan, keadaan kesehatannya. jelek, penyakitan. h. resort tempat tetirah/peristirahatan.
healthful	ks. sehat. h. climate iklim yang sehat.
healthwise	kk. inf.: dari sudut kesehatan.
healthy	ks. sehat. h. appetite nafsu makan yang baik. that's not a h. situation itu bukan keadaan yang sehat.
heap	kb. tumpukan, timbunan. h. of wood tumpukan kayu. -kkt. menumpuk, menghimpun.
hear	kkt. (heard) 1 mendengar. 2 mendengarkan.-kki. mendengar. -hearing kb. 1 pendengaran. 2 law : pemeriksaan.
heard	lih hear.
hearer	kb. pendengar.
hearken	kki. to h. to mendengarkan.
hearsay	kb. kabar orang/angin, desas-desus, sas-sus.
hearse	kb. kereta jenazah, mobil jenazah/mayat.
heart	kb. 1 jantung. 2 hati. 3 bagian tengah (of lettuce, celery). 4. bridge : hart. 5 inti, pokok. 6 kehendak. heart-shaped ks. berbentuk jantung. heart-stirring ks. yang membangkitkan semangat (speech, song). heart-to-heart ks. dari hati ke hati.
heartace	kb. dukacita, kepiluan.
heartbeat	kb. denyut/debaran/detik jantung.
heartbreak	kb. kesedihan/remuk hati, kemasygulan.
heartbreaker	kb. mata keranjang, penghancur hati (orang).
heartbreaking	ks. mamilukan, menyayat hati.
heartbroken	ks. bersedih/berpilu hati, amat sedih, berhati pilu.
heartburn	kb. rasa panas dalam perut.
hearten	kkt. membesarkan hati.
heartfelt	ks. yang sepenuh hati. my h. thanks for terima kasihku yang sepenuh hati atar.
hearth	kb. perapian, tungku.
heartily	kk. lih hearty.
heartsick	ks. sedih, gundah-gulana, pilu hati.
heartstrings	kb., j. hati sanubari, perasaan hati. to tug at o's heartstrings sangat menggetarkan hati sanubari.
heartthrob	kb. s.: kekasih.
hearty	ks. 1 besar. 2 sungguh-sungguh, dengan sepenuh hati. -heartily kk. 1 dengan penuh nafsu makan. 2 sungguh-sungguh. to disagree h. sungguh-sungguh tidak setuju.
heat	kb. 1 panas, kepanasan. 2 bagian dari balapan. 3 tekanan. -kkt. memanaskan. -heated ks. hangat, bernafsu. -heating kb. pemanasan. -ks. pemanas
heater	kb. alat pemanas. electric h. alat pemanas (dengan tenaga) listrik. gas h. alat pemanas (dengan tenaga) gas.
heathen	kb. penyembah berhala, kafir, yang tidak ber-tuhan.
heatstroke	heatstroke
heave	kb. angkatan, dorongan. -kkt. (heaved) 1 membongkar, mengangkat (jangkar). 2 menghela. -kki. 1 bergelombang (of a sea). 2 menyembul, timbul. 3 (hove) timbul, muncul.
heaven	kb. 1 sorga, surga. 2 (hindu) kayangan. -heavens j. langit, cakrawala. heaven-sent ks. mujur, mendapat karunia tuhan, kedatangan seorang yang menguntungkan.
heavenly	ks. 1 amat menyenangkan. 2 lezat, sedap.
heavily	lih heavy.
heavy	kb. film : peranan penjahat/bandit. -ks. (heavier, heaviest). 1 berat. 2 padat, ramai (of traffic). 3 tebal. 4 keras. 5 hebat. 6 kasar. -kk. secara berat. -heavily kk. secara berat.
heavyweight	kb. 1 box.: kelas berat. 2 kaliber berat. he's intelligent but not a h. dia pintar tapi bukan termasuk kaliber berat.
heb.	[hebrew(s)] 1 bible : orang yahudi. 2 yahudi.
hebrew	kb. 1 orang yahudi. 2 bahasa yahudi. -ks. yahudi. the h. language bahasa yahudi.
heck	kb. to give s.o. h. mengomeli seseorang. -kseru persetan, buset.
heckle	kkt. menggoda, mengganggu (dengan ucapan yang mengejek). -heckling kb. mencela, memfitnah, mengejek.
heckler	kb. tukang ejek yang berteriak.
hectare	kb. hektar.
hectic	ks. tidak tenang, ribut, ramai sekali.
hectogram	kb. hectogram.
hectograph	kb. hektograf. -kkt. memperbanyak. (sesuatu) dengan alat hektograf.
hedge	kb. 1 (garden) pagar tanam-tanaman 2 pembendung. -kkt. to h. in memagari, membatasi, mengungkung. -kki. mengelak- elakkan, menghindarkan. to hedge-hop kki. (hedge-hopped) melakukan penerbangan yang rendah diatas tanah.
hedgehog	kb. landak.
hedgerow	kb. pagar tanaman.
hedonism	kb. paham yang dianut orang-orang yang mencari kesenangan semata-mata.
heed	heed
heedless	ks. dengan tidak memperhatikan/mengindahkan/memperdulikan. h. of. the danger dengan tidak memperhatikan bahaya.
heehaw	kb. tertawa kasar. -kki. meringkik.
heel	kb. 1 tumit. 2 inf.: bangsat, bedebah. -kki. memiringkan. -heeled ks. bertumit.
hefty	ks. besar dan kuat, kokoh, kekar (of people). h. steel frame rangka baja yang kuat.
height	kb. 1 tinggi. 2 puncak.
heighten	kkt. mempertinggi (a doorway, interest). -kki. memuncak, menambah. the conflict heightened pertentangan itu memuncak.
heinous	ks. bengis, mengerikan, keji sekali, kejam. h. crime kejahatan yang keji sekali.
heir	kb. waris. she is h. to a lot of money dia akan mewarisi uang yang banyak. h. apparent putera mahkota.
heiress	kb. ahli waris perempuan.
heirloom	kb. pusaka.
helicopter	kb. helikopter.
heliport	kb. lapangan helikopter.
helium	kb. helium.
hell	kb. neraka. kseru. persetan.
hellbent	ks. sl.: bersikeras. he was h. on getting to new york dia bersikeras untuk pergi ke new york.
hellcat	kb. perempuan yang jahat.
hellenic	ks. yunani.
hellfire	kb. api neraka, hukuman di neraka.
hellhole	kb. tempat yang sangat tidak menyenangkan.
