wail	kb. 1 ratapan, raungan (of a person). 2 lengkingan (of a siren). -kki. 1 meraung, mengaung, bergaduh. 2 meratap. the woman wailed wanita itu meratap. -wailing kb. ratapan.
wainscot	kb. kayu lis, lapis kayu pada dinding. -kkt. memberi bingkai kayu pada dinding. -wainscoting kb. 1 bingkai/lis dinding. 2 pembingkaian dinding.
waist	kb. pinggang. waist-deep, waist-high ks. setinggi pinggang.
waistband	kb. ikat pinggang.
waistline	kb. ukuran pinggang.
wait	kb. masa menunggu. -kkt. menangguhkan (dinner). -kki. menunggu. -waiting kb. menunggu. w. list daftar nama orang-orang yang menunggu.
waiter	kb. pelayan, pramubhakti. w.! jang ! pelayan ! bung !.
waitress	kb. pelayan wanita. w.! pelayan ! dik ! zus ! sis !.
waive	kkt. melepaskan (a right).
waiver	kb. surat pernyataan melepaskan tuntutan. w. of immunity pelepasan hak kekebalan, surat pernyataan pembebasan (dari tuntutan).
wake	kb. 1 air baling-baling, jaluran ombak (of a ship). 2 rel.: berjaga semalam suntuk disamping jenazah. -kkt. (waked atau woke, waked atau woken) membangunkan (s.o). -kki. bangun.
waken	= wake.
walk	1 jalan-jalan. 2 jarak untuk dijalani. 3 cara berjalan. 4 (side-) trotoar, kaki lima. 5 (w.of life) jabatan, pekerjaan. -kkt. 1 mengantar. 2 membawa. 3 menjalani, mondar-mandir (the deck, floor). 4 berjalan(kaki) (the street). -walking kb. berjalan kaki.
walkaway	kb. inf.: kemenangan yang mudah.
walker	kb. 1 orang yang berjalan kaki. 2 alat pembantu berjalan.
walkie-talkie	kb. walkie-talkie, alat woki-toki.
walkout	kb. pemogokan.
walkover	kb. inf.: kemenangan yang mudah, w.o.
walkway	kb. gang, tempat berjalan.
wall	kb. 1 (inside) dinding. 2 (outside) tembok. -kkt. to w. off memasang batas tembok pada (a yard). wall-towall carpeting babut yang menutupi lantai dari dinding ke dinding.
wallboard	kb. papan dinding.
wallet	kb. dompet.
wallflower	kb. gadis atau wanita yang duduk tanpa ikut berdansa.
wallop	kb. pukulan keras. -kkt. mendera, menghajar. -walloping inf.: kb. pukulan keras, hajaran, dera(an). ks. kuat, besar.
wallow	kb. kubangan. -kki. 1 berkubang (of hog, buffaloes). 2 bergelimangan (in sand). 3 bermandikan, bergelimang (in luxurious living). she's wallowing in money ia sangat kaya.
wallpaper	kb. kertas dinding. -kkt. menghiasi kamar dengan kertas, menempel dinding dengan kertas dinding.
walnut	kb. semacam kenari.
walrus	kb. semacam ikan duyung, beruang laut.
waltz	kb. wals. -kki. berdansa irama wals.
wan	ks. 1 pucat, lesu (in appearance). 2 lemah (smile). 3 pudar (light). -wanly kk. lemah-lemah.
wand	kb. tongkat sihir/wasiat, tongkat sim-sala-bim.
wander	kkt. menggeluyur (the street). -kki. 1 mengembara. 2 berkeliling-keliling (through a museum). 3 menyimpang. -wandering kb. penggeluyuran. in her wanderings dalam pengembaraannya.
wanderer	kb. pengembara, kelana.
wanderlust	kb. nafsu berkelana, kesukaan mengeluyur/mengembara.
wane	kb. to be on the w. semakin berkurang. -kki. 1 menyusut (of the moon). 2 berkurang kekuasaannya (of empires). 3 mundur, menurun (of enthusiasm). -waning kb. penyusutan, mundurnya (of strength).
wangle	kkt. berhasil mendapat dengan akal licik.
want	kb. 1 kebutuhan. 2 ketiadaan. 3 kekurangan. -kkt. 1 ingin, mau. 2 membutuhkan, memerlukan. 3 menghendaki. 4 meminta. 5 menginginkan. -wanting ks. kurang.
wanton	ks. 1 ceroboh, tanpa alasan (neglect, destruction). 2 a-susila. 3 sembarangan. 4 tanpa alasan.
wantonness	kb.1 kecerobohan. 2 keberandalan.
war	kb. perang, peperangan. w. of nerves perang urat syaraf. -kki. (warred) berperang. war-torn ks. rusak karena peperangan. war-weary ks. lesu (ber)perang. -warring ks. sedang berperang.
warble	kb. kicauan. -kkt. menyanyi. -kki. berkicau (of birds).
warbler	kb. burung pengicau.
ward	kb. 1 (hospital) ruangan rumah sakit, ruangan tempat orang sakit, bangsal. 2 pol.: daerah pemilihan, distrik kota. 3 orang yang dibawah perwalian (of a court). -kkt. to w. off 1 menangkis, menghindari (a blow). 2 mencegah (a cold). 3 menangkal.
warden	kb. 1 sipir, kepala rumah penjara. 2 (game-) pengawas.
wardobe	kb. 1 lemari pakaian. 2 kumpulan pakaian. w. trunk kopor pakaian.
ware	kb. barang. literary wares karya-karya kesusasteraan.
warehouse	kb. gudang. bonded w. gudang barang-barang bebas bea.
warehousing	kb. pergudangan.
warfare	kb. perang, peperangan.
warhead	kb. bagian depan yang berisi bahan peledak (on a missile). nuclear w. hidung/ujung peledak senjata nuklir.
warily	lih wary.
warlike	ks. suka perang. w. tribe suku yang suka perang.
warm	ks. 1 panas. w. climate iklim panas. w. weather cuaca panas. 2 hangat. 3 peramah. 4 inf.: dekat, hampir (in games). 5 memanaskan diri.
warm-blooded	ks. berdarah panas. warm-up kb. latihan untuk melemaskan badan. -warmly kk. dengan hangat. -warming ks. hangat, yang memanaskan.
warmonger	kb. penghasut perang.
warmongering	kb. (peng)hasutan perang.
warmth	kb. 1 kehangatan (of a room). 2 kehangatan hati, keramahan (of a person).
warn	kkt. memperingatkan. -warning kb. peringatan.
warp	kkt. 1 melengkungkan, membengkokkan. 2 menyesatkan. -kki. 1 membengkok. 2 melengkung. -warped ks. melengkung (of a wheel, table).
warpath	kb. jalan yang ditempuh oleh pasukan yang pergi berperang (pada suku (indian). on the w. 1 marah-marah. 2 siap untuk berperang.
warrant	kb. surat perintah/tuntutan, saman. -kkt. 1 memerlukan, membenarkan. 2 menjamin.
warranty	kb. (j. -ties) 1 garansi, jaminan. 2 pembenaran.
warren	kb. tanah berlubang-lubang tempat memelihara kelinci.
warrior	kb. pejuang, prajurit, serdadu.
warship	kb. kapal perang.
wart	kb. kutil.
wartime	ks. masa perang. w. experiences pengalaman-pengalaman masa perang.
wary	ks. waspada, hati-hati, awas. to be w. of awas terhadap. -warily kk. dengan berhati-hati.
was	lih be.
wash	kb. 1 cucian. 2 tempat pencucian. 3 sibak/riak air (from propellors). 4 mandi (for a dog). -kkt. 1 mencuci (o's hands, the walls, the dishes). 2 mencuci, berkeramas (o's hair). 3 mencuci/memandikan (the dog). 4 mendulang (gold).
washable	ks. dap dicuci (tanpa menjadi rusak).
washbasin	kb. wastafel, tempat cuci tangan, waskom.
washboard	kb. papan cuci/penggilas.
washbowl	kb. wastafel, tempat cuci tangan.
washcloth	kb. lap (pencuci) badan.
washday	kb. hari mencuci.
washed-out	ks. rusak dihanyutkan (of a road, bridge). -washed-up ks. gagal, habis. wash-and-wear, w. 'n wear ks. cuci-pakai (clothes). -washing kb. cucian.
washer	kb. 1 cincin penutup, ring. 2 (machine) mesin cuci.
washerwoman	kb. (j. -women) tukang cuci perempuan.
washout	kb. 1 penghanyutan (of road, bridge). 2 (failure) sl.: kegagalan.
washrag	kb. lap pencuci (badan). lap mandi.
washroom	kb. kamar kecil, w.c.
washstand	kb. meja cuci muka.
washtub	kb. bak/tong cuci.
washwoman	= washerwoman.
wasn't	[was not] tidak (dalam waktu yang telah lewat).
wasp	kb. tabuhan, penyengat, tawon.
wasserman	w. test test darah untuk menyelidiki ada tidaknya penyakit sipilis.
wastage	kb. apa yang dihabiskan (dibuang-buang).
waste	kb. 1 pemborosan. 2 pembuangan. -kkt. 1 memboroskan (money, paper). 2 membuang-buang (time). 3 menghamburkan, membuang-buang (water). -wasted ks. yang dibuang-buang, yang disia-siakan.
wastebasket	kb. keranjang sampah.
wasteful	ks. pemboros, royal.
wasteland	kb. tanah kosong, gurun.
wastepaper	kb. kertas sobekan/sampah. w. basket keranjang sampah.
waster	kb. pembuang. he's a real time w. ia betul-betul pembuangan waktu.
watch	kb. 1 arloji, jam (tangan). jaga. -kkt. 1 memperhatikan (s.o.). 2 menjaga (s.t.). 3 mengamati. 4 menonton (soccer, a a movie). -kki. menonton.
watchband	kb. ban arloji, gelang jam.
watchcase	kb. kas/kotak arloji.
watchdog	kb. 1 anjing penjaga. 2 penjaga. w. of the treasury penjaga perbendaharaan.
watcher	kb. pengintai. bird w. peneliti burung.
watchful	ks. waspada. to keep a w. eye over menjaga dengan waspada.
watchfulness	kb. perhatian, penelitian, sifat menjaga/mengamat-amati.
watchmaker	kb. tukang arloji.
watchmaking	kb. pembuatan arloji.
watchman	kb. (j. -men) jaga, penjaga.
watchtower	kb. menara pengawasan/kawal.
watchword	kb. semboyan.
water	kb. 1 air. 2 perairan. 3 air ledeng. -waters j. 1 perairan. 2 anat.: cairan amnion. -kkt. 1 menyirami, menjirus (flowers). 2 memberi minum (cattle). 3 mencampuri dengan air (gasoline, wine).
water-down	ks. 1 yang diecerkan (dengan air) (of milk). 2 yang diperlemah/diperlunak (version). -watering kb. 1 keluarnya air mata. 2 pengairan (of a field).
watercourse	kb. anak sungai/air.
watercraft	kb. 1 kapal, perahu. 2 keahlian dalam berolahraga air.
waterfall	kb. air terjun.
waterfowl	kb. burung/unggas air (yang bisa berenang).
waterfront	kb. 1 tepi laut. 2 bagian kota yang berbatasan dengan air, daerah pelabuhan. w. activities kegiatan-kegiatan di pelabuhan.
waterglass	kb. silikat soda.
waterloo	kb. waterloo. to meet o's w. menderita kekalahan.
watermark	kb. cap air. -kkt. memberi cap air.
watermelon	kb. semangka.
waterproof	ks. tahan air.
waterproofing	kb. 1 pembuatan tahan air. 2 sesuatu zat atau bahan untuk membuat tahan air.
watershed	kb. batas air. his work marks a w. in the field of genetics penyelidikannya merupakan titik yang menentukan dalam lapangan genetika.
waterspout	kb. 1 pipa penyemprot air. 2 meteor.: angin punca beliung, puting beliung.
watertight	ks. 1 kedap, rapat (of door). 2 tak dapat dibantah (of argument).
waterway	kb. 1 jalan air. 2 terusan.
waterworks	bangunan air.
watery	ks. 1 encer (of soup). 2 berair (of o's eyes). 3 pucat. 4 banyak hujan.
watt	kb. wat(t). watt-hour jam watt.
wattage	kb. jumlah watt.
wattle	kb. 1 poul.: pial. 2 anyaman dahan-dahan dan ranting-ranting kayu.
wave	kb. gelombang. radio w. gelombang radio. 2 keriting, ikal, alunan (in hair). 3 ombak. 4 lambaian. -kkt. 1 melambaikan (the hand, a flag). 2 mengacungkan (weapon, fist). 3 mengombak (hair). -kki. 1 melambai. 2 berkibar (of flags). 3 berombak.
wave, wave	kb. anggota korp cadangan wanita al (di as).
waveband	kb. riak gelombang.
waver	kki. 1 ragu-ragu (in o's decision). to w. between ragu-ragu antara. 2 goncang. 3 berkelap-kelip (of a light).
wavy	ks. berombak, keriting (of hair). w. line garis yang berombak.
wax	kb. lilin. floor w. lilin lantai. w. paper kertas lilin/parafin. -kkt. menggosok dengan lilin. -kki. 1 menjadi. to w. enthusiastic menjadi gembira. 2 bertambah besar (of the moon). -waxing kb. bertambah besar (of the moon).
waxy	ks. dari lilin. w. substance bahan dari lilin.
way	kb. 1 jalan. 2 arah, jurusan. 3 cara. 4 hal. 5 daerah. 6 jarak. by w. of 1 melalui, melewati. 2 sebagai kesimpulan. that w. 1 dengan begitu. 2 begitu. 3 kesana.
wayang	kb. wayang.
waybill	kb. semacam konosemen.
wayfarer	wayfarer
waylaid	lih waylay.
waylay	kkt. (waylaid) 1 mencegat. 2 menghentikan.
ways	j. galangan peluncuran kapal kedalam air. the ways adat, kebiasaan. ways-out ks. sl.: luarbiasa (of a book, so's views, clothes).
wayside	kk. tepi/pinggiran jalan. to fall by the w. jatuh, kalah, berhenti. w. table meja di tepi jalan.
wayward	ks. tidak patuh, suka melawan.
we	kg. 1 kami (speakers only). 2 kita (all, including those spoken of). we leave tomorrow kami berangkat besok.
we'd	1 [we had] kami telah. 2 [we would] kami akan.
we'll	[we will, we shall] kami/kita akan.
we're	[we are] kami/ kita akan.
we've	[we have] kami/kita telah.
weak	ks. 1 lemah (of stomach). he's too w. to sit up dia terlalu lemah untuk duduk. 2 lemah, da'if (argument). 3 rendah, lemah (gas, electricity). 4 lemah, sedang menurun (of stock market). 5 encer (of tea, coffee).
weak-kneed	ks. lembek, lemah. weak-minded ks. bimbang, berjiwa lemah. -weakly kk. 1 dengan lemah. 2 sering sakit-sakit, sakit-sakitan.
weaken	kkt. memperlemah, melemahkan (a foundation). to w. a drink melemahkan minuman keras. -kki. menjadi lemah (under pressure, from disease). weakenend condition keadaan yang menjadi lemah.
weakling	kb. orang yang lembek/lemah.
weakness	kb. kelemahan, kekurangan (of an argument). to have a w. for women mempunyai kelemahan terhadap wanita.
wealth	kb. kekayaan. to possess a w. of information on mempunyai banyak keterangan mengenai.
wealthy	kb. the w. j. orang-orang kaya, kaum hartawan. -ks. kaya.
wean	kkt. 1 menyapih, menyarak (a baby). 2 menghentikan, membuat berhenti (s.o. from a bad habit).
weapon	kb. senjata. weapon carrier semacam kendaraan militer untuk mengangkat senjata.
wear	kb. 1 pakaian. 2 pemakaian. -kkt. (wore, worn) 1 memakai (clothes). 2 kelihatan. 3 melicinkan, meratakan.
wear-resistant	ks. tahan lama (of tires). -worn ks. 1 usang (of material). 2 letih. worn-out ks. cape, letih, lesu. -wearing ks. melelahkan, meletihkan (trip).
wearability	kb. daya tahan pakai.
wearable	ks. 1 dapat dipakai. 2 dapat tahan.
wearer	kb. pemakai.
weariness	kb. kelelahan, keletihan, kelesuan.
wearisome	ks. mencapekkan, menjemukan.
weary	ks. 1 capek, letih. my w. feet kakiku letih. 2 bosan, jemu. -kkt. (wearied) membosankan. -kki. bosan. -wearied ks. lelah. -wearyingks. melelahkan, meletihkan. -wearily kk. dengan lelahnya/letihnya.
weasel	kb. semacam musang. -kki. inf.: keluar dengan susah-payah. to w. out of a situation bersusah-payah keluar dari sesuatu keadaan.
weather	kb. 1 cuaca. w. report berita cuaca.. 2 daerah cuaca. -kkt. 1 melalui, menyelesaikan (a problem). 2 dapat bertahan, melalui. -kki. membiarkan lama-lama dimakan cuaca. . -weathering kb. kerusakan kena hujan dan angin, hancuran iklim.
weathercock	kb. gada-gada, penunjuk (arah) angin.
weatherman	kb. (j. -men) inf.: peramal cuaca, ahli penyelidik cuaca.
weatherproof	ks. tahan cuaca.
weatherstrip	kkt. (weatherstripped) memberi pita pelindung terhadap cuaca.
weatherworn	ks. dimakan cuaca.
weave	weave
weaver	kb. 1 penenun, tukang tenun. 2 penganyam.
web	kb. 1 jaringan. w. of lies jaringan kedustaan. 2 selaput diantara jari-jari kaki (of ducks).
webbing	kb. anyaman, pita (tenunan) yang kuat dan lebar.
webfooted	ks. berkaki berselaput diantara jari-jari.
wed	kkt. (wedded) 1 mengawini. she weddid him ia menikahinya. 2 mengawinkan, menikahkan. -kki. kawin, nikah. -wedded ks. kawin. -wedding kb. 1 perkawinan, pernikahan. 2 penyatuan, perpaduan (of disparate elements).
wed.	[wednesday] hari rabu.
wedge	kb. 1 baji (for spitting wood). 2 iris. a w. of cheese seiris keju. -kkt. mendesak. -kki. terjepit (in a doorway).
wedlock	kb. ikatan perkawinan.
wednesday	kb. hari rabu.
wee	ks. (amat) kecil. a w. bit of cake kue sedikit saja. the w. small hours of the morning jauh larut malam.
wee-wee	kki. sl.: buang air, kencing.
weed	kb. 1 rumput liar, rumput-rumputan. 2 inf.: tembakau. 3 inf.: rokok mariyuana. -weeds j. pakaian berkabung. -kkt. menyiangi, merumputi (a yard, garden). -weeding kb. penyiangan.
weeder	kb. alat/mesin pencabut rumput liar.
weedkiller	kb. obat pembunuh rumput-rumputan.
weedy	ks. berumput banyak, penuh rumput-rumputan (of a yard).
week	kb. minggu, pekan. to be away for a w. pergi selama seminggu.
weekday	kb. hari kerja.
weekend	kb. akhir pekan/minggu. w. resort tempat bertamasya (pada) akhir pekan. -kki. bertamasya akhir pekan.
weeklong	ks. selama sepekan.
weekly	weekly
weenie	= wiener.
weeny	ks. sangat kecil. lih teeny.
weep	kkt. (wept) mencucurkan. to w. buckets of tears menangis mencucurkan air mata yang banyak. -kki. menangis. -weeping kb. tangisan.
weepy	ks. inf.: mudah menangis.
weevil	kb. kumbang penggerek. lih boll.
weigh	kkt. 1 menimbang (a package). 2 mempertimbangkan (a matter). 3 membongkar. -kki. menimbang berat badan.
weight	kb. 1 berat, bobot. 2 batu ladang (on fishing line). 3 tahanan. -weights j. (anak) timbangan. -kkt. menghimpit.
weightiness	kb. kepentingan, pentingnya. the w. of the problem pentingnya soal itu.
weightless	ks. tanpa bobot.
weightlessness	kb. keadaan tak berbobot.
weighty	ks. berat, penting (problem).
weird	ks. 1 aneh (person). 2 mengerikan (story).
weirdie	kb. sl.: orang yang aneh, orang yang luar biasa.
weirdo	weirdo
welcome	kb. 1 sambutan. 2 selamat datang. -ks. 1 menggembirakan. 2 boleh saja. -kkt. 1 menyambut (s.o.). 2 menerima dengan senang hati (an opportunity).
weld	kkt. 1 memateri, melas (metal). 2 menyatukan, menggalang (the country). -kki. dilas. -welding kb. pekerjaan mengelas. w. torch obor/api pengelas.
welder	kb. pengelas, tukang las.
welfare	kb. kesejahteraan, keselamatan. for his own w. untuk keselamatannya sendiri.
well	kb. 1 sumur, mata air, perigi. -ks. 1 sehat. 2 baik. kseru. nah. well-advertised ks. kerap/banyak diiklankan. well-advised ks. mendapat nasehat yang baik. well-appointed ks. yang perkakas rumahnya baik (of an apartment). well-balanced ks. seimbang.
wellborn	ks. dari keluarga orang baik-baik.
wellspring	kb. sumber/mata air.
welsh	kki. tidak memenuhi. to w. on a contract mengingkari kontrak.
welt	kb. bilur.
welter	kb. campuran/tumpukan yang kacau.
welterweight	welterweight
wench	kb. dara, gadis.
wend	kkt. pergi. to w. o's up to pergi naik ke. to w. o's way home pergi pulang. -kki. pergi.
went	lih go.
wept	lih weep.
were	lih be.
weren't	[were not] telah tidak (ada).
wert	lih be.
west	kb. barat, sebelah/bagian barat. the sun sets in the w. matahari terbenam disebelah barat. the w. 1 barat. 2 us.: negara-negara bagian yang terletak di bagian barat. west-bound ks. yang menuju ke barat (traffic).
westerly	kb. angin barat. -ks. ke barat, dari barat.
western	kb. 1 pilem koboi. 2 buku koboi. -ks. barat. the w. bloc barat. w civilization peradaban barat. w. hemisphere belahan bumi barat. w. union kantor kawat di as.
westerner	westerner
westernization	kb. pembaratan.
westernize	kkt. meembaratkan.
westward(s)	kk. menuju/ke jurusan barat.
wet	kb. kebasahan. don't go out in the w. jangan keluar/pergi berhujan. -ks. basah. -kkt. (wet atau wetted) membasahi. -weting kb. pembasahan.
wetness	kb. kebasahan.
wha(t)chamacallit	kb. inf.: apa namanya.
whacha	[what are you] sl.: w. doing ? ngapain ? sedang berbuat apa. ?
whack	kb. pukulan keras. sl.: to have/ take a w. at mencoba. -kkt. memukul. -whacking inf.: ks. amat besar.
whacky	= wacky.
whaddya	[what do you] sl.: apa yang kamu. w. know ? apa yang kamu tahu ?
whale	kb. ikan paus. a w. of yang amat hebat. -kkt. inf.: memukul, menghantam, menghajar. -whaling kb. penangkapan ikan paus. w. ship kapal penangkapan ikan paus.
whalebone	whalebone
whaler	kb. 1 (ship) kapal penangkap ikan paus. 2 penangkapan ikan paus.
wham	kseru. bluk, bam. -kkt. (whammed) memukulkan, menumbukkan.
wharf	kb. (j. whareves) dermaga.
wharves	j. lih wharf.
what	ks. 1 apa. 2 alangkah. -kg. 1 apa. 2 siapa. 3 berapa. 4 apa yang. 5 yang. 6 yang mana.
whatever	ks. apa saja, apapun. -kg. 1 apa saja. 2 inf.: apakah gerangan.
whatnot	kb. 1 barang kecil. 2 rak dinding kecil.
whatsoever	= whatever.
wheat	kb. terigu, gandum. w. belt daerah terigu/gandum. w. germ benih gandum.
wheatcake	kb. kue gandum/dadar/serabi.
wheatland	kb. tanah perladangan atau daerah gandum.
wheedle	kkt. 1 membujuk (s.o.). 2 memancing, menggait, menipu (information out of s.o.).
wheel	kb. 1 roda. 2 setir. 3 roda, jentera (in a watch). 4 sl.: tokoh, gembong. -kkt. memutar (a car). -kki. berbalik. w. chair kursi-roda.
wheelbarrow	kb. gerobak tangan, kereta sorong (yang beroda satu).
wheelbase	kb. jarak roda.
wheeler	kb. kendaraan beroda. two-wheeler bike sepeda roda dua. wheeler-dealer kb. pedagang lihay.
wheelwright	kb. tukang roda.
wheeze	kb. bunyi menciut-ciut, mendesah. -kki. berbunyi menciut-ciut.
whelp	kb. anak (binatang). -kki. melahirkan.
when	kb. lih where. -kk. bila (mana), kapan.-kg. sejak kapan. -ksam. 1 kalau, bilamana. 2 ketika (past time).
whence	kk. darimana.
whenever	kk. sewaktu-waktu, kapan-kapan. -ksam. bilamana saja.
where	kb. the w. and when of his birth dimana dan kapan ia dilahirkan. -kk. 1 dimana. 2 mana. 3 dari mana. 4 kemana. 5 apa. 6 padahal. -kg. tempat.
whereabout(s)	kb. tempat berada. his w. is know tempat dimana dia berada diketahui. -kk. dimana. w. is there a telephone ? dimana ada telepon ?
whereas	kb. mengingat. w., we ... oleh karena kami... -ksam. sedangkan, sebaliknya, padahal.
whereby	kk., ksam. untuk, dengan jalan mana. i know no other way w. it can be achieved saya tidak tahu jalan lain untuk mencapainya.
wherefore	kb. lih why. -kk. mengapa.
wherein	kk., ksam. dimana, dalam mana.
whereof	kk., ksam. tentang apa. he knows w. he speaks ia menetahui tentang apa ia berbicara.
wheresoever	kk., ksam. kemanapun.
whereupon	kk., ksam. lalu, kemudian, sesudah mana.
wherever	kk. kemanapun, kemana saja. w. you go, you'll be welcome kemanapun engkau pergi, engkau akan diterima dengan ramah-tamah.
wherewithal	kb. alat atau uang yang diperlukan, persediaan yang diperlukan.
whet	kkt. (whetted) 1 mengasah (a knife). 2 merangsang, menambah (an appetite).
whether	ksam. apa(kah). do you know w. she's coming ? tahukah engkau apakah ia akan datang atau tidak?
whetstone	kb. batu asah(an).
whew	kseru. wah.
whey	kb. air dadih.
which	ks. yang mana. -kg. 1 yang mana. w. is your car ? yang mana mobilmu 2 yang. the boat w. i owned perahu yang saya punyai/miliki.
whichever	ks., kg. (yang) mana saja. take w. hat you like ambillah topi yang mana saja yang saudara sukai.
whiff	kb. 1 bau (of tobacco). 2 kepulan (of smoke).
while	kb. saat, waktu. a little w. sebentar. the w. sementara itu. once in a w. sekali-sekali, terkadang-kadang. -ksam. 1 sementara. 2 walaupun. 3 sedangkan. -kkt. melewatkan.
whim	kb. tingkah.
whimper	kb. rengek. kki. merengek.
whimsical	ks. tidak keruan, aneh, bertingkah.
whimsy	kb. (j. -sies) sifat/lelucon yang aneh.
whine	kb. 1 rengekan (of a child). 2 deru (of an engine). -kki. 1 mendengking (of a dog). 2 merengek (of a person). 3 menderu (of an engine). to w. for merengek meminta (sesuatu).
whip	kb. 1 cemeti, cambuk, pecut. 2 pol.: tokoh politik penggerak. -kkt. (whipped) 1 mencemeti, mencambuk, mendera (seseorang). 2 inf.: (defeat) mengalahkan. 3 mengocok (cream). 4 melambai - lambaikan. -whipping kb. dera.
whiplash	kb. 1 pukulan cemeti. 2 salah urat pada leher karena kepala tersentak (from an accident). -kkt. memukul dengan cemeti.
whipper-snapper	kb. pemuda yang congkak.
whippoorwill	kb. semacam burung di as.
whipsaw	kb. gergaji tangan.
whir	kb. deru, desing. -kki. (whirred) mendesing, menderu.
whirl	kb. 1 pusingan. 2 perasaan bingung. -kkt. memutar, memusingkan (a baton). -kki. berputar.
whirligig	kb. semacam gasing, mainan yang dapat diputar.
whirlpool	kb. pusaran air.
whirlwind	kb. angin puyuh/langkisau/selembubu.
whirlybird	kb. inf.: helikopter.
whirr	= whir.
whish	kb. bunyi mendesir.
whisk(e)y	kb. wiski. w. and soda wiski soda.
whisker	kb. 1 rambut janggut (of persons). 2 sungut kucing (of cat). -whiskers j. jambang (di pipi).
whisper	kb. bisikan, to speak in a w. berbisik-bisik. -kkt. membisikkan. -kki. berbisik. -whispering kb. berbisik-bisik. w. campaign kampanye bisik-bisik/desas-desus.
whist	kb. semacam permainan kartu.
whistle	kb. 1 peluit. 2 bunyi peluit. 3 siul(an). -kkt. bersiul melagukan 9a melody). -kki. 1 bersiul (by aperson). 2 mmbunyikan peluit (by referee, conductor).
whistler	kb. penyiul, orang yang bersiul.
whit	kb. hal yang kecil. i don't care a w. about his health aku tak perduli sedikitpun tentang kesehatannya.
white	kb. putih. -whites j. 1 kaum/bangsa kulit putih. 2 telur putih. -ks. 1 putih. 2 menjadi pucat (from fear). white-faced ks. pucat pasi, bermuka pucat. white-haired/-headed ks. beruban, berambut putih.
whitecap	kb. ombak yang memutih, ombak yang berpuncak putih, kepala ombak.
whiten	kkt. memutihkan, membuat putih. -kki. memutih.
whitener	kb. obat/bahan pemutih.
whiteness	kb. putihnya, sifat putih.
whitewall	kb. ban berpinggiran putih.
whitewash	kb. cat/air kapur. -kkt. 1 mengapuri, melabur. 2 inf.: mencukur (the opposing team). 3 menutupi kesalahan-kesalahan (an investigation).
whither	kk. kemana.
whitish	ks. keputih-putihan.
whitsuntide	kb. hari-hari pantekosta.
whittle	kkt. meraut, mengerat (wood, a statue). -kki. to w. down o's expenses mengurangi pengeluaran (sedikit demi sedikit).
whiz(z)	kb. jagoan, ahli. he's a w. at tennis dia seorang yang ulung dalam bidang tenis. -kkt. (whizzed) mendesingkan. -kki. 1 mendengung, mendesing (of bees). 2 mendesing (of a ball). whiz-bang ks. ulung, unggul.
who	kg. 1 siapa. w. called me ? siapa (yang) memanggil saya ? 2 yang. 3 siapa-siapa, barang-siapa, siapa saja.
who'll	[who will, who shall] siapa yang akan.
who's	[who is, whohas] siapa yang. w. who 1 (buku yang memuat) orang terkemuka. 2 siapa orang-orangnya.
who, w.h.o.	[world health organization] kb. organisasi kesehatan sedunia.
whoa	kseru. 1 stop (seruan untuk kuda). 2 nanti/tunggu dulu (said to a person).
whoadunit	whoadunit
whoever	kg. 1 siapapun, barang siapa. 2 siapakah gerangan.
whole	kb. 1 keseluruhan. 2 jumlah. -ks. 1 seluruh. 2 lengkap. 3 bulat, utuh. whole-hearted ks. tulus, ikhlas, sungguh-sungguh, sepenuh hati. whole-wheat ks. tepung terigu yang terdiri dari biji-biji terigu yang utuh. -wholly kk. sama sekali.
wholesale	kb. borongan, usaha grosir, kulakan.-ks. besar-besaran. -kkt. menjual secara borongan.
wholesaler	kb. tengkulak, grosir, peraih, pedagang perantara yang membeli secara besar-besaran.
wholesome	ks. 1 sehat (person, food, atmosphere). 2 berfaedah, bermanfaat (of books).
wholly	kk. lih whole.
whom	kg. 1 siapa. w. are you calling ? siapa yang kau panggil ? 2 yang. the man w. she accompanied was... laki-laki yang ditemaninya itu adalah...
whomever	kg. siapapun, barang siapa . w. she marries... siapapun yang menjadi suaminya...
whomp	kkt. inf.: mengalahkan.
whomsoever	kg. siapa saja. ask w. you wish tanyakan kepada siapa saja yang kau inginkan.
whoop	kb. teriakan, sorak(-sorai). -kki. berbatuk-batuk dengan suara keras.
whoopee	kseru. huree. to make w. berpesta pora.
whoops	kseru. aduh.
whoosh	whoosh
whop	kb. inf.: pukulan keras, gebuk. -kkt. (whopped) memukul, menggebuk. -whopping ks. besar (lie, amount).
whopper	kb. inf.: 1 sesuatu yang sangat besar. 2 bohong besar.
whore	whore
whorehouse	kb. rumah sundal/jalang/ pelacuran,pegermoan.
whorl	kb. 1 lingkaran, gelungan. 2 ulir, alur-alur berputar.
whose	kg. 1 siapa (punya). w. glove is that ? siapa punya saruing tangan ini ? 2 yang...-nya. a couple w. daughter you met suami-istri yang anak perempuannya berjumpa dengan kamu.
whosoever	= whoever.
why	kb. the whys and wherefores of a subject sebab-musabab, duduk perkara, persoalan. -kk. mengapa, kenapa, apa sebab. -kseru. 1 aduh, wah. 2 hai. 3 oh, ah.
wick	kb. sumbu.
wicked	ks. 1 jahat (of a person). 2 hebat 9of a storm). 3 keras (blow). 4 nakal (smile).
wickedness	kb. kejahatan. 2 kenakalan.
wicker	kb. dahan atau ranting untuk dijadikan anyaman. w. basket keranjang anyaman. w. chair korsi anyaman (rotan).
wickerwork	kb. barang anyaman.
wicket	kb. 1 pintu/gerbang kecil. 2 sport : gawang.
wide	ks. 1 lebar. 2 luas. 3 bermacam-macam. -kk. jauh. wide-awake ks. 1 mata terbuka lebar. 2 cerdas, sigap. 3 waspada. wide-brimmed ks. berpinggir(an) lebar (of a hat, glasses). wide-eyed ks. 1 dengan mata terbelalak. 2 dengan penuh keheranan.
widely	kk. 1 luas w. acclaimed diakui secara luas. 2 kemana-mana. w. known terkenal kemana-mana.
widen	kkt. melebarkan, memperlebar. -kki. melebar. -widening kb. pelebaran (of a road).
widespread	ks. 1 tersebar luas (of disease). 2 yang meluas, besar (of interest). 3 terkembang lebar (of wings).
widow	kb. randa, janda. -kkt. menjadikan janda. to be widowed menjadi janda.
widower	kb. duda, janda, randa.
widowhood	kb. kejandaan, keadaan hidup sebagai janda.
width	kb. 1 lebar. what is the w. of the material ? berapa lebar bahan (kain) itu ? 2 keluyasan. w. of vision keluasan pandangan.
wield	kkt. 1 memegang dan menggunakan (a sword, axe, stick). 2 mempunyai (influence).
wiener	kb. semacam sosis. w. roast piknik dengan makan sosis dipanggang.
wienie	= wiener.
wife	kb. (j. wives) istri. to take as a w. memperistri. she is his second w. ia istrinya yang kedua.
wifely	ks. sebagai isteri. w. duties tugas-tugas sebagai seorang isteri.
wig	kb. rambut palsu.
wiggle	kb. 1 berlenggang, bergoyang (of walking). 2 bergeliat-geliut, berliat-liut (of a fish). -kki. bergoyang-goyang. don't w. so much ; stand still jangan begitu bergoyang-goyang ; berdiri diam-diam.
wiggler	kb. 1 orang yang terus saja bergerak. 2 (insect) anak nyamuk, jentik-jentik.
wigwag	kki. mengayunkan (sesuatu) sebagai isyarat.
wiireless	ks. tanpa kawat. w. operator markonis. w. telegraphy telegrap. w. telephone telepon radio.
wild	kb. wilds j. daerah liar, hutan belantara/rimba. -ks. 1 liar. 2 gila. 3 sembrono, sembarangan. 4 ribut. -kk. (dengan) liar. 2 bersimaharajalela (of weeds). -wildly kk. dengan ramai.
wildcat	kb. kucing hutan/jalang/buas. -ks. liar. w. strike pemogokan yang tak disahkan, pemogokan liar.
wilderness	kb. hutan belantara.
wildfire	kb. to spread like w. menyebar cepat sekali.
wildflower	kb. lih wild.
wildlife	kb. margasatwa. w. preserve suaka margasatwa. w. sanctuary cagar alam.
wildness	kb. 1 kebuasan (of an animal). 2 keadaan liar.
wildwood	kb. hutan belantara, rimba.
wile	kb. tipu muslihat, akal. -kkt. to w. away the hours menghabiskan waktu.
wilful	ks. disengaja. w. neglect pengabaian yang disengaja. -wilfully kk. dengan sengaja.
will	kb. 1 kemauan. 2 kehendak. 3 hasrat. 4.surat wasiat. -kkb. (would) 1 akan. 2 mau. 3 dapat. 4 harus. 5 biasa. would-be kb. seorang bakal/calon. ks. 1 akan menjadi. 2 berlagak seperti/seakan-akan. 3 gadungan. -willing ks. mau, sudi.
will-o'-the-wisp	kb. 1 lelatu, cetusan api. 2 impian.
willful	= willful.
willies	kb., j. inf.: kegelisahan, kebingungan.
willow	kb. semacam pohon.
willowy	ks. ramping, langsing.
willpower	kb. ketekunan, kemauan yang keras, tekad, dayakarsa.
willy-nilly	kk. 1 mau tak mau, bagaimanapun juga. 2 kacau-balau.
wilt	kki. menjadi layu (of flowers). 2 menjadi lesu, kehilangan tenaga (of a person).
wily	ks. cerdik, pintar, cerdas, lihay.
win	kb. inf.: kemenangan. -kkt. (won) 1 memenangkan, menang dalam (a race). 2 mencari. 3 memikat hati (an audience). -kki. menang. -winning kb. kemenangan. winning j. hasil kemenangan. ks. 1 yang menang. 2 yang menarik, yang menawan hati.
wince	kb. kedip, kelip, kejap. -kki. bergerenyit, menggerenyit.
winch	kb. mesin derek, kerekan.
wind	kb. 1 angin. 2 napas. wind-blown ks. keanginan. -winded ks. kehabisan/kekurangan napas.
windbag	kb. sl.: tukang bual.
windbreak	kb. penahan angin.
windbreaker	kb. jaket.
windfall	kb. rejeki nomplok, durian runtuh, rejeki yang tak disangka-sangka.
windlass	kb. mesin kerek.
windmill	kb. kincir/kitiran angin. to tilt at windmills dengan sia-sia menyerang sesuatu yang tak dapat dikalahkan.
window	kb. 1 jendela. please close the w. coba tutup jendela itu. 2 loket (at bank, movie theater). to window-shop melihat-lihat (pajangan etalase) toko-toko.
windowpane	kb. kaca jendela.
windpipe	kb. batang tenggorokan.
windshield	kb. kaca depan (pada mobil). w. wiper kipas kaca mobil.
windstorm	kb. angin topan.
windswept	ks. keanginan.
windward	kb. arah darimana angin bertiup. -kk. atas angin. to cast an anchor to w. mengambil langkah-langkah untuk pengamanan.
windy	ks. 1 berangin, banyak angin (day). 2 yang banyak sekali omongnya (of a person or speech).
wine	kb. anggur. -kkt. menjamu dengan minum anggur. wine-colored ks. berwarna merah tua.
winery	kb. (j. -ries) kilang anggur.
wing	kb. 1 sayap (of bird, plane, building). 2 thea.: sisi panggung. 3 av. satuan. -wings j. tanda/lencana penerbang. -kkt. mengenai sayap. winged ks. bersayap.
wingding	kb. sl.: pesta ramai.
wingspread	kb. 1 lebar sayap (of a plane). 2 panjang sayap (of a bird).
wink	kb. 1 kedip(an). 2 sebentar. -kkt. memberi isyarat dengan kedipan mata (to kepada). -kki. 1 mengedipkan mata (of a person). 2 berkedip-kedip (of a stars).
winner	kb. pemenang. this is a winner-take-all fight ini merupakan pertandingan dimana pemenang akan mendapat semua hadiah.
winnow	kb. penampi. -kkt. 1 menampi (grain). 2 memisahkan (truth from rumor).
wino	kb. sl.: pencandu anggur.
winsome	ks. menarik, menawan hati.
winter	kb. musim dingin. in w. dalam musim dingin. -kki. menghabiskan musim dingin.
wintergreen	kb. semacam tanaman di as.
winterize	winterize
wintertime	kb. waktu musim dingin.
wintry	ks. yang berkaitan dengan musim dingin. w. night malam musim dingin.
wipe	kb. sapuan. -kkt. 1 menyeka (the dishes, o's hands). 2 menghapus (o's face, the blackboard). 3 membersihkan/menghapus (o's nose). 4 menggosok (o's eyes).
wiper	kb. penyeka, penghapus, penyapu, kain lap. w. blade daun penyapu. lih windshield.
wire	kb. 1 kawat, dawai, kabel. 2 inf.: telgram, kawat. -kkt. 1 menelgram, mengawatkan (s.o). 2 memasang kawat (a house). 3 mengikat dengan kawat (s.t. together). -kki. mengirim telgram.
wirephoto	kb. foto telegrap. -kkt. mengirim foto dengan kawat.
wirepuller	kb. orang yang dengan diam-diam mempergunakan pengaruhnya, pengatur siasat dibelakang layar.
wiretap	kb. rekaman / penyedapan suara dari sambungan telpon. -kkt. (wiretapped mengadakan sambungan/penyadapan telpon secara rahasia untuk mendengarkan percakapan-percakapan. -wiretapping kb. penyadapan pembicaraan (telpon) tanpa diketahui.
wiriness	kb. keliatan, sifat kasar seperti kawat.
wiry	ks. 1 liat, liat-liut (of hair). 2 kurus tapi kuat (of a person).
wis(c).	wisconsin] negarabagian di as.
wisdom	kb. kebijaksanaan, kearifan. w. tooth geraham bungsu. w. of age kebijaksanaan karena umurnya.
wise	kb. cara. -ks. bijaksana, arif. -kkt., kki. sl.: to w. up menyadar, menjadi sadar, memberitahukan. -wisely kk. dengan bijaksana.
wiseacre	kb., orang yang sok tahu.
wisecrack	kb. sl.: lelucon, jawaban yang tepat dan lucu.
wish	kb. keinginan, kehendak, hasrat, kemauan. -kkt. 1 mengharapkan. 2 menginginkan. 3 menghendaki. 4 ingin.
wishbone	kb. tulang garpu (ayam).
wishful	ks. ingin, berkeinginan. w. thinking impian khayal/keinginan.
wishy-washy	ks. 1 lembek, lembah. 2 encer. 3 plin-plan.
wisp	kb. 1 unting (of hair). 2 utas (of straw). 3 gumpalan (of smoke).
wistfal	ks. sayu, sedih, bermuram durja. -wistfully kk. dengan prihatin.
wit	kb. 1 orang jenaka. 2 akal. -wits j. kecerdasan. -witting ks. dengan sengaja. -wittinglykk. dengan kesadaran itikad, sadar, mengetahui.
witch	kb. tukang sihir wanita. she's an old w. ia perempuan tua yang jahat.
witchcraft	kb. ilmu gaib/sihir, guna-guna.
with	kd. 1 dengan. 2 serta. 3 pakai. 4 pada. 5 karena. 6 bersama.
withdraw	kkt. (withdrew, withdrawn) menarik, mengambil (o's hand, o's savings). -kki. 1 menarik diri (from dari) (a contest). 2 meninggalkan. -withdrawn ks. pendiam, suka menyendiri (of personality).
withdrawal	kb. 1 pengambilan kembali (of funds, troops). 2 penarikan dari (from a campaign). 3 penarikan dirinya dari masyarakat (from society).
withdrawn	lih withdraw.
withdrew	lih withdraw.
wither	kkt. melayukan (flowers0. -withered ks. 1 layu (of flowers). 2 lemah, kurus (kering) (of an arm). -withering ks. yang meremukkan, yang amat menghina.
withheld	lih withhold.
withhold	kkt. (withheld) 1 tidak memberi, menyembunyikan (information, clues). 2 tidak memasukkan (names from a list). 3 menahan sejumlah gaji uang (dari gaji dsb) untuk membayar (taxes). -withholding kb. pemotongan pajak.
within	kk. dalam. -kd. 1 dalam. 2 sampai, dalam. 3 dibawah, tak lebih dari.
without	kd. tanpa, dengan tidak. w. financial help tanpa bantuan keuangan. i can't do w. my glasses aku tak dapat berbuat apa-apa tanpa kacamataku.
withstand	kkt. (withstood) menahan, bertahan (terhadap) (an assault, advances, pain).
withstood	lih withstand.
witless	ks. dungu, tidak berakal.
witness	kb. 1 saksi. w. stand tempat saksi. 2 kesaksian, penyaksian. to bear w. 1 memberikan kesaksian (against terhadap). 2 mencerminkan (hardship, pain). -kkt. 1 menyaksikan (an accident). 2 (to experience) mengalami (disorder, corruption, revolution).
witticism	kb. kejenakaan, ucapan yang lucu.
wittingly	lih wit.
witty	ks. jenaka, pintar lucu (person, remark). -wittily kk. dengan jenaka/ lucu.
wive	lih wife.
wizard	kb. 1 ahli sihir. 2 jagoan, ahli (in mathematics). financial w. pandai sekali atau ulet dalam soal keuangan.
wizardry	kb. ilmu sihir.
wizened	ks. (ber)keriput, layu, berkerut, berkerinyut (face).
wk(s)	1 [week(s)] minggu, pekan. 2 [work(s)] pekerjaan, karya.
wm.	[william] william.
wo	[warrant officer] bintara.
wobble	kb. goyang(an). -kki. terhuyung-huyung, bertatih-tatih.
wobbly	ks. 1 gual-gail, goyang, goyah (of a person). 2 reyot (of furniture).
woe	kb. sengsara, kesengsaraan. w. to him who sins ! terkutuklah barangsiapa yang berdosa.
woebegone	ks. sedih.
woeful	ks. sedih. -woefully kk. dengan sedih.
woke	lih wake.
wolf	kb. 1 serigala. 2 buaya (lelaki), mata keranjang. -kkt. to w. down memakan dengan rakus.
wolferine	kb. semacam anjing hutan yang berbulu tebal.
woman	kb. (j. women) wanita, perempuan. young w. wanita muda.
womanhood	kb. 1 kewanitaan. 2 kaum wanita/hawa. to develop into w. manjadi dewasa.
womanish	ks. kewanita-wanitaan.
womankind	kb. kaum wanita/hawa.
womanly	ks. seperti wanita. w. advice nasihat kewanitaan.
womb	kb. kandungan, rahim, peranakan.
women	lih woman.
womenfolk	kb. kaum wanita/hawa.
won	lih win.
won't	[will not] tidak akan/mau.
wonder	wonder
wonderful	ks. sangat bagus. a w. success sukses yang sangat hebat. -wonderfully kk. amat, sangat.
wonderland	kb. negeri ajaib.
wonderment	kb. keheranan.
wondrous	ks. menakjubkan.
wont	kb. kebiasaan. -ks. biasa. to be w. to listen to the newscast biasa mendengarkan siaran wartaberita.
woo	kkt. 1 merayu, membujuk (a woman). 2 mencoba merebut (a fortune, the affection of a neighboring country). -wooing kb. bercumbu-cumbuan.
wood	kb. 1 kayu. 2 golf.: getokan kayu. 3 hutan. 4 kayubakar. -woods j. hutan.
woodbin	kb. peti tempat kayu bakar.
woodcarver	kb. pemahat kayu.
woodcarving	kb. 1 ukiran kayu. 2 (pekerjaan) mengukir kayu.
woodchopper	kb. penebang kayu.
woodcraft	kb. kerajinan kayu.
woodcut	kb. ukiran/klise kayu, lukisan dari ukiran kayu.
woodcutter	kb. penebang kayu.
wooded	ks. berpohon-pohon.
wooden	ks. 1 dari kayu. w. box peti kayu. 2 kaku (of manner).
wooden-headed	ks. tolol, dungu. sl.: w. nickel sesuatu yang palsu, tipu daya.
woodland	kb. daerah/tanah berhutan. w. area daerah/tanah hutan.
woodman	kb. (j. -men) penebang kayu.
woodpecker	kb. burung pelatuk.
woodpile	kb. tumpukan kayu (bakar).
woodshed	kb. gudang (tempat menyimpan) kayu.
woodwork	kb. bagian-bagian yang terbuat dari kayu (dalam rumah).
woodworker	kb. tukang/pekerja kayu.
woodworking	kb. pekerjaan tukang kayu.
woody	ks. bersikap rimba/hutan/kayu, banyak batang kayunya.
wooer	kb. perayu, peminang.
woof	kb. pakan.
wool	kb. bulu domba, (kain) wol. w. blanket selimut wol.
woolen	kb. pakaian wol. to packo's woolens away for the summer menyimpan pakaian wolnya untuk musim panas.
woolgatherer	kb. pelamun.
woolgathering	kb. mengelamun.
woolly	kb. inf.: woolies j. pakaian dalam dari wol. -ks. 1 berbulu, seperti wol. 2 tidak terang (of memo, thoughts).
woozy	ks. inf.: pusing.
word	kb. 1 kata. 2 perkataan. 3 sepatah kata. 4 kabar. 5 sabda. 6 janji. 7 pesan. 8 perintah. 9 (pass-) kata sandi. -kkt. menyusun kata-kata (a telegram). word-for-word ks. kata demi kata (quotation). word-of-mouth ks. secara lisan.
wordiness	kb. kepanjang-lebaran.
wording	kb. susunan kata.
wordy	ks. terlalu panjang-lebar, dengan banyak kata-kata, dengan panjang lebar.
wore	lih wear.
work	kb. 1 pekerjaan. 2 karya. 3 kerja. -kkt. 1 mengerjakan. 2 mengolah, mengusahakan (a farm, the soil). 3 meramas-ramas (butter). 4 menjalankan (a machine). work-shy ks. malas bekerja.
workability	kb. kemungkinan untuk dilaksanakan.
workable	ks. dapat dikerjakan/dilaksanakan (of a plan).
workaday	ks. biasa, sehari-hari (routine).
workbasket	kb. keranjang jahitan.
workbench	kb. meja kerja.
workbook	kb. buku catatan.
workday	kb. hari kerja.
worker	kb. pekerja, karyawan, buruh. he's a good w. ia seorang pekerja yang baik. -the workers j. para karyawan.
workhorse	kb. 1 kuda beban/penarik. 2 pekerja keras, seorang yang betul-betul kuat bekerja.
workinggirl	kb. buruh/pekerja wanita, karyawati.
workingman	kb. (j. men) karyawan, buruh/pekerja pria.
workings	j. 1 cara berpikir (of o's mind). 2 bagian dari tambang yang sedang dikerjakan.
workingwoman	kb. (j. -women) karyawati, buruh/pekerja wanita.
workload	kb. beban kerja.
workman	kb. (j. -men) laki-laki yang bekerja, karyawan, pekerja pria, buruh lelaki.
workmanlike	ks. mahir, cekatan, cakap.
workmanship	kb. 1 kecakapan kerja. 2 pembuatan. guaranteed against defects in w. dijamin terhadap cacat-cacat dalam pembuatan.
workout	kb. inf.: sport : latihan. 2 percobaan (of a car).
workroom	kb. ruang kerja.
workshop	kb. bengkel, ruang kerja, lokakarya.
worktable	kb. meja kerja.
workweek	kb,. pekan kerja.
world	kb. 1 dunia. 2 alam, dunia. 3 banyak sekali. word-famed, world-famous. ks. termasyhur, tersohor. world-wide ks. yang meliputi seluruh dunia (organization).
worldliness	kb. keduniawian.
worldly	ks. duniawi. w. ambitions cita-cita duniawi.
worm	kb. cacing, ulat. the w. will turn keadaan akan berubah. -worms j. penyakit cacing. worm-eaten ks. dimakan ulat, berulat (fruit).
wormhole	kb. lobang ulat.
wormy	ks. 1 berulat (of food). 2 bercacing, cacingan (of persons).
worn	lih wear.
worried	lih worry.
worries	lih worry.
worry	kb. (j. -ries) 1 kesusahan. 2 urusan. -kkt. (worried) 1 mencemaskan, menyusahkan. 2 mengganggu. -kki. 1 merasa cemas. 2 khawatir. 3 memikirkan. -worried ks. cemas, khawatir. -worriedly kk. dengan khawatir/cemas. -worrying ks. khawatir, mencemaskan.
worrywart	kb. seorang pesimis.
worse	ks. lih bad. 1 lebih buruk/jelek. 2 bertambah buruk. 3 lebih jahat. -kk. lebih buruk.
worsen	kkt. menjadikan/membuat lebih buruk. -kki. memburuk, menjadi lebih buruk (of s.o's condition, of business).
worship	kb. 1 ibadat, ibadah, sembahyang. 2 pemujaan. -kkt. 1 menyembah, memuja (god). 2 memperdewa (jewels). 3 memuja. -kki. bersembahyang, melakukan ibadat (at a church).
worshiper	kb. pemuja.
worst	kb. 1 yang paling buruk, yang terburuk. 2 yang paling hebat. 3 yang paling rugi. -ks. lih bad. 1 terburuk, paling buruk. 2 paling jahat. -kkt. mengalahkan (o's enemies).
worsted	kb. wol.
worth	kb. harga. -ks. 1 bernilai, cukup baik, bermanfaat. 2 berharga. 3 seimbang.
worthless	ks. tidak berharga/bernilai.
worthwhile	ks. berfaedah, berguna, bermanfaat.
worthy	kb. (j.-thies) orang yang berjasa. -ks. 1 berguna, berfaedah. 2 patut, layak, pantas.
would	lih will.
wouldn't	[would not] tidak akan.
wound	kb. luka. bullet w. luka kena tembakan. -kkt. melukai.
wove	lih weave.
woven	lih weave.
wow	kb. sl.: sesuatu yang hebat sekali. -kkt. sl.: membuat kagum. kseru. sl.: aduh, wah.
wrack	kb. bobrok. the house has gone to w. and ruin rumah itu sudah bobrok dan hampir runtuh.
wraith	kb. 1 roh. 2 hantu.
wrangle	kb. pertengkaran, percekcokan. -kki. bercekcok, bertengkar. (over tentang).
wrap	kb. selendang. -kkt. (wrapped) 1 membungkus (a package). 2 membelitkan, melilitkan. wrapping paper kertas pembungkus. -wrappings kb., j. bahan pembungkus.
wraparound	kb. pakaian yang dililitkan. w. skirt rok yang dililitkan.
wrapper	kb. 1 tukang bungkus, pembungkus. 2 pembungkus (of cigar). 3 sampul, selubung (of books). 4 cloth.: pakaian rumah.
wrapt	= wrapped.
wrath	kb. kegusaran, kemarahan, kemurkaan.
wreak	kkt. 1 mendatangkan, menimbulkan (havoc). 2 melampiaskan (o's anger) (on kepada). 3 membalas dendam (revenge).
wreath	kb. j. wreaths rangkaian bunga berbentuk lingkaran. funeral w. rangkaian bunga untuk pemakaman.
wreathe	kkt. 1 meliputi. her face was wreathed in smiles mukanya diliputi senyum. 2 melingkari. mist wreathed the hills kabut melingkari bukit-bukit.
wreck	kb. 1 kecelakaan. 2 rongsokan (of a boat). -kkt. merusak, menghancurkan (a building, plans). -wrecking kb. mengangkat barang (besar) yang rusak.
wreckage	kb. rosokan, rongsokan.
wrecker	kb. 1 tukang bongkar (of a building). 2 mobil penyeret/penarik.
wren	kb. semacam burung penyanyi.
wrench	kb. 1 (tool) kunci inggris. 2 pilinan, putaran 9of a wrist or ankle). -kkt. 1 merenggut (s.t. from s.o.). 2 membuka (a lid open). 3 keseleo, terkilir (o's ankle).
wrest	kkt. 1 merebut (authority/a knife from s.o.). 2 merebut, memperoleh secara paksa (a recipe, secret).
wrestle	kkt. to w. s.o. to the ground menjatuhkan seseorang ke tanah dengan pergulatan. -kki. bergumul, bergulat. -wrestling kb. pergulatan, gulat, adu gulat.
wrestler	kb. jago/tukang gulat, pe(ng)gulat.
wretch	kb. orang celaka/malang/sial. the poor w. orang yang malang itu.
wretched	ks. 1 tidak enak badan. 2 pahit, sial sekali, yang menyedihkan (of an experience). 3 sedih, susah sekali, buruk sekali.
wretchedness	kb. keadaan yang buruk/menyedihkan sekali.
wrier	lih wry.
wriest	lih wry.
wriggle	kb. geliang-geliut. -kki. bergeliang-geliut (of children, fish, worm).
wring	kkt. (wrung) 1 memeras (water from a cloth). to w. out memeras (a sheet). 2 meremas-remas (o's hands). 3 memijit (a chicken's head). 4 menyayat-nyayat hati kami.
wringer	kb. alat pemeras. inf.: to put s.o. through the w. menguji seseorang dengan percobaan yang berat.
wringing-wet	ks. basah kuyup.
wrinkle	kb. 1 kerut, kerenyut, keriput (in o's face, in clothes). 2 inf.: gagasan, akal. -kkt. mengisutkan, mengerutkan . -kki. menjadi kusut. -wrinkled ks. 1 berkerut, berkerenyut, kisut (of face). 2 kusut (of clothes).
wrinkleproof	ks. tahan kusut.
wrist	kb. pergelangan tangan. w. watch jam/arloji tangan.
wristband	kb. bagian manset lengan kemeja.
writ	kb. 1 surat perintah. 2 penulisan, perintah tertulis. holy w. penulisan yang suci.
write	kkt. (wrote, written) 1 menulis 9a letter). 2 mengarang, menulis (a novel). 3 menggubah, menulis (poetry). 4 mengambil. -kki. 1 menulis. 2 menulis, mengarang. written ks. tertulis. -writing kb. tulisan, karangan.
writer	kb. 1 penulis. 2 pengarang (of a novel).
writhe	kki. menggeliat. to w. in pain menggeliat kesakitan.
written	lih write.
wrong	kb. 1 kesalahan. 2 law : ketidakadilan. -ks. 1 salah. 2 keliru, khilaf. -kkt. 1 melukai hati, memperlakukan secara tidak adil (seseorang). 2 memburukkan tanpa alasan -wrongly kk. keliru, salah.
wrongdoer	kb. 1 orang yang bersalah. 2 penjahat, orang jahat.
wrongdoing	kb. 1 perbuatan salah. 2 pelanggaran.
wrongful	ks. 1 salah. 2 tidak sah, yang melanggar undang-undang.
wrote	wrote
wroth	ks. marah, gusar.
wrought	ks. dibuat, ditempa. w. iron besi tempa. wrought-up ks. gelisah, tegang.
wrung	lih wring.
wry	ks. (wrier, wriest) 1 miring, mencong. 2 masam. to make a w. face memandang dengan muak yang menolak sesuatu . w. smile senyum masam.
wt.	[weight] bertanya.
wy(o).	[wyoming] negarabagian di as.
x	kb. 1 huruf ke-24 dari abjad inggris. 2 kali. 2x3=6 2 kali 3=6. 3 jumlah yang tak diketahui. mr. x tuan anu. x. -kkt. menyinari dengan sinar x., memotret dengan sinar x.
xenophobe	kb. seseorang benci pada barang atau orang asing.
xenophobia	kb. kebencian terhadap barang atau orang asing, ketaksukaan pada yang serba asing.
xerography	kb. zerografi.
xerox	kkt. membuat kopi dengan alat xerox.
xmas	[christmas] hari natal.
xylography	kb. seni cetak dari ukiran kayu.
xylophone	kb. sejenis gambang.
y	kb. 1 huruf k-25 dari abjad inggris. the y-axis poros/garis y. 2 = ymca.
y.	1 [yard(s)] yar, yar-yar. 2 [year(s)] tahun, tahun-tahun.
yacht	kb. 1 perahu/kapal pesiar. 2 kapal (layar) untuk perlombaan.
yachting	kb. berperahu pesiar.
yachtsman	kb. (j. -men) peserta balap perahu, pengemudi perahu balap.
yackety-yack	kb. sl.: obrolan ramai-ramai.
yam	kb. ubi rambat.
yank	kb. inf.: renggutan, sentakan. sl.: y. orang amerika. -kkt. merenggut (a rope, a book from s.o's hands).
yankee	kb. orang amerika. us : orang new england, orang yang tinggal di bagian utara as. y. ingenuity kepintaran yankee.
yap	kb. sl.: gonggongan (pendek dan tajam). -kki. (yapped) 1 menyalak(i), menggonggongi (of a pup). 2 berkecek-kecek. -yapping kb. obrolan yang kosong.
yard	kb. 1 halaman, pekarangan. back y. halaman belakang. 2 langsiran. freight y. langsiran kereta api barang. 3 yar.
yardage	kb. 1 jumlah yar. 2 ukuran panjang dengan yar.
yardman	kb. (j. -men) 1 rr.: tukang langsir. 2 tukang kebun.
yardmaster	kb. kepala bagian langsiran.
yardstick	kb. 1 (kayu) meteran yar. 2 ukuran.
yarn	kb. 1 benang, benang rajutan/tenun. 2 cerita, cerita. to spin a y. mendongeng, bercerita.
yaw	kb. penyimpangan dari jurusan lurus. -kki. merewang, mengoleng.
yawl	kb. joli-joli.
yawn	kb. kuap -kki. 1 menguap. to stifle a y. menahan/menekan kuap. 2 terbuka lebar. -yawning ks. yang menganga. y. abyss jurang yang terbabang.
yaws	kb., j. framboesia, patek.
yd(s)	[yard(s)] yar, yar-yar.
ye	kst. itu. -kg. kamu, engkau.
yea	kb. ya, benar, memang, betul.
yeah	kk. inf.: yah.
year	kb. tahun. ten years sepuluh tahun. for years bertahun-tahun (lamanya). year-(a)round ks. sepanjang tahun. year-by-year ks. dari tahun ke tahun (appointment). year-end ks. akhir tahun. year-to-year ks. setahun-tahun (lease).
yearbook	kb. buku tahunan.
yearling	kb. anak kuda berumur antara satu dan dua tahun.
yearlong	ks. selama setahun (contract).
yearly	ks., kk. tahunan, sekali setahun.
yearn	kki. rindu. to y. to study frnch ingin sekali belajar bahasa perancis. -yearning kb. hasrat, kerinduan.
yeast	kb. ragi.
yell	kb. sorakan, teriakan, pekik. -kki. berteriak, memekik, bersorak. -yelling kb. pekikan, teriakan.
yellow	kb., ks. kuning. to turn y. menguning, menjadi kuning. -kkt. menguning, menjadi kuning. sl.: yellow-bellied ks. yang bersifat pengecut.
yellowish	ks. kekuning-kuningan.
yellp	kb. suara dengking, salak. -kki. mendengking, berdengking.
yen	kb. minat/keinginan/hasrat yang besar. -kki. (yenned) amat ingin, berhasrat sekali.
yeoman	kb. (j. -men) perwira rendahan dalam administrasi. to perform y. service memberikan bantuan yang berguna.
yes	kk. ya y., sir ya, tuan ; ya pak. -kkt. mengiakan, menyetujui (o's boss). inf.: yes-man pak angguk, orang pengekor, pembebek, penjilat.
yesterday	kb., kk. kemarin. yesterday's luncheon makan siang kemarin.
yet	kk. 1 masih. i don't y. know when saya masih belum tahu kapan. 2 masih belum. he doesn't know as yet ia masih belum tahu. ksam. namun, tetapi, sekalipun begitu.
yew	kb. sejenis pohon cemara.
yiddish	kb. bahasa yiddi.
yield	kb. hasil. wheat y. hasil/panenan gandum. -kkt. 1 menghasilkan. 2 memberi.-kki. 1 menyerah, mengalah.
ymca, y.m.c.a.	[young men's cristian association] kb. ikatan pemuda kristen.
yo-heave-ho	kseru. holopis kuntul baris ; tu-wa-ga !
yodel	kb. bernyanyi yodel.
yoga	kb. latihan disiplin mental cara hindu.
yogurt	kb. susu masam kental.
yoke	kb. 1 kuk. 2 pasang. a y. of oxen sepasang lembu. 3 beban, penindasan. 4 gandar. -kkt. memasang kuk. to y. oxen to a plow memasang kuk tenggala/bajak kepada lembu.
yokel	kb. orang dusun/udik.
yolk	kb. kuning telur.
yonder	kk. (nun) disana, disebelah sana.
yoo-hoo	kki. berteriak yuhu, berseru hihu. -kseru. yuhu, hihu.
yore	kk. dahulu kala.
you	kg. kamu, engkau, anda, saudara, kau.
you'd	1 [you had] lebih baik kau. 2 [you would] kau akan.
you'll	[you will, you shall] kau akan.
you're	[you are] kamu adalah.
you've	[you have] 1 kamu sudah. y. changed kamu sudah berubah. 2 kau mempunyai.
young	kb. anak. the y. orang/kaum muda. -ks. 1 muda. 2 masih baru, baru dimulai (of a firm).
youngish	ks. agak muda.
youngster	youngster
your	ks. (kepunyaan) mu, (milik) kamu, kepunyaan tuan/saudara.
yours	kb. keluarga. you and y. saudara dan keluarga saudara. -kg. kepunyaanmu, milikmu.
yourself	kg. lih self.
youth	kb. 1 masa muda. in my y. semasa muda saya, sewaktu masih muda. 2 kaum muda. y. center balai pemuda, gelanggang remaja.
youthful	ks. 1 kelihatan muda. y. appearance kelihatan muda. y. figure kelihatan muda tampangnya. 2 kanak-kanak.
yowl	kb. lolong, raung, gonggong/meong panjang. -kki. menolong, meraung, memekik, memeong panjang.
yr(s).	1[year(s)] tahun-tahun. 2 [your(s)] milikmu, kepunyaan kamu.
yuletide	kb. masa natal.
yum-yum	kseru. mm ! sedap !
yummy	ks. sl.: enak, lezat, sedap.
ywca, y.w.c.a.	[young women's christian association] ikatan pemuda masehi/kristen.
z	kb. huruf ke-26 dari abjad inggris.
zany	kb. orang yang amat lucu. -ks. sangat lucu, amat jenaka.
zeal	kb. kegiatan, semangat.
zealot	kb. 1 orang yang fanatik. 2 pengikut yang setia sekali.
zealous	ks. giat/bersemangat/tekun sekali. -zealously kk. dengan rajin/tekun.
zebra	kb. kuda zebra/belang/loreng.
zenith	kb. zenith, puncak.
zephyr	kb. angin sepoi-sepoi.
zeppelin	kb. (pesawat) zeppelin.
zero	kb. nol. a million is one plus six zeros sejuta adalah satu dan enam nol. -kkt. to z. in on membidik tepat ke arah (a target). mil.: z. hour saat yang menentukan. z. result hasil kosong samasekali.
zest	kb. 1 semangat (for life). 2 nafsu, rasa lezat (of food). 3 animo.
zestful	ks. penuh semangat, dengan gairah.
zigzag	ks. 1 berliku-liku (of a road). 2 berbiku-biku (of a line, edge). -kki. (zigzagged) berliku-liku, berkelok-kelok.
zinc	kb. seng, timah sari. z. ointment salep timahsari.
zing	kb. semangat. he does everything with z. ia mengerjakan apa saja dengan penuh semangat.
zip	kb. semangat. inf.: she has lots of z. semangatnya berlimpah-limpah. -kkt. (zipped) to z up menutup ritsleting (a dress). -kki. inf.: to z. though a test cepat-cepat menempuh ujian. z. code kode daerah pos.
zipper	kb. ritsleting, rits, kancing tarik. -kkt. menutup ritsleting, menutup tarikan (baju). -zippered ks. beritsleting.
zither	kb. semacam kecapi, sitar, cempelung.
zodiac	kb. mintaku i'buruj.
zombi(e)	kb. sl.: seorang yang bodoh-bebal.
zonal	ks. mengenai wilayah/lingkungan/daerah.
zone	kb. 1 daerah, mintakat. mailing z. daerah (hantaran) pos. 2 lingkungan, daerah. -kkt. menetapkan sebagai daerah.
zoning	kb. penetapan daerah/wilayah.
zoo	kb. kebun binatang
zookeeper	kb. penjaga/mandor kebun binatang.
zoological	ks. kehewanan, mengenai ilmu hewan. z. garden kebun binatang.
zoologist	kb. ahli ilmu hewan.
