positif	/positip/ positive.
poskar	postcard.
posma	[pekan orientasi dan studie mahasiswa] freshman orientation week.
pospaket	parcel-post package.
pospor	see fosfor.
postel	[pos dan telekomunikasi] postal, telegraph, and telephone service.
poster	poster.
postulat	postulate.
poswesel	money order.
pot	1 pot. 2 chamber pot.
potas	potassium.
potehi	(china) hand puppets.
potensi	potential.
potensial	/potensiil/ potential.
potia	(china) overseer.
potlot	pencil.
poto	see foto.
potokopi	see fotokopi.
potol	1 broke, hard up. 2 cut off.
potong	1 piece. 2 lump. 3 slice. 4 be reduced by. 5 take a short cut.
potongan	1 deduction from wages. 2 discount. 3 way s.t. is made or built, model, cut of clothes. 4 abbreviation. 5 a cut.
potret	1 photograph, picture, snapshot. 2 camera. 3 have o.'s picture taken.
power	1 k.o. four-wheel-drive army truck used in mountainous regions. 2 power of radio or stereo set.
poya	see foya.
poyang	grandfather.
pp	1 [pulang pergi] round trip. 2. [peraturan pemerintah] governmental regulations.
ppdank	[pendidikan, pengajaran dan kebudayaan] ministry of education and culture.
pplh	[pembinaan dan pelestarian lingkungan hidup] cultivation and preservation of the environment.
ppn	(pajak pendapatan nasional] national income tax.
ppn(b)	[pusat perkebunan negara (baru) ] (new) center for gvt. estates.
ppp	[partai persatuan pembangunan] united development party, a muslim party.
pppk	[pertolongan pertama pada kecelakaan] first aid.
pr	1. [penyapu ranjau] minesweeper. 2. [pekerjaan rumah] homework. 3. [pemuda rakyat] communist youth movement, the people's youth.
pr-	see also entries with per-.
pra-	see also entries with pre-.
praada	preexistence.
praanggapan	prejudice, presupposition.
prabakti	probationary.
prabawa	see perbawa.
prabedah	preoperative.
prabu	the sovereign.
pracerita	opening portion of a story.
pracipta	s.t. created beforehand.
prada	1. (prajurit dua] (mil.) private (lowest rank). 2. see perada 1.
pradewasa	preadult.
pradini	premature in birth, ripening, or flowering.
praduga	presumption.
prafabrik	prefabricated.
pragaan	see raga 1.
pragmatis	pragmatic.
pragmatisme	pragmatism.
prah	freight, cargo.
praha	prague.
prahara	hurricane, tempest.
prahoto	truck.
prailmiah	prescientific.
praja	territory of jurisdiction.
prajurit	1 solder. 2 a private. 3 soldierlike and brave.
praka	[prajurit kepala] (mil.) highest rank of private below kopral.
prakarsa	initiative.
prakarya	vocational subjects in school (home-making, sewing, automobile repairing, etc.).
prakata	foreword.
prakemerdekaan	pre-independence.
prakira	forecast.
prakondisi	prerequisite.
praktek	/praktik/ 1 practice of a profession. 2 practices.
praktikum	practical work, lab work.
praktis	1 practical. 2 practically.
prakualifikasi	/prakwalifikasi/ (fin.) qualifications stipulated for all prospective tenders of a bid.
pralambang	prediction, prophecy.
pralon	k.o. hard pipe.
prama	[pramahasiswa] o. who is about to enter university.
pramadara	newly registered university freshman (female).
pramana	(java) careful.
pramaria	newly registered university freshman.
pramasehi	pre-christian.
prambos	see frambos.
prameswari	see permaisuri.
prami	newly registered university student (female).
pramubakti	/pramubhakti/ (euphemism) maid servant.
pramugara	attemdant on long distance transport.
pramugari	female attendant on long distance transport.
pramuka	[(gerakan) praja muda karana] boy scouts.
pramukawati	girl scout.
pramuniaga	[euphemism] sales clerk.
pramuria	[euphemism] nightclub hostess.
pramuwisata	tourist guide.
pramuwisma	[euphemism] maid servant.
pranata	instituation, regulation.
prancis	france, french.
prangko	postage stamp.
prapatan	crossroads.
prapen	(java) furnace, fireplace, or any place for a fire.
prapendaftaran	preregistration.
praperadilan	pretrial.
prapertunjukan	preview.
prarasa	partiality, preference.
prarencana	plan in rough, preliminary form.
prasaja	straightforward, without guile.
prasangka	prejudice.
prasantap	food served before main course.
prasaran	working paper, introductory or working paper for.
prasarana	1 infrastructure. 2 labor done in preparation.
prasarjana	degree awarded after three years of tertiary level study.
prasasti	1 ancient inscription, epigraphy. 2 plaque commemorating inauguration of building.
prasejarah	prehistory, prehistorical.
prasekolah	preschool.
prasetia	/prasetya/ firm intent, pledge of loyalty, religious vow.
praskripsi	(acad.) b.a.thesis.
prasman	(coll.) frenchman.
prasmanan	buffet.
prasyarat	prerequisite.
prat-prit	sound of whistle blowing repeatedly.
pratanda	1 sign, indication. 2 forerunner.
pratekan	(ling.) prestressed.
pratijangkit	antiseptic.
pratiwi	see pertiwi.
pratu	[perajurit satu] private first class.
prausul	working paper.
prawacana	foreword, preface.
prawarsa	initiative, impetus.
prawira	see perwira.
prayoga	decent, suitable.
prayojana	purpose, intention, motive.
pre	see perai 1.
preambul	preamble.
predikat	1 citation, designation. 2 (ling.) predicate.
prefek	(rel.) prefect, the supervisor in a church organization.
prefektur	prefecture (in japan, france, etc.).
preferensi	preference.
preferensiil	preferential.
prehistori	prehistory.
prehistoris	prehistoric.
prei	1. see perai 1. 2. leek.
prek	(vulg.) nonsense ! shut up ! (exclamation to silence s.o.). mem-prek-i tell s.o. to shut up.
prekik	see prikik.
prelat	prelate.
preliminer	preliminary.
prem	plum.
preman	1 private, civilian. 2 (coll.) street kids, hoodlums.
prematur	premature.
premi	1 premium. 2 bonus.
premier	(thea.) premier.
premis	premise.
prenjak	k.o. bird.
preparat	(med.) blood smear.
prepentip	see preventif.
prerogatif	prerogative.
pres	1. pres-ban k.o. procedure for tire repaire in which a faulty inner tube is sealed by pressing rubber to it with a hot iron tool. 2. 1) prize. 2) toy given away as prize in package (of crackerjacks, etc.).
presdir	[presiden direktur] president and director of a company.
preseden	precedent.
presentasi	presentation.
presiden	president.
presidensial	/presidensiil/ presidential
presidium	presidium.
presis	see persis.
presisi	precision.
preskripsi	prescription.
prestasi	achievement, performance
prestise	prestige.
pretel	1 dismantle, tear apart. 2 remove, take out. 3 find out a secret, question thoroughly. 4 wipe out, clear away.
pretensi	pretension.
pretensius	pretentious.
preventif	/preventip/ preventive.
previu	preview.
prewangan	shaman, o. who has mystical powers.
pri	see pribumi.
pria	man, male.
priai	see priyayi.
pribadi	1 individual, personal. 2 person.
pribahasa	see peribahasa.
pribumi	indigene, o. of native stock and not of immigrant blood.
pribumisasi	the process of turning enterprises over to the indigenouse people.
pries	/pris/ frisian.
prigel	(java) skillful.
prihal	see peri 1.
prihatin	concerned, apprehensive.
prikik	(sport.) free kick after minor foul.
prilaku	see peri 1.
prilem	preliminary.
prima	first-rate.
primadona	(coll.) woman who is considered excellent.
primata	(bio.) primate.
primbon	(java) divining manual.
primer	primary.
primitif	primitive.
prin	/pring/ (mil.) answer to the call werda ( " who goes there ?"): friend (not foe).
pringas-pringis	grin sheepishly.
pringgitan	(java) open structure in front of mansion, behind the pendopo, for showing shadow plays or receiving visitors.
pringisan	grin.
prinsip	principle, tenet.
prinsipiil	/prinsipil/ principal, basic.
prioritas	/prioritet/ priority.
prisma	prism.
prit	sound of blown whistle.
privat	private.
prive	private.
privilese	privilege.
priwil	a bicycle gear that allows wheels to turn without engaging pedals.
priya	see pria.
priyayi	(java) o. belonging to upper classes.
pro	pro.
probabilitas	probability.
problem	/problim/ problem.
problematik	set of problems.
procot	(vulg.) be born.
prodeo	free, without cost.
produk	product.
produksi	production.
produktif	productive.
produktivitas	/produktivitet/ productivity.
produsen	producer.
produser	/produsir/ memp-produser produce.
profesi	profession. ber-profesi professional.
profesionalisme	professionalism.
profesor	professor.
professi	see profesi.
profil	1 appearance. 2 profile.
profisiat	expression. uttered when offering congratulations.
prognosa	/prognose/ prognosis.
program	/programa/ program.
progresif	progressive.
progresivitas	/progresivitet/ progressiveness.
prohibisionis	prohibitionist.
prokem	(jakarta) 1 jargon of youth in jakarta. 2 street kids.
proklamasi	proclamation.
proklamator	o. who proclaims.
proklamir	memp-proklamir-kan proclaim.
prokurasi	(leg.) power of attorney.
proletar	proletarian.
proletariat	proletariat.
proletarisasi	proletarianization.
proliferasi	proliferation.
prolog	prologue.
promes	(fin.) promissory note.
promosi	1 promotion of a product. 2 (acad.) disertation defense.
promosional	promotional.
promotor	(acad.) dissertation supervisor. 2 o. who champions s.t.
promovendus	(acad.) a candidate for a doctorate.
prop	1. cork, stopper, plug. 2. [propadeus] preparation for entering a university course or profession.
prop.	[propinsi] province.
propadeus	/propaedeuse/ preparation for entering (a course, a profession).
propaganda	propaganda.
propagandis	propagandist.
propeler	(av.) propeller.
properti	property (in tv, film making).
propesi	see profesi.
propesor	see profesor.
propil	see profil.
propinsi	see provinsi.
propokatip	see provokatif.
proporsi	proportion.
proporsional	/proporsionil/ reasonable, in accordance with o. would expect.
prosa	prose.
prosedur	procedure.
proseduril	procedural.
prosen	see persen.
prosentase	/prosentasi/ percentage.
prosentuil	on a persentage basis.
proses	1 process. 2 legal action.
prosesi	procession.
prosis	1 prose writer. 2 prosaic.
prosodi	prosody.
prospek	prospect, future chances.
prospektus	promotional leaflet.
prostat	/prostata/ (anat.) prostate.
prostitusi	prostitution.
proteina	protein.
proteksi	economic protection.
proteksionis	protectionist.
protektorat	protectorate.
protes	protest.
protestan	protestant.
protokol	1. protocol. 2. master of ceremonies at formal functions.
protokoler	having to do with protocol.
protol	(java) apart, in pieces.
proton	(phys.) proton.
provinsi	province.
provinsial	provincial.
provinsialisme	provincialism.
provinsialistis	provincial.
provisi	(fin.) commission.
provokasi	provocation.
provokatif	/provokatip/ provocative.
provokator	provocateur.
provost	military police in air force or navy.
proyek	project.
proyeksi	projection, forecast.
proyektil	missile.
proyektir	project s.t. or an image.
proyektor	projector.
prri/permesta	[pemerintah revolusioner republik indonesia/perjuangan semesta] total struggle and the republic of indonesia's revolutionary gvt., a rebellion in sumatra and n. sulawesi against the central gvt. in the late 1950s.
pruf	/prup/ printer's proof.
prusi	verdigris.
ps.	1. [pasal] article (in legal documents, etc.] 2. [pasar] market. 3. [pejabat sementara] temporary official.
psi	[partai sosialis indonesia] indonesian socialist party.
psi.	[psikologi] psychology.
psii	[partai serikat islam indonesia] islam party of indonesia.
psikiater	psychiatrist.
psikiatri	psychiatry.
psikiatrik	/psikiatris/ psychiatric.
psikis	psychological, mental.
psikoanalis	psychoanalyst.
psikoanalisa	psychoanalysis.
psikolinguistik	psycholinguistics.
psikolog	psychologist.
psikologi	psychology.
psikopat	psychopath.
psk.	[pasukan] (mil.) troops.
pspb	[pendidikan sejarah perjuangan bangsa] the history of the national struggle, a subject in school.
pt	1. [perseroan terbatas] inc., ltd. 2. [panglima tertinggi] officer the rank of governor of a region. 3. [perguruan tinggi] institute of higher education.
pt.	[pendeta] rev., title for a minister.
ptik	[program tinggi ilmu kepolisian] police academy.
ptip	[(departemen) perguruan tinggi dan ilmu pengetahuan] department of higher education and sciences.
ptm	[persekutuan tanah melayu] federation of malaya.
ptp	[pos, telekomunikasi (dan) pariwisata] post office, telecommunications, and tourism.
ptt	[pos, telegrap dan telpon] postal, telegraph, and telephone service.
pu	1. [pejabat ulama] high official. 2. [pembantu utama] secretary-general of a ministry. 3.[pekerjaan umum] public works.
puade	see kuade.
puah	bah ! phooey !
puak	group, tribe.
puaka	gnome, spirit (inhabiting a certain place).
pual	1. voile. 2. vortex.
pualam	1 marble. 2 alabaster.
puan	1. plate for betel. 2. (lit.) title or deferential term of address for a woman. 3. see kelapa.
puar	cardamom.
puas	satisfied, contented.
puasa	1 fast. 2 (islam) fasting month.
puatang	(china) have no chance.
puber	/pubertas/ puberty.
publik	public.
publikasi	publication.
publisir	publicize.
publisistik	mass communications (as a field of study).
publisitas	publicity.
pucat	pale due to illness or fright.
pucuk	1 tip of a leaf, shoot, sprout. 2 tip of s.t. 3 a classifier.
pucung	1. heron. 2. tree that produces keluak.
pudak	k.o. pandanus.
pudar	1 pale, faded. 2 weak, dim.
pudat	full to the brim.
pudek	[pembantu dekan] assistant dean.
pudel	poodle.
puder	(face) powder.
pudi	powder, dust of precious stones.
puding	1. croton plant. 2. see podeng.
pudur	extinguished.
pugar	mem-pugar restore.
puguh	(jakarta) for sure, certain.
puhun	see pohon 2.
puing	1. ruins, debris. 2. see puyeng.
puisi	poetry.
puitik	/puitis/ poetic.
puja	worship, adoration.
pujaan	1 adoration, worship. 2 idol.
pujangga	1 man of letters. 2 poet.
puji	praise. mem-(p)uji praise, commend.puja-puja-an prayers of adoration.
pujuk	see bujuk.
pujur	profligate, dissolute.
pujut	strangulation.
puk-oping	/puk ping/ menthol inhaler for colds.
pukal	lump, block.
pukang	1 crotch. 2 thigh of animal. mem-pukang tear apart.
pukas	see pukes.
pukat	seine, dragnet. pukat-harimau large trawling.
pukau	drug to make o. sleep.
pukauan	charm.
pukes	vulva.
puki	(vulg.) vagina.
pukis	k.o. butter cake.
pukta	excellent.
pukul	1 strike. 2 blow, o. fell swoop. 3 o'clock.
pul	1. (car)pool. 2. pole.
pula	1 likewise, as well. 2 again. 3 (who, where, how, etc.) alse ? 4 (who, where, why, how, etc.) do you think, (what, etc.) in the world. 5 do unnecessarily.
pulai	k.o. tree whose bark is medicinal and with corklike wood.
pulak	see pula.
pulan	1 good-tasting (of cooked rice or tubers cooked to proper softness). 2 smooth and mellow.
pulang	1 return home. 2 be left up to.
pulas	1. fast asleep. 2. a dab. 3. 1) turn, wring. 2) twist, distort. 3) have coloc.
pulasan	1. 1) outward appearance. 2) s.t smeared on. 2. k.o. rambutan whit short nubbles as if the hair had been tweaked off.
pulasari	liana with yellow flowers.
pulau	island.
pulauisme	insularity.
pule	see pulai.
pulen	see pulan.
pules	see pulas 1.
puli	1. o. of the parts of the automobile chassis. 2. rice cracker.
pulih	1 recovered from an illness. 2 restored, repaired.
pulisi	see polisi.
pulkanisir	see vulkanisir.
pulpen	fountain pen.
pulsa	beat, throb, pulse.
puluh	counter for a multiple of 10. puluh-an 1 tens, decades. 2 10-rupiah note.
pulun	1 rise (of smoke). 2 rise like smoke (of thoughts).
pulung	1. pellet. 2. (java) flash of light which gives o. power enabling him to be legitimized as ruler.
pulungan	s.t. rolled into pellets.
pulur	see empulur.
pulut	1 glutinous rice. 2 birdlime.
pumigasi	see fumigasi.
pumpun	flock together.
pumpunan	1 meeting place, 2 center.
pun	1 (lit.) then, subsequently. 2 also. 3 even. 4 who, where, what, etc. ever it might be, everywhere, everyone, everything, etc.
punah	extinct.
punai	pigeon.
punakawan	(java) servants of royalty in wayang.
punat	(med.) core of a boil.
punca	1 flap, tail, end. 2 beginning, introduction, elementary. 3 initial cause.
puncak	1 top, summit. 2 peak, mount. 3 acme, zenith.
pundak	1 shoulder. 2 neck.
punden	(java) holy place (graves of ancestors, sacred trees, etc.).
pundi	1 earthen jar to hold water. 2 crockery piggy-bank. pundi-pundi purse, bag.
punding	knot.
pungak-pinguk	be or look embarrassed.
punggah	load, cargo.
punggahan	place for loading cargo.
punggal	mem-punggal break off the point of s.t.
punggawa	court official in java shadow play.
pungguk	k.o. owl.
punggung	back.
punggur	tree trunk.
pungkah	piece, lump.
pungkasan	final, end.
pungki	see pengki.
pungkir	see mungkir.
pungkur	1 rear end, posterior. 2 residue.
pungli	[pungutan liar] toll or tariff collected without proper legal authority.
pungliwan	o. who extracts illegal tolls.
pungsi	see fungsi.
pungut	adopted.
pungutan	1 pickings, harvest. 2 quotation. 3 tax levied. 4 amount collected, collection (in church).
punjul	(java) a bit over in amount.
punjung	trellis, bower.
punjut	tie together.
punktuasi	/pungtuasi/ punctuation.
punokawan	see punakawan.
punsu	[china] able, talented.
punt	/pent/ 1 that is the end of it, period. 2 period, point.
puntal	1 winding round. 2 in balls.
puntalan	1 bobbin spool. 2 ball of wool.
punten	(sunda) excuse me.
punti	see buah.
puntianak	k.o. vampire or blood-sucking supernatural being.
puntil-susu	nipple.
puntir	mem-puntir wind, twist firmly.
puntiran	1 torsion. 2 s.t. twisted.
puntng-panting	see pontang-panting.
puntul	dull, blunt.
puntung	1 blunt. 2 butt, stub, stump. 3 maimed. crippled, mutilated.
punuk	see ponok.
punya	1 (coll.) have, possess. 2 belonging. 3 (coll. ) a possessive marker. 4 after, with.
pupu	degree of consanguinity.
pupuh	1. ber-pupuh fight. mem-pupuh beat. 2. strophe.
pupuk	1. manure, fertilizer. 2.(java) put traditional medicines on a wound.
pupun	collect (e.g. rubber).
pupunan	gathering of rubber.
pupur	face powder.
pupus	1. budding leaf, leaf that has just come out. 2. 1) wiped out, obliterated. 2) disappeared.
puput	whistle, flute, blow.
puputan	1) pair of bellows. 2) blowing of the wind.
pur-	complete, post-(in formal words or titles).
pura	1. 1) bag. 2) fund. 2. balinese temple, shrine.
pura-pura	1 pretend. 2 pseudo, mock.
purata	(math.) mean.
purba	old, ancient, antique.
purbakala	olden times.
purbakalawan	archaeologist.
purbasangka	prejudice.
pure	puree.
purek	[pembantu rektor] assistant to the rector.
purel	[public relations] public relations.
puri	1 castle, royal palace. 2 town. 3 balinese house of worship.
purifikasi	purification.
purik	go home for sympathy out of anger.
puring	see puding 1.
purn.	[purnawirawan, purnakaryawan] retired, emeritus.
purnakaryawan	retired civil servant.
purnakata	what is said in conclusion.
purnama	full moon.
purnaswasta	o. retired in private sector.
purnawirawan	retired armed services officer.
puru	sore, boil, ulcer.
puruk	hide s.t. inside.
purun	k.o. rush used for basket weaving.
purus	diarrhea.
purut	rough-skinned. jeruk-purut k.o. nubbled lime used as condiment.
purwa	see wayang.
purwaka	in the beginning, formerly.
purwakanti	(ling.) assonance, alliteration.
purwoceng	k.o. aphrodisiac.
pusa	1 momentum. 2 desire to do s.t.
pusaka	heirloom.
pusar	navel.
pusara	1. 1) cemetery. 2) grave. 2. reins.
pusaran	1 rotation. 2 handle, crank. 3 vortex.
pusat	1 navel. 2 center. 3 center, central, main.
puser	(java) navel.
pusing	1 whirling, dizzy. 2 be puzzled, confused, worried. pusing-an rotation.
puskesmas	[pusat kesehatan masyarakat] local gvt. clinic.
puso	parched, dried up.
puspa	(lit.) flower.
puspen	[pusat penerangan] information center.
puspita	(lit.) flower.
pustaka	1 book. 2 divining manual.
pustakawan	librarian.
pusu	1. (m) troop, band. 2. anthill.
pusung	dreamer, dullard.
pusut	awl.
putao	(china) rice wine.
putar	turning.
putaran	1 circle. 2 crank, windlass. 3 wheel. 4 showing.
puter	1. k.o. dove. 2. (java) see putar.
putera	1 prince. 2 son, child (of o. who is respected). 3 a son of (o. from) a certain place. 4. male.
puteri	1 princess. 2 daughter, girl (of o. who is respected). 3 female.
putih	1 white. 2 pale, fair skinned. 3 pure.
putik	(biol.) 1 bud, pistil. 2 ovary. ber-putik beginning to bear fruit.
puting	1 handle, hilt. 2 stalk.
puting-beliung	whirlwind, waterspout.
putra	see putera.
putri	see puteri.
putu	steamed cake. putu-mayang k.o. cake made of rice noodles fashioned into a wreath.
putus	1 broken off, served. 2 break. 3 finish. 4 break a promise. 5 sever s.t.
puyan	body dirt.
puyang	see lempuyang.
puyeng	1 headache. 2 confused, dizzy.
puyuh	1. quail. 2. see angin.
puyunghai	see fuyonghai.
pwi	[persatuan wartawan indonesia] journalists' association of indonesia.
pym	[paduka yang mulia] your excellency.
pyuh-pyuh	expression of surprise.
q	the 17 th letter of the alphabet.
q-	almost all words with q may also be written with k. for entries with q- see k-.
qabil	(islam) cain, abel's brother.
qari	(islam) receiter of the koran.
qariah	(islam) female reciter of the koran.
qur'an	see koran.
r	the 18 letter of the alphabet.
r.	[raden] (java) masculine noble title.
r.m.	[raden mas] (java) title of minor male nobility.
ra'yat	see rakyat.
ra.	[radiallahu an(hu) ] (islam) an exclamation uttered after mention of o. of muh.'s companions or the prophets: may god bless him !
raad	see rad.
rab	[rencana anggaran belanja] 1 budget plan. 2 draft budge.
raba	1 feel s.t. 2 grope (often with sexual implications). 3 guess.
rabaan	1 touch. 2 groping with the hand. 3 guess, estimate.
rabah	shrike.
rabak	1 large tear, rip. 2 in tatters
raban	1 jabber, babble. 2 rave, be delirious.
rabas	(m) drizzle.
rabat	rebate, quantity discount.
rabbi	(bib.) lord.
rabi'ul-akhir	(islam) 4th month of arabic calendar.
rabi'ul-awal	(islam) 3d month of arabic calendar.
rabies	rabies.
rabik	/rabit/ torn, tattered at the edges.
rabu	1.(m) lungs. 2. size, carry off (loot, etc.). 3. wednesday.
rabuk	1 fertilizer. 2 tinderwood.
rabun	1) hazy, dim. 2) near sighted .
rabung	ridge of a house.
rabut	see cabut.
racau	delirious.
racek	(jakarta) pockmarked.
racik	1. bird snare. 2. 1) cut into thin slices. 2) blend various proper ingredients into food, etc. 3) eat foods already mixed (rice with vegetables, etc.). 4) make the necessary preparations prior to a main endeavor.
racuk	tease, entice s.o.
racun	poison.
rad	council.
rada	(java, jakarta) rather, somewhat.
radak	1 a stab with a spear. 2 an attact.
radang	1 inflamed, hot. 2 fly into a rage.
raden	1 title of java nobility. 2 form of address, esp. as den.
rader	rolling pin.
rades	radish.
radiallahu-anhu	(islam) may god bless him, exclamation uttered after the mention of o. of muh.'s companions or the prophets.
radiasi	radiation.
radiator	radiator.
radikal	(pol.) radical. radicalism.
radikalisasi	radicalization.
radikalisir	radicalize.
radikalisme	radicalism.
radin	see raden.
radio	radio.
radioaktif	radioactive.
radioaktifitas	radioactivity.
radiogram	radiogram.
radiologi	radiology.
radiowan	radioman.
radius	circle, radius.
radmolen	ferris wheel.
rafia	1 raffia fibre. 2 k.o. twine made of thin strips of plastic similar to raffia fibre.
raflesia	k.o. endotropic parasitic plant, the rafflesia.
raga	1. 1) (lit.) boast, show off. 2) hold an exhibition. 2. 1) k.o. simple rattan basket. 2) ball plaited from rattan. 3. (lit.) body.
ragam	1 melody, tune. 2 manner, kind. 3 caprice, whim. 4 (ling.) register, style.
ragangan	1 scaffolding, laths. 2 kite frame. 3 handlebars.
ragas	1 pull out (hir, grass, etc.). 2 cut, tear.
ragawi	physical.
ragbol	1 dust mop, esp. for ceilings. 2 moplike tool for cleaning toiled bowl.
ragi	1. yeast, fermentation agent. 2. design, formulation.
ragib	absorbed in an activity.
ragil	(java) youngest (child).
ragu	hesitant. ragu-ragu 1 be wary, uncertain. 2 hesitate to do s.t.
ragum	(lit.) vise, clamp.
raguman	joint (membership, etc.).
ragut	see renggut.
rahab	see rahap1.
rahang	jaw. rahang-atas upper jaw. rahang-bawah lower jaw.
rahap	1. shroud. 2. 1) alight. 2)kneel down next to. 3) throw o.s. face down.
raharja	(java) well-being prosperty.
rahasia	secret.
rahat	see istirahat.
rahayat	see rakyat.
rahayu	1 well-being. 2 greeting, esp. used by adherents of java folk religion.
rahib	1 monk. 2 nun.
rahim	1. womb, uterus. 2. (islam) merciful (of god).
rahimi	(islam) merciful (of god).
rahman	/rahmani/ (islam) compassionate (of god).
rahmat	(islam) god's mercy.
rahmatullah	(islam) mercy of god.
rahsia	see rahasia.
rahu	k.o. monster that causes lunar eclipses by swallowing moon.
rahuh	sigh of relief.
rai-gedek	(java) shameless.
raib	see gaib.
raih	1 reach for. 2 sweep up, take in toward o.s. 3 achieve, manage to obtain.
rais	1. sweep off. 2. president or chairman, formerly used by the islam party.
rait	screeching sound.
raja	1 king. 2 tycoon. 3 o. who excels at s.t. 4 (che.) king.
rajab	(islam) 7th month of arabic calendar.
rajabrana	(java) treasure, riches.
rajah	1. 1) (lit.) figure or design with mystical properties. 2) tattoo. 3 lines in the palm. 2. see raja.
rajakula	dynasty.
rajalela	violent and arbitrary.
rajalele	prized variety of rice.
rajam	me-rajam stone to death.
rajaman	stoning.
rajang	cut into small pieces, mince (vegetables, etc.). rajang-an cut tobacco.
rajawali	k.o. large black hawk.
rajet	(coll.) broken into small pieces.
rajin	1 industrious, diligent. 2 frequently.
rajuk	pout, sulk.
rajungan	k.o. small crab.
rajut	net.
rak	1. cracking sound. 2 shelf, rack.
raka	1 (lit.) elder brother. 2 senior male university student.
rakaat	(islam) essential unit of prayer ritual, consisting of bows and prostrations performed a prescribed number of times.
rakam	1 stamping, printing. 2 embroidering.
rakaman	1 notes, recorded materials. 2 recording (of music, etc.).
rakan	see rekan.
rakanita	senior female university student.
rakat	see rekat.
rakawati	see rakanita.
raker	[rapat kerja] meeting at which work is accomplished.
rakerda	[rapat kerja daerah] regional working meeting.
rakernas	[rapat kerja nasional] national working meeting.
raket	1. (sport) racket. 2. see roket.
rakhman	/rakhmani/ see rahman, rahmani.
rakhmat	see rahmat.
rakit	raft.
rakna	see ratna.
raksa	see air.
raksamala	see rasamala.
raksasa	1 mythical gigantic demon. 2 giant.
raksasi	see raseksi.
raksi	1. perfume. 2 see rasi 1.
rakuk	nick, notch, indentation.
rakus	greedy, voracious.
rakut	1 spin a web, lay a snare. 2 deceive.
rakyat	populace, citizenry.
ralat	error, mistake, esp. typographical.
ralip	me-ralip doze off. pe-ralip o. who is always sleepy.
raliwan	(sport) participant in sports rally.
rally	/reli/ (sport) rally.
ram	[republik arab mesir] egyptian arab republic.
rama	see romo.
rama-rama	butterfly, us. large.
ramadan	/ramadhan, ramadlan/ (islam) 9th month of the arabic calendar, fasting month.
ramah	friendly, easy to talk with. ramah-tamah hospitable and friendly.
ramai	1 crowded, busy. 2 bustling, lively, festive. 3 noisy, loud. 4 interesting.
ramal	tell fortunes.1 predict. 2 portend.
ramalan	1 prognosis, prediction.oracle, fortune-teller.
ramanda	(java, repsectful) 1 father (respectful). 2 uncle.
ramas	1. 1) press, knead. 2.) see rames.
ramayana	great hindu epic from which many themes of indonesian literature and public life are drawn.
rambah	clear away, cut down.
rambai	1. k.o. tree bearing edible but undomesticated fruit. 2. 1) fringe. 2) tuft of hair.
rambak	edible portion of beef or pork skin, often fried as chips or used in sauces.
ramban	(jakarta) collect grass or leaves for food.
rambang	1. broad, wide, extensive. 2.see rembang.
rambas	me-rambas crush s.t.
rambat	spreading, creeping.
rambatan	propagation.
rambate-rata-hayo	(java) heave-ho, phrase uttered in unison by group carrying s.t. heavy.
rambia	see rumbia.
rambo	/rembo/ the movie character rambo.
rambu	1. fringe, tassel. 2. (naut.) short pillar on quay for tying up ships, buoy. rambu-lalulintas traffic sign.
rambun	tangled undergrowth.
rambut	1 hair of the head. 2 (coll.) body hair. 3 mane. 4 (coll.) thread. 5 (coll.) filament.
rambutan	k.o. nephelium tree bearing fruit similar to lychee, the rambutan. rambutan-rapiah highly priced k.o. rambutan of jakarta.
rame	see ramai.
ramelan	see ramadan.
rames	1 mix by kneading. 2 provide with a misture.
rami	hemp, jute.
ramin	basket making.
rampai	various.
rampai-rampai	mixed, jumble.
rampak	1. thick, dense (of foliage, crowd). 2. completely dressed up. 3. see rempak.
rampas	seize, carry away.
rampasan	loot.
rampat	swing, brandish.
ramping	1. slender, slightly built. 2. side by side, next to. 3. 1) disfigured, multilated. 2) pierced (of ears).
rampok	rob, plunder .
rampung	(java) finished, settled, completed.
rampus	indecent (of language).
ramsum	see rangsum.
ramu	gather, collect.
ramuan	ingredients, concoction.
ramus	superfluous hair.
rana	1. long-suffering. 2. see ratna.
ranah	1 meadow, low-lying valley. 2 domain.
ranai	rizzle, trickle.
ranap	still, quiet.
rancah	scaffolding.
rancak	1. (m) handsome, beautiful. 2. a set.
rancakan	stand for a set of small gongs.
rancang	stake, post.
rancangan	plan, program.
rancap	1. pointed. 2 masturbation.
rancu	confused.
rancung	pointed, acute.
randa	widow, widower (in some areas of indonesia).
randai	1. traditional minangkabau theather. 2. traverse on foot.
randang	see rendang.
randau	1 eat food that has been mixed together or seasoned. 2 make food tasty by mixing several things together.
randek	(jakarta) stop.
randu	silk-cotton tree.
randung	violet, step on, infringe.
rang	1. rank, position. 2. clanging sound. 3. design, plan. 4. see orang 2.
rang-rangan	rough draft, outline.
rangah	boast.
rangak	(m) noisy.
rangam	tomato.
rangas	(jakarta) termite.
rangda	see randa.
rangga	sharp point.
ranggah	1. sharp point. 2 cock's comb. 3.strip s.t of all its fruit.
ranggak	(naut.) tow (in embarkation).
ranggas	1 withered, arid. 2 leafless.
ranggeh	me-ranggeh reach for s.t.
ranggi	attractive.
ranggul	me-ranggul tilt up.
ranggung	with legs apart.
rangin	long sash (for dancing).
rangka	1 framework. 2 draft, blueprint.
rangkah	see rangkak.
rangkai	bunch (of certain fruits).
rangkaian	1 series. 2 combination. 3 connecting structure (i.e. chain, etc).
rangkak	1 crawl on hands and kness. 2 make slow progress. 3 fawn.
rangkam	grasp s.t in the hands.
rangkang	(islam) religious training center for advanced islam studies.
rangkap	1. 1) double. 2) (ling.) phonetic cluster. 2. trap, pitfall.
rangkas	see ranggas.
rangkaya	/rangkayo/ (m) lady of the house.
rangket	(sunda) me-rangket thrash, beat up.
rangkiang	rice granary.
rangking	hood, canopy made of basketry.
rangkok	k.o. bird, k.o. hornbill.
rangkuh	see rengkuh.
rangkul	in o. embrace.
rangkum	an armful.
rangkuman	1 embrance. 2 armful. 3 summary.
rangkung	squat down, crouch.
rangkungan	see kerongkongan.
rangkup	1 hollow, cavity. 2 curve.
rangrang	see semut.
rangsang	1 exciting, stimulating. 2 pungent.
rangsek	(jakarta) attack.
rangsel	see ransel.
rangsuk	see rasuk 2.
rangsum	rations.
rangun	observation post, tower.
rangup	1 fragile. 2 crisp (i. e. cracker, chip, etc.).
rani	1. queen. 2 rich.
ranjah	loot, pillage.
ranjam	(java) see rajam.
ranjang	iron bed. ranjang-bayi baby's crib. ranjang-pengantin nuptial bed.
ranjau	(mil.) 1 bamboo spiked booby traps (set around village to wound enemy). 2 antipersonnel weapon, mine.
ranjing	1 possessed (by bad spirit, etc.), mania. 2 have a mania for s.t.
ranju	see ranjau.
ranjul	broken up, bumpy.
ranjungan	see rajungan.
ranking	/rengking/ grade rangking (in schools).
rankus	collect, gather s.t.
ransel	1 knapsack, backpack. 2 duffle bag.
ransum	see rangsum.
rantai	1 chain. 2 necklace. 3 series, sequence. 4 a measure of distance, esp. in rice fields.
rantam	do s.t. collectively.
rantang	set of stacked containers for transporting food.
rantas	1 broken off. 2 frayed.
rantau	1 (geog.) shoreline. 2 (geog.) reaches (of a river). 3 abroad, foreign country.
rante	see rantai.
ranting	1. 1) small branch, twig. 2) subsection, branch (of offices, parties, etc.). 2. dried up.
ranum	overripe. ripen.
ranyah	(m) be difficult, agitated (of infants).
ranyang	(m) 1 lively. 2 capricious.
ranyuk	grumble.
raon	see rawon.
rap	rapping sound, knocking.
rapah	walk, step on s.t.
rapak-lumuh	(islam) right of woman to appeal to judge if husband refuses to divorce her.
rapal	1 utter a prayer or incantation over s.o. 2 (sunda) bless and solemnize a wedding.
rapat	1 close, proximate, dense. 2 close, intimate, familiar. 3 meeting, assembly.
rapbd	[rencana anggaran pendapatan dan belanja daerah] regional budget.
rapbn	[rencana anggaran pendapatan dan belanja negara] national budget.
rapel	back pay.
rapi	orderly, neat.
rapiah	see rambutan.
rapih	see rapi.
rapim	[rapat pimpinan] meeting of the armed forces commanders.
rapkol	k.o. cabbage.
rapor	/raport, rapot/ school report card.
rapsodi	rhapsody.
rapuh	brittle, likely to snap.
rapun	(m) broken, destroyed.
rapung	see apung.
rarak	see rerak.
ras	1 sound of rustling (of papers, leaves, etc.). 2 reins. 3 race. 4 throroughbred.
rasa	1 taste, sensation. 2 feeling, sense. 3 be of a certain opinion.
rasai	suffer much.
rasain	(coll., jakarta) serves you right !.
rasaksa	see raksasa.
rasam	see resam 2.
rasamala	k.o. tree with fragrant wood.
rasan	(java) backbite, gossip about.
rase	civet cat.
raseksa	see raksasa.
raseksi	female giant.
rasi	1. 1) constellation. 2) lucky. 2. harmonious, matching, compatible.
rasia	1. see razia. 2. see rahasia.
rasial	racial.
rasialis	racialist.
rasialisme	racialism.
rasian	rasian
rasio	1 reason. 2 (match.) ratio.
rasional	/rasionil/ rational.
rasionalisasi	1 rationalization. 2 reduction in the number of workers in a firm.
rasisme	racism.
rasmi	see resmi.
rasuah	bribery, corruption.
rasuk	1. crossbar, cross beam. 2. possession by a spirit.
rasul	1 messenger sent by god. 2 (islam) prophet. 3 (rel.) apostle.
rasuli	(rel. islam) apostolic.
rasulullah	(islam) the messenger of god.
raswah	see rasuah.
rat	1. see erat. 2 see rad.
rata	1 flat, level. 2 even. 3 average.
ratah	simple, plain.
ratap	lamentation.
ratas	see retas.
ratib	(islam., lit.) repeated, chanted recitation of prayer.
ratib-sadati	k.o. traditional dance in aceh.
ratifikasi	ratification.
ratifisir	ratify.
ratio	see rasio.
ratna	gem, jewel.
ratu	1 (lit.) king. 2 queen.
ratus	1. hundred. 2. (java) k.o. perfumed powder used as incense.
ratusan	1) hundreds 2) a currency note or coin with the value of 100.
rau	see derau.
raum	see raung.
raun-raun	(sl.) go on a pleasure trip, stroll about, tour.
raung	sound of a siren, a siren.
raup	scoop up s.t. with the hands.
raupan	handful.
raut	shape, form.
rawa	/rawa-rawa/ swamp, marsh.
rawah	1. see rawa. 2. (m) basin.
rawai	fishing line (with several hooks).
rawak	(lit.) haphazard.
rawan	1. 1) (lit.) emotional, sensitive. 2) troubled, disturbed. 2. (lit.) classifier for articles of twine.
rawang	see rawa.
rawat	1 take care of, nurse. 2 (lit.) resume o.'s original form.
rawatan	1 treatment. 2 nursing, care.
rawe	k.o. liana causing itching.
rawe-rawe	/rawe-rawe rantas malang-malang putung/ (java) strive onward, no matter what (revolutionary slogan).
rawi	narrator, writer of story.
rawit	1. fine, small. 2. (java) music, song.
rawitan	overture (esp. gamelan music).
rawon	(java) k.o. beef stew made with keluak.
rawuh	(java) come (said of respected person).
rawun	overripe.
ray.	see ra 2.
raya	(lit.) great, large.
rayagung	(java) the 6th month of the arabic calendar.
rayah	plunder, raid.
rayan	be delirious, dream of s.t. preoccupying.
rayan-rayan	delirious.
rayang	dizzy.
rayap	termite.
rayau	1 fumble, grope. 2 rustle. 3 wander around. 4 be troubled.
rayon	area, district.
rayonisasi	process of dividing into administrative districts.
rayu	sad, touched, emotional.
rayuan	1 persuasion. 2 flattery, wooing.
razia	/rasia/ 1 raid by police (in red-light district, etc.). 2 unannounced examination of licenses, documents, etc. by police (in speed trap, during house-to-house search, etc.).
rdj	[republik demokrasi jerman] democratic republic of germany.
rdrk	[republik demokrasi rakyat korea] democratic people's republic of korea.
rdv	[republik demokrasi vietman] democratic republic of vietnam.
reagens	(chem.) reagent.
reak	see riak 2.
reaksi	reaction.
reaksioner	reactionary.
reaktor	(phys.) reactor..
real	see rial.
realis	realist.
realisasi	realization.
realisir	bring s.t. about.
realisme	realism.
realistis	realistic.
realitas	reality.
realokasi	reallocation.
reat-reot	sound of squeaking.
rebab	two-stringed musical instrument.
rebah	fall down, collapse.
rebak	1.be full of tears. 2. /re`bak/ deep cut, wound. 3. spread (of news, disease).
reban	chicken coop. /re`ban/ see reben.
rebana	tambourine.
rebas	see rabas.
rebat	enclose, fence in.
rebeh	hang down loosely.
rebek	1 (jakarta) dirty, not washed. 2 ugly. 3 disorderly.
