tempter	kb. penggoda.
temptress	kb. penggoda wanita.
ten	kb. sepuluh. by tens berpuluh-puluh. for tens years untuk puluhan tahun. t. spot uang kertas sepuluh dolar.
tenable	ks. yang dapat dipertahankan (view, position).
tenacious	ks. yang mengotot, kuat bertahan, ulai, tahan.
tenacity	kb. ketahanan, kegigihan, keuletan.
tenancy	kb. (j. -ties) 1 sewa-menyewa., persewaan. 2 jangka persewaan.
tenant	kb. penyewa. t. farmer petani penyewa.
tend	kkt. merawat, memelihara (a form). -kki. cenderung. she tends to talk too loud ia cenderung untuk berbicara terlalu keras.
tendency	kb. (j. -cies) kecenderungan, kecondongan, he has a t. to stutter ia cenderung untuk menggagap.
tendentious	ks. 1 rewel, suka melawan. 2 berpihak. t. report laporan yang berpihak.
tender	kb. 1 penawaran. 2 tawaran. 3 rr.: gerobak arang lok. -ks. 1 empuk (of food). t. meat daging lunak/empuk. 2 lembut, lunak (of skin). 3 perih, sakit (of a wound, cut). 4 sabar/tidak lekas marah (parents). 5 halus. -kkt. mengajukan (o's resignation).
tender-hearted	ks. mesra, ramah, simpatik. -tenderly kk. dengan lemah lembut, dengan halus.
tenderfoot	kb. orang yang masih hijau.
tenderize	kkt. membuat/bikin empuk (steak).
tenderizer	kb. zat/bahan pelunak.
tenderloin	kb. daging pinggang yang lunak.
tenderness	kb. kelembutan (hati), kehalusan budi. 2 keempukan (of food).
tendon	kb. urat daging. t. of achilles urat daging tumit.
tendril	kb. sulur, carang.
tenement	kb. rumah petak (yamg jembel).
tenet	kb. 1 ajaran, prinsip. 2 pendirian, pendapat.
tenfold	ks., kk. lipat sepuluh, sepuluh kali lipat.
tennis	kb. tenis. t. ball bola tenis. t. court lapangan tenis. t. mutch pertandingan tenis. t. racket raket tenis.
tenor	kb. 1 tujuan, maksu, arah (of a remark). 2 suasana umum (of affairs, of life). 3 penyanyi tenor. t. voice suara tenor.
tenpins	kb., j. sejenis permaoinan pancang, menggunakan sepuluh botol-botol kayu.
tense	kb.: masa. present t. of a verb katakerja masa kini. -ks. 1 tegang, regang ( person, moment). 2 keras (of voice).
tensenees	kb. ketegangan, kerenggangan of the situation). his t. was apparent ketegangannya tampak benar. t. in the voice kekerasan dalam suara.
tensile	ks. yang dapat direnggangkan, yang berkaitan dengan ketegangan. t. strength daya rentang.
tent	kb. tenda, kemah.
tentacle	kb. 1 alat penangkap. 2 alat peraba/perasa.
tentative	ks. (bersifat) sementara. t. arrangement suatu aturan percobaan. -tentatively kk. sementara.
tenterhook	kb. kait pada bingkai peregang. to be on tenterhooks merasa tegang dan gelisah.
tenth	kb., ks. 1 (ke) sepuluh. your letter of the t. suratmu tertanggal sepuluh. 2 persepuluh. a t. of a dollar sepersepuluh dari sedolar.
tention	kb. 1 ketegangan. the t. rose ketegangan meningkat. under great t. dalam keadaan sangat tegang. nervous t. ketegangan syaraf. 2 tegangan (on a cable or rope).
tenuous	ks. lemah, renggang (relationship, influence).
tenure	kb. 1 masa jabatan (of office). 2 kedudukan tetap (as professor).
tepid	ks. suam-suam/hangat-hangat kuku (of liquid).
tercentenary	kb. (j. -j. -ries) peringatan tigaratus tahun.
term	kb. 1 masa. 2 istilah. 3 ucapan (of reproach. -terms j. 1 syarat-syarat (of a contract). 2 hubungan. -kkt. mengatakan.
term.	1 [terminal] setasiun, terminal (is, kereta api, kepal terbang]. 2 terminology] terminologi, peristirahatan. 3 [termination] pengakhiran, kesudahan.
terminal	kb. 1 stasiun (bis, kereta api). 2 setasiun, terminal, pangkalan (airlines). 3 sambungan (of a battery.
terminate	kkt. mengakhiri (a countract). -kki. berakhir (of contract.
termination	kb. 1 kesudahan, penghentian (of acontract). 2 gram.: akhiran.
terminology	kb. (j. -gies) istilah, peristilahan, terminologi.
terminus	kb. ujung penghabisan.
termite	kb. anai-anai, rayap.
tern	kb. semacam burung laut.
terr.	[territory] wilayah, daerah.
terrace	kb. 1 petak. rice t. petak sawah. 2 teras. -kkt. membuat, berteras-teras, berjenjang. -terraced ks. bertingkat- tingkat.
terrain	kb. tanah lapangan, daerah.
terrapin	kb. semacam kura-kura, penyu.
terrestrial	ks. yang berkaitan dengan bumi. t. globe bola bumi.
terrible	ks. 1 buruk sekali. t. situation keadaan yang buruk sekali. 2 mengerikan, dahsyat (of an accident). 3 malas, tidak baik (of a worker). 4 yang sama sekali tidak menyenangkan (of a talker). -terribly kk. sangat, amat.
terrier	kb. sejenis anjing.
terrific	ks. hebat, dahsyat. he got a t. reception ia mendapat sambutan yang hebat. 2 amat manakutkan, dahsyat (of a storm). 3 menyala.
terrified	lih terrify.
terrifies	lih terrify.
terrify	kkt. (terrified) mengerikan bagi, menakutkan. such a thought terrifies me pikiran yang demikian mengerikan bagiku. -terrifying ks. mengerikan.
territorial	ks. yang berkaitan dengan wilayah, daerah, teritorial. he has no t. ambitions ia tak mempunyai keinginan mengambil (tanah) wilayah orang/piuhak lain. t. waters perairan wilayah/teritorial.
territory	kb. (j. -ries) daerah, wilayah. indian t. daerah tempat tinggal orang-orang indian. sales t. daerah perdagangan.
terror	kb. rasa ngeri, kengerian, teror. reign of t. pemerintahan yang bengis. inf.: he's a holy t. ia benar-benar menakutkan/menyeramkan. terror-stricken ks. merasa amat ngeri.
terrorism	kb. terorisme, penggentaran.
terrorist	kb. penggentar, perusuh, teroris.
terrorize	kkt. menggentari.
terry	kb. (j. -ries) t. cloth kain anduk.
terse	ks. pendek dan tepat (of a statement).
terseness	kb. kecekatan, ketegasan.
tertiary	ks. 1 ketiga. t. characteristic ciri ketiga. t. stress tekanan ketiga. 2 geol.: tersier. t period jaman tersier.
test	kb. ujian. driver's t. ujian mengambil rebewes. -kkt. 1 menguji. 12 mencoba (a car). -testing kb. pengujian, percobaan.
test.	[testament] perjanjian.
testament	kb. 1 surat wasiat. last will and t. surat wasiat yang terakhir. 2 bible : t. perjanjian.
tester	kb. pencoba, tukang coba, penguji.
testicle	kb. buah pelir, biji kemaluan.
testified	lih testify.
testifies	lih testify.
testify	kki. (testified) memberikan kesaksian. to t. against s.o. memberikan kesaksian yang memberatkan bagi seseorang.
testimonial	kb. 1 tanda penghargaan (to s. o's achievement). 2 surat keterangan, surat pujian. t. dinner makan malam penghormatan.
testimony	kb. (j. -nies) kesaksian, penyaksian. to bear t. to memberi kesaksian terhadap.
testy	ks. bengkeng, tidak sabar, mudah tersinggung.
tetanus	kb. tetanus, kekejangan otot.
tete-a-tete	kk. berdua saja, pembicaraan/pertemuan antara dua orang saja.
tether	kb. (tali) tambatan. to be at the end of o's t. kehilangan kesabaran, tak sabar lagi. -kkt. menambatkan.
tetralogy	kb. (j. -gies) serangkaian dari empat buah cerita sandiwara yang saling berhubungan.
teutonic	teutonic
tex.	[texas] negarabagian as.
text	kb. 1 tes, ayat,wejangan (of a sermon, from a holy scripture). 2 isi, bunyi (of a telegram, cable). 3 buku pelajaran. 4 teks. 5 naskah.
textbook	kb. buku pelajaran. an economics t. sebuah buku pelajaran ilmu ekonomi.
textile	kb. tekstil. t. industry industri tekstil, pertekstilan t. mill paberik tekstil. -textiles j. bahan tekstil.
texture	kb. 1 susunan, tekstur. t. of cloth susunan kain. 2 jaringan.
texual	ks. yang berkaitan dengan isi karangan. t. emendation perbaikan dalam teks. t. error kesalahan mengenai isi.
th.	1 [thursday] hari kamis. 2 [thomas] thomas.
th.d	[doctor of theology] doktor ilmu agama.
thai	kb. orang thai. 2 bahasa thai. -ks. (muang) thai.
thailand	kb. thailand, muang thai.
than	ksam. dari, daripada. she is older t. i ia lebih tua dari aku. i have more t. you sya mempunyai lebih banyak daipada kamu.
thank	kb. thanks j. terima kasih. -kkt. menyatakan terimakasih. to t. s.o. for s.t. menyatakan terimakasih kepada seseorang untuk sesuatu. thank-you ks. pernyataan terimakasih.
thankful	thankful
thankfulness	kb. rasa syukur.
thankless	ks. tak tahu rasa terima kasih (of a person). 2 yang menyusahkan (of a task). 3 yang tak dihargai. (of an act).
thanksgiving	kb. rasa syukur. t. (day) hari pernyataan terrima kasih.
that	( j. those) ks. itu. t. book buku itu. t. way begitu. t. very day hari itu juga. -kk. (se) begitu. kg. 1 itu. 2 yang satu itu. -ksam. 1 bahwa. 2 mana. 3 supaya, agar.
thataway	kk. inf.: ke arah itu. he went t. ia pergi ke arah itu.
thatch	kb. lalang, jerami, daun-daunan. t. roof atap lalang. -kkt. membuat/memberi atap dari jerami, daun kelapa dsb.
thaw	kb. 1 cair, pencairan (of snow, ice). 2 perbaikan (in relations). -kkt. melunakkan yang beku (of meat). -kki. 1 menjadi cair (of snow, ice). 2 menjadi lebih lincah/luwes (of a person).
the	kst. itu. t. elephant is an animal gajah adalah seekor binatang. t. show pertunjukan itu. -kk. if both of you come so much t. better kalau kamu berdua datang, tiu lebih baik lagi.
theater	kb. 1 gedung bioskop. movie t. (gedung) bioskop. 2 dunia sandiwara. 3 mil.: medan perang, mandala. 4 panggung sandiwara. theater-in-the-round teater ditengah-tengah gedung. med.: operating t. kamar bedah.
theatergoer	kb. pengunjung sandiwara/bioskop.
theatre	= theater.
theatrical	kb. theatricals j. pertunjukan drama khususnya oleh amatir. -ks. 1 yang berkaitan dengan sandiwara. 2 yang dibuat-buat. to assume a t. manner bertingkah-laku yang dibuat-buat.
thee	kg. kamu, anda (dipakai oleh quaker).
theft	kb. pencurian, kemalingan.
their	kg. mereka (punya). t. attitude sikap mereka.
theirs	kg. punya mereka. is this boat t. ? apakah perahu ini kepunyaan mereka ?
theism	kb. aliran ketuhanan.
them	kg. 1 mereka. i haven't seen t. aku tidak melihat mereka. 2 -nya. one of t. is broken salah satu diantaranya rusak.
theme	kb. 1 tema, pokok, motif (of a story, music, play). 2 karangan (pendek). t. song nyanyian utama. 3 suara-dasar.
then	kb. waktu itu. the knew by t. that... waktu itu mereka sudah tahu bahwa... -ks. waktu itu. -kk. 1 lalu, kemudian. 2 maka. if you do wrong, t. you must admit it kalau kau berbuat salah, maka kau harus mengakuinya. what t.? lalu bagaimana ?
thence	kk. kemudian. a. few years t. beberapa tahun kemudian.
thenceforth	kb. sejak itu.
theocracy	kb. (j. -cies) teokrasi.
theologian	kb. ahli ilmu agama.
theological	ks. yang mengenai agama. t. school sekolah agama/teologi. t. seminary seminari teologi.
theology	kb. (j. -gies) teologi, ilmu agama.
theorem	kb. dalil.
theoretical	ks. teoritis. t. physics ilmu fisika teoritis. -theoretically kk. secara teoretis.
theoretician	kb. teoretikus. -theoreticians j. teoritis.
theorist	kb. teoretikus.
theory	kb. (j. -ries) teori. t. of relativity teori relativitas. in t. dalam teori.
theosophy	kb. teosofi.
therapeutic	ks. yang mengandung unsur-unsur atau nilai pengobatan. rest is t. istirahat mengandung nilai pengobatan.
therapeutics	kb. ilmu pemeriksaan dan pengobatan.
therapy	kb. (j. -pies) terapi, pengobatan. physical t. pengobatan jasmani.
there	kb. sana. -kk. 1 disana, disitu. 2 kesana, kesitu. 3 (memanggil perhatian).4 sekian. 5 (tanpa tekanan). -kseru. nah ! who's in t. ? siapakah yang didalam itu.
thereabouts	kk. kira-kira, kurang lebih. five miles or t. kira-kira lima mil.
thereafter	kk. sesudah itu, kemudian.
thereby	kk. dengan (cara) demikian.
therefor	kk. untuk itu.
therefore	kk. oleh karena itu.
therein	kk. disitulah, disanalah.
thereof	kk. daripadanya, dari itu. i bought a cake and ate a slice t. aku membeli kue, lalu memakannya sepotong.
thereto	kk. kesitu, kesana. to affix o's signature t. membubuhi tanda tangan kepadanya.
theretofore	kk. sampai saat itu.
thereunder	kk. yang dibawah.
thereupon	kk. 1 lalu, setelah itu. she t. canceled her flight lalu ia membatalkan penerbangannya. 2 oleh sebab itu.
therewith	kk. beserta, bersamaan dengan itu.
thermal	ks. yang berkaitan dengan panas. t. current arus panas.
thermodynamics	kb. ilmu (pergerakan) panas.
thermometer	kb. termometer, alat pengukur panas. what does the t. read ? berapa panasnya pada ukuran panas itu ?
thermonuclear	ks. termonuklir.
thermos	kb. termos. t. bottle botol termos.
thermostat	kb. alat pengatur/pengimbang panas.
thesaurus	kb. kamus, ensiklopedi atau buku lain yang berisi keterangan.
these	lih this.
theses	lih thesis.
thesis	kb. (j. theses) 1 acod.: tesis, sasterakanta, disertasi. 2 tesis.
they	kg., j. mereka. they are going mereka pergi. here t. come itu mereka telah datang.
they'd	1 [they had] mereka telah. 2 [they would] mereka akan.
they'll	[1 they shall 2 they will] mereka akan.
they're	[they are] mereka ada(lah).
they've	[they have] mereka telah.
thick	kb. in the t. of ditengah-tengah. ks. 1 tebal. 2 kental. 3 berkabut. 4 serak, parau 5 dungu, tolol. -kk. amat berlebih-lebihan. -thickly kk. padat, rapat.
thicken	kkt. 1 mengentalkan (gravy). 2 mempertebal (a wall). -kki. menjadi rumit (of a plot). -thinckening kb. bahan pengental.
thicket	kb. belukar, semak-semak.
thief	kb. (j. thieves) pencuri, maling, pencoleng, tikus. -thieves j. kaum tangan-panjang.
thieve	kkt. mencuri. -thieving kb. pencurian.
thievery	kb. (j. -ries) pencurian.
thieves	lih thief.
thievish	ks. tangan-panjang.
thigh	kb. paha.
thighbone	kb. tulang paha.
thimble	kb. tudung/sarung jari, bidal.
thimbleful	kb. sedikit sekali, sejumlah kecil sekali.
thin	kb. lih thick. -ks. 1 tipis (of book, wall, paper). 2 encer (of liquids). 3 lemah (of voice, excuse). 4 kurus (of a person). 5 jarang (of hair, foliage). 6 renggang, tipis (of air). 7 yang sedikit jumlahnya (of an audience).
thine	kg. kepunyaan atau milik kamu/anda. t. eyes matamu.
thing	kb. 1 benda. what is this t.? benda apa itu ? 2 barang. 3 alat-alat, peralatan. 4 orang, makhluk. 5 mantel, pakaian luar.
thingumajig	kb. inf.: anu, apa itu.
think	kb. inf.: he has another t. coming sekarang ia telah lain pikirannya. -kkt. (thought) memikirkan (evil thoughts). -kki. 1 pikir. 2 kira, pikir. 3 berpikir, merenung. 4 menganggap (well of a.s.). 5 menduga, menyangka.
thinkable	ks. masuk akal (untuk mengira).
thinker	kb. ahli pikir, pemikir.
thinking	kb. berpikir. thought-out ks. yang telah dipikirkan masak-masak.
thinner	kb. bahan pengencer/pencair, tener.
thinness	kb. 1 kejarangan (of hair). 2 ketipisan (of paper). 3 keenceran (of liquid). 4 permintaan maaf yang tidak sungguh-sungguh (of an excuse).
thinning	kb. penjarangan (of plants). ks. menipis, menjadi jarang (hair). -kkt. (thinned) 1 mengencerkan (a liquid). 2 memperjarang (plants). thin-skinned ks. 1 mudah tersinggung (of a person). 2 berkulit tipis (of fruit). -thinly kk. tipis.
third	kb. 1 pertiga. 2 persneling ketiga. 3 tiga. -ks. ketiga. third-rate ks. bermutu rendah, kelas kambing. -thirdly kk. (yang) ketiga.
thirst	kb. dahaga, kehausan. to quench o's t. menghilangkan/melepaskan dahaganya. -kki. to t. for 1 haus akan (knowledge). 2 ingin sekali (a coke).
thirsty	ks. haus. i'm t. aku haus. that makes me t. itu membuat saya haus.
thirteeenth	kb. 1 ketigabelas. the t. tanggal tigabelas. 2 pertigabelas. -ks. yang ketigabelas.
thirteen	kb. tigabelas.
thirtieth	kb. 1 tigapuluh. the t. tanggal tigapuluh. 2 pertigapuluh. -ks. yang ketigapuluh.
thirtty	kb. (j. -ties) tigapuluh. thirty-first kb. tigapuluh satu. ks. yang ketigapuluh satu. thirty-second ks. yang ketigapuluh dua. thirty-two kb. tigapuluh dua.
this	(j. these) ks. ini. these books buku-buku ini. -kk. t. far sejauh ini. t. much sebanyak ini. -kg. 1 ini. t. is wrong ini salah. 2 yang ini. i prefer t. aku lebih suka yang ini.
thistle	kb. semacam widuri, semacam tumbuhan berduri.
thither	kk. kesana, kesitu.
tho, tho'	kk., ksam. = though.
thong	kb. tali kulit.
thoracic	ks. yang berkaitan dengan dada. t. cavity rongga dada.
thorn	kb. duri, onak. i have a t. in my finger ada duri didalam jariku. to be a t. in o's flesh or side duri (di) dalam daging, suka menyusahkan orang.
thorny	ks. 1 berduri (of a plant). 2 sulit, menjengkelkan (of a problem).
thorough	ks. 1 seksama, teliti (examination). 2 cermat, teliti (person). 3 yang tidak bertanggung jawab. -thoroughly kk. 1 sepenuhnya. 2 bukan kepalang.
thoroughbred	kb. 1 yang berdarah/berketurunan murni (of dog, horse). 2 seorang yang halus budi bahasanya. -ks. berdarah/berketurunan murni.
thoroughfare	kb. jalan. main t. jalan utama. not t. bukan jalan untuk umum. public t. jalan umum. busy t. tempat lalu-lintas yang sibuk/ramai.
thoroughgoing	ks. seksama, sempurna. the car received a t. overhaul mobil itu diperiksa secara seksama.
those	kg. lih that.
thou	kg. engkau, dikau, kau.
thou.	[thousand] se(ribu).
though	kk. lebih dulu. i hit him but he hit me first t. aku memukulnya, tapi ia memukul aku lebih dulu. -ksam. mesdkipun, walaupun. t. he knew better, he... meskipun ia tahu itu salah, ia.....
thought	kb. 1 pikiran, gagasan, ide. i have a good t. aku mempunyai pikiran yang baik. 2 pemikiran. 3 perhatian. thought-provoking ks. yang menimbulkan pikiran (data). -kk. sedikit. be a t. more polite agak lebih sopanlah sedikit.
thoughtful	ks. 1 tenggang hati, bijaksana (of others). 2 berpikir. he was t. for a while ia berpikir sejenak. 3 dalam (of a book).
thoughtfulness	kb. perhatian, keprihatinan.
thoughtless	ks. tak dipikirkan. to make a t. remark mengucapkan sesuatu tanpa pemikiran.
thoughtlessness	kb. ketidakbijasanaan, kesembronoan.
thousand	kb. ribu. i pay two t. for it saya membayar duaribu untuk itu. -ks. seribu. a t. men seribu orang.
thousandth	kb. perseribu. one t. of an inch seperseribu inci. -ks. keseribu.
thrash	kkt. lih thresh. 1 menebah, mengirik (grain). 2 memukul, membanat, membedal, merangket (s.o.). to t. about in the water menggelepar-gelepar didalam air. -thrashing kb. 1 pemukulan, laberakan, dera(an). 2 menebah, mengirik of grain).
thread	kb. 1 benang. 2 urutan. to pick up the threads again a) meneruskan kehidupan. b) meneruskan cerita lagi. 3 galur, ulir drat (of a screw) 4 berkas. -kkt. 1 memasang benang. 2 membuat galur. 3 menyusup.
threadbare	ks. 1 using sekali,tipis menerawang (of clothes). 2 tua (of a joke).
threat	kb. ancaman. there's the t. of snow ada ancaman (turunnya/jatuhnya) salju. t. on o's life ancaman akan dibunuh.
threaten	kkt. mengancam. to t. s.o's life mengancam jiwa seseorang. -threatening ks. yang mengancam. t. letter surat ancaman.
three	kb. 1 tiga. the big t. (negara) tiga besar. 2 tiga orang. only t. came hanya tiga orang yang datang. -ks. tiga. t. books tiga buku.
threefold	ks., kk. lipat tiga. t. increase kenaikan lipat tiga.
threescore	ks. enam puluh. t. and ten tujuh puluh.
threesome	kb. kelompok/regu tiga orang.
thresh	= thrash. threshing machine mesin pengirik.
thresher	kb. 1 penebah. 2 (machine) mesin penebah/pengirik/rontongan.
threshold	kb. 1 ambang pintu. to be on the t. of success berada di ambang pintu sukses. 2 permulaan, ambang (of pain). to cross the t. melintasi/meliwati ambang pintu.
threw	lih throw.
thrice	kk. tiga kali.
thrift	kb. hemat, penghematan, sifat berhemat.
thriftiness	kb. sifat berhemat.
thrifty	ks. (ber) hemat, cermat. a t. shopper seorang pembelanja yang hemat. -thriftily kk. dengan hemat. to live t. hidup dengan hemat.
thrill	kb. getaran hati/jiwa, sensasi. -kkt. menggetarkan hati, menggairahkan (s.o.). -kki. menggetarkan. -thrilling ks. yang menawankan hati.
thriller	kb. 1 (sports event) sesuatu yang menggetarkan hati. 2 sesuatu yang mengerikan. movie t. pilem yang mengerikan. 3 (story) roman atau cerita detektip.
thrive	kki. (throve atau thrived, thrived atau thriven) 1 tumbuh dengan subur (of plants and animals). 2 maju dengan pesat, berkembang dengan pesat (of business). -thriving ks. yang sedang berkembang. t. business usaha yang sedang berkembang dengan baik.
thriven	lih thrive.
throat	kb. 1 kerongkongan, tenggorokan. i have asore t. tenggorokanku sakit. 2 (batang) leher.
throatiness	kb. suara serak/parau.
throaty	ks. serak, parau.
throb	kb. 1 denyut (of pulse). 2 debar (of a heart). 3 denyutan. -kki. (throbbed) 1 berdebar (of aheart) . 2 berdenyut-denyut (of pulse). -throbbing kb. 1 denyut (of heart or pulse). 2 dentaman (of an engine).
throes	kb., j. kelabakan (of a slaughterea animal or fowl). death t. sakaratulmaut.
thrombosis	kb. trombosa, pembekuan darah (dalam buluh darah). lih coronary.
throne	kb. takhta, singgasana. to mount/take/ascend the t. naik takhta, menjadi raja.
throng	kb.bondong, gerombolan orang. -kkt. memenuhi, menjejali. -kki. to t. around berdesak-desakan, berkerumun mengelilingi (the president).
throttle	kb. katup penghambat/penutup, klep penutup (on boiler, locomotive). -kkt. 1 mencekek (s.o). 2 memberedel, memberangus (the press). 3 memperlambat (jalan) (a locomotive).
through	ks. 1 selesai, siap. 2 terus(an). -kk. 1 dari permulaan sampai habis. 2 terus. 3 menyambung. -kd. 1 melalui. 2 melewati, lewat. 3 karena. 4 terus. 5 diluar.
throughout	kk. seluruhnya. -kd. 1 diseluruh. 2 sepanjang. t. the year sepanjang tahun.
throughway	= thruway.
throve	lih thrive.
throw	kb. 1 lemparan. 2 kain penutup (for sofa). -kkt. 1 melemparkan (a ball, rock). 2 melemparkan, menjebloskan. 3 memberi. 4 menyorotkan. 5 inf.: mengadakan (a party). 6 melilitkan. 7 (of a horse) melepaskan (a shoe). 8 memusingkan kepala. 9 pembuat.
throwaway	kb. lembaran iklan (yang tak berarti). t. container wadah untuk dibuang.
throwback	kb. seseorang yang memiliki ciri-ciri dari leluhurnya.
thrower	kb. pelempar. discus t. pelempar cakram.
thrown	lih throw.
thru	= through.
thrum	kb. petikan. 0kki. (trummed) 1 memetik (on guitar or banjo). 2 mengetuk-ngetukkan (on a table). -thrumming kb. petikan.
thrush	kb. 1 sejenis murai. 2 med.: guam, seriawan.
thrust	kb. 1 daya tolak/dorong (of an engine). 2 tusukan, tikaman (of a sword). 3 arah, tujuan. 4 serangan. -kkt. (thrust) 1 memasukkan, mendorongkan (the hands in o's pockets). 2 mendorong (roots). 3 menusukkan 4 menimpakan. -kki. berdesakan.
thruway	kb. jaklan raya untuk lalulintas cepat.
thu.	[thursday] kamis, kemis.
thud	kb. gedebuk (of a fallen body). to make a t. bergedebuk, bergedebuk.
thug	kb. penjahat yang kejam.
thuindercloud	kb. awan petir.
thumb	kb. ibu jari. to be all thumbs canggung, kikuk. thumbs down tanda tak setuju. thumbs up tanda setuju. -kkt. membaca sepintas lalu (a book).
thumbnail	thumbnail
thumbprint	kb. cap jempol.
thumbtack	kb. paku jamur/payung.
thump	kb. gebukan, bunyi geebuk. -kkt. 1 memukul (a pillow). 2 mengetuk (a patien). -kki. berdebar.
thunder	kb. guntur, guruh, gemuruh. t. of applouse tepuk-tangan yang gemuruh. -kki. mengguruh. mengguntur. -thundering ks. 1 berderap. a t. herd sekawanan hewan yang berderap. 2 inf.: besar sekali. t. lie dusta besar.
thunderbolt	kb. halilintar, petir, geledek.
thunderous	ks. bergemuruh.
thunderstorm	kb. hujan angin ribut disertai petir dan guruh.
thunderstruck	ks. seperti disambar petir, teringa-inga, termangu-mangu.
thurs.	[thursday] kamis, kemis.
thursday	kb. kamis, kemis.
thus	kk. 1 demikian. do it t. kerjakanlah demikian. 2 jadi. she is ill ; t. she can't come ia sakit, jadi ia tak dapat datang. 3 hingga. t. for hingga kini.
thwack	kb. pukulan.
thwart	kkt. merintangi, menghalangi, menggagalkan. to t. s.o's plans merintangi rencana seseorang.
thy	kg. ( milik kepunyaan) kamu, engkau, -mu. t. book bukumu.
thyme	kb. semacam tumbuhan (untuk pengharum makanan).
thyroid	ks. yang berrkaitan dengan lekum. t. gland kelenjar gondok.
thyself	lih self.
tiara	kb. perhiasan kepala (menyerupai mahkita kecil), tiara.
tibetan	kb. 1 orang tibet. 2 bahasa tibet. --ks. yang berhubungan dengan tibet.
tibia	kb. tulang kering.
tic	kb. gerenyet. nervous t. gerenyet urat syaraf.
tic-tac-toe	kb. tebak-tebakan dengan angka.
tick	kb. 1 detik(an) (of a clock). 2 kutu (on dog). 3 (bed covering) sarung kasur. 4 tanda ("). -kkt. mendetikkan. -ticking kb. kain kasur.
tick-tack-toe	= tic-tac-toe.
tick-tock	kb. bunyi berdetak-detik.
ticker	ticker
ticket	kb. 1 karcis (of train, plane). t. office tempat penjualan karcis. 2 tuntutan (polisi). to get a t. for speeding kena tuntutan polisi karena berkendaraan terlalu cepat. 3 daftar calon suatu partai. -kkt. memberi kartu harga.
ticketholder	kbn. pemegang/pemilik karcis.
tickle	kb. perasaan gatal. i have a t. on my nose hidungku gatal. -kkt. 1 menggelitik (s.o.). 2 menggelikan bagi. -kki. terasa gatal. -tickling kb. menggelikan.
tickler	kb. 1 catatan untuk mengingat. 2 inf.: soal yang sulit, problema yang berat.
ticklish	ks. 1 mudah geli. she's t. ia mudah geli. 2 yang harus diperlakukan dengan hati-hati. t. subject hal yang mudah menyinggung perasaan.
tickness	kb. 1 tebalnya, ketebalan (of a book, wall). 2 ketebalan (of lips). 3 lapis tebal. 4 kekentalan (of a liquid).
tidal	ks. yang disebabkan pasang nai dan pasang surut. t. basin kuala air pasang. t. current arus pasang. t. wave gelombang pasang.
tidbit	kb. (food) penganan kecil. 2 berita atau keterangan yang menarik.
tiddlywinks	kb. permainan melempar benda-benda pipih bulat kedalam cangkir.
tide	kb. 1 pasang. the t. is coming in pasang sedang naik. 2 turun naiknya. the t. of public opinion turun naiknya pendapat umum. -kki. to t. over membantu melalui.
tidewater	kb. air pasang. t. area daerah air pasang.
tidier, tidiest	lih tidy.
tidiness	kb. kerapian.
tidings	kb., j. kabar, berita.
tidy	ks. (tidier, tidiest) 1 rapi, teratur (room). 2 lumayan. a t. sum of money sejumlah uang yang lumayan. -kkt. merapikan, mengatur (the house). -kki. membereskan.
tie	kb. 1 dasi. 2 pertalian, tali. 3 rr.: balok landasan/rel, ganjal rel. 4 seri. -kkt. (tying) 1 mengikat (o's shoelaces). 2 mengikatkan (s.t. to or around s.t.). 3 bermain seri melawan. 4 menghubungkan, mempertalikan. 5 mengikat (an artery).
tie-in	kb. hubungan, pertalian. tie-up kb. 1 hubungan, koneksi. 2 kemacetan (of traffic).
tier	kb. deretan bertingkat.
tiff	kb. pertengkaran kecil, cekcok sedikit. they had a t. antara mereka terjadi sedikit percekcokan.
tiger	kb. harimau, macan.
tight	kb. tights j. celana (panjang) ketat. -ks. 1 sempit (of clothing, chair). 2 kikir. 3 mabuk. 4 sukar, sulit (of money). 5 ketat (of string, knot, shoe, dress). -kk. rapat. 2 kuat-kuat.
tight-fisted	ks. kikir, bakhil.
tight-knit	ks. bersatu padu. tight-lipped ks. membisu. -tightly kk. rapat sekali. these doors fit t. pintu-pintu ini (menutup) rapat sekali.
tighten	kkt. 1 mempererat (a string). 2 mengetatkan (a bolt). to t. o's belt a) mengeratkan tali pinggang. b) inf.: berusaha hidup sederhana. -tightening kb. pengetatan.
tightness	kb. kesesakan, keketatan.
tightrope	kb. tali (yang direntang) tegang. to walk a t. berusaha menyelamatkan diri dalam keadaan yang sulit.
tightwad	kb. sl.: orang kikir.
tigress	kb. harimau betina.
tile	kb. jubin, ubin. roof t. genteng atap. -kkt. memasang ubin. to t. a bathroom memasang ubin di kamar mandi. to t. a roof memasang genteng atap. -tiling kb. ubin, jubin.
till	kb. 1 laci uang. 2 mesin kas. -kd. sampai. from morning t. night dari pagi hingga malam. -kkt. mengerjakan tanah. -ksam. sampai, hingga.
tiller	kb. 1 nau.: pasak kemudi, celaga. 2 petani, peladang.
tilt	kb. 1 kemiringan, miringnya (of a table). 2 pertengkaran. 3 pertandingan dengan tombak. -kkt. memiringkan (a table, container). -kki. bertombak-tombakan, bertanding lembing. to t. back memiringkan kebelakang. to t. forward memiringkan kedepan.
timber	kb. 1 kayu. to make a fortune in t. menjadi kaya dalam berdagang kayu. 2 kayu-kayuan, pohon - pohonan. much of his land is in t. sebagian besar tanahnya ditumbuhi kayu-kayuan.
timberland	kb. tanah hutan.
timbre	kb. warnanada.
time	kb. 1 waktu, tempo. to learn to tell t. belajar mengenal waktu (pada jam). 2 jaman, zaman. 3 kali. 4 jam, pukul. 5 musim. 6 masa, waktu. 7 irama. -times j. waktu, zaman. -kkt. 1 mengukur waktu. 2 mengatur, memilih waktu. -timing kb. pemilihan waktu.
timecard	kb. kartu waktu/hadir.
timekeeper	kb. pencatat/penjaga waktu.
timeless	ks. tanpa prhitungan waktu, tanpa batas waktu, tak habis-habis, abadi.
timeliness	kb. berketepan waktu, waktu yang tepat.
timely	ksd. tepat pada waktunya. the meeting was t. rapat itu diadakan pada waktunya. t. departure kepergian yang tepat pada waktunya.
timepiece	kb. jam, lonceng.
timer	kb. alat pengatur waktu.
timesaver	kb. penghemat waktu.
timesaving	ks. yang menghemat waktu. t. appliance alat yang menghemat waktu.
timetable	kb. daftar jam/perjalanan.
timeworn	ks. aus, usang (theory, floor).
timid	ks. 1 takut-takutan, malu-malu (of a person). 2 takut. to make a t. approach to o's boss mendekati majikannya dengan takut. -timidly kk. takut, malu-malu.
timidity	kb. sifat takut-takut/malu-malu.
timorous	ks. takut-takut(an).
timpani	kb., j. semacam drum., tambur, genderang.
tin	kb. timah. made of t. terbuat dari timah. 2 kaleng. pie t. panci pastel dari kaleng. 3 blek. t. can kaleng, blek. -kkt. (tinned) melapisi dengan timah, mengalengkan, menempatkan di kaleng.
tincture	kb. larutan obat dalam alkohol
tinder	kb. rabuk, kawul.
tinderbox	kb. 1 sesuatu yang mudah terbakar (said of a house). 2 seorang yang sangat mudah marah.
tine	kb. gigi (sebuah garpu).
tinfoil	kb. kertas/daun timah.
ting-a-ling	kb. bunyi nyaring dari genta kecil.
tinge	kb. (sedikit) warna. she has a t. of gray in her hair rambutnya telah beruban sedikit. 2 nada (of sadness, reproach in o's voice). -kkt. 1 mencat, mewarnai (hair, water). 2 membubuhi, memberi nada pada.
tingle	kb. gelenyar. -kki. 1 menggelnyar (with excitement, stage fright). 2 terasa gatal. -tingling kb. perasaan geli. t. sensation sensasi/kehebohan yang menggelikan.
tinhorn	kb. sl.: pelagak, sok berlagak, t. soldier serdadu pilihan.
tinker	kb. tukang pateri. not to care a tinkers dam what... sedikitpun tak perduli akan.... -kkt. to t. at menggerupis/menggerumit. to t. with bekerja sembarangan dengan menggerumit. -tinkering kb. mengerjakan sesuatu tanpa keahlian, main-main dengan sesuatu.
tinkle	kb. bunyi dering, kerincing (of bells). -kki. berdering, berkerincing. -tinkling kb. bunyi gemerincing.
tinny	ks. seperti timah.
tinsel	kb. perada kertas-kertas perak ,mas dan timah.
tint	kb. warna. -kkt. memberi warna, mewarnai.
tinware	kb. barang-barang dari timah.
tiny	ks. kecil sekali. she had a t. income penghasilannya kecil.
tip	kb. 1 ujung (of a finger, island, iceberg). 2 uang perten/rokok. 3 petunjuk. 4 nasehat, petuah. 5 info, kabar rahasia. -kkt. (tipped) 1 memberikan uang persen (kepada). 2 (to touch) menyinggung, mengenai. 3 merebahkan, merobohkan.
tipoff	kb. inf.: 1 peringatan. 2 petunjuk (rahasia).
tipper	kb. pemberi (uang) persen, orang yang memberi persen.
tipple	kb. alat untuk memiringkan gerobak batu bara.
tipsy	ks. agak mabuk.
tiptop	ks. inf.: sangat baik. in t. shape dalam keadaan jasmani yang sangat baik.
tirade	kb. semburan kata-kata marah yang berlangsung lama.
tire	kb. ban. -kkt. meletihkan, melelahkan. -kki. menjadi lelah. she tires easily ia lekas lelah. -tired ks. lelah, letih, payah. i feel t. aku merasa lelah. -tiring ks. 1 melelahkan, meletihkan (work). 2 membosankan, menjemukan.
tiredness	kb. kelelahan, keletihan.
tireless	ks. 1 tak kunjung letih, tak mengenal lelah (of a person). 2 tak henti-hentinya (of efforts). -tirelessly kk. tanpa keletihan/kelelahan, terus-menerus.
tiresome	ks. membosankan, menjemukan.
tissue	kb. 1 jaringan. muscular t. jaringan otot. 2 lap/serbet kertas. t. paper kertas yang tipis dan lunak. 3 urat daging. he strained the t. in his leg urat daging kakinya terkilir.
tit	kb. pentil. t. for tat pukulan dibalas dengan pukulan. to give s.o. t. for tat membalas seseorang dengan setimpal.
tithe	kb. semacam zakat, sepersepuluh dari penghasilan (yang diberi gereja). -kki. berzakat.
titillate	kkt. menggairahkan, merangsang.
title	kb. 1 gelar. what's his t. ? apa gelarnya? 2 judul (of a book). 3 hak. 4 sport : kejuaraan. -kkt. memberi judul. t. deed surat bukti hak (milik), sertifikat tanah. -titled ks. bergelar bangsawan.
titleholder	kb. pemegang (gelar) kejuaraan.
titter	titter
tittle-tattle	kb. kabar angin, buah mulut.
titular	ks. tituler, sebagai gelar (saja).
tizzy	kb. sl.: keadaan amat gelisah. to be in a t. over merasa gelisah menghadapi.
tko	[technical knokout] lih technical
tnt	kb. semacam bahan peledak.
to	ks. 1 ke. to go to the bank pergi kebank. 2 kepada. bring the book to me bawakan buku itu (ke)padaku. 3 dengan. did you talk to him ? apakah kau telah berbicara dengan dia. 4 untuk. to drink to the king. minum untuk kehormatan raja. 5 kurang.
toad	kb. katak, kodok.
toadies	lih toady.
toadstool	kb. jamur payung.
toady	kki. (toadied) menjilat, berminyak air (to kepada).
toast	kb. roti panggang. to drink a t. to s.o. minum untuk memberi selamat kepada seseorang. -kkt. memanggang (bread).
toaster	kb. pemanggang roti.
toastmaster	kb. pemimpin (up)acara.
tobacco	kb. tembakau. t. can kaleng tembakau. t. pouch kantong tembakau.
toboggan	kb. sejenis kereta peluncur.
today	kb. hari ini, harini. t. is friday hari ini hari jum'at. -kk. hari ini. they will return t. mereka akan kembali hari ini.
toddle	kki. berlatih, bertatah (of a baby).
toddler	kb. anak kecil yang baru belajar berjalan.
toddy	kb. (j. -dies) minuman keras berbumbu, semacam minuman tuak.
toe	kb. 1 jari kaki. he broke his t. tulang jari kakinya patah. 2 ujung (of shoe, stocking). -kki. to t. in whwn walking berjalan dengan kakinya menghadap kedalam. t. hold tumpuan kaki.
toenail	kb. kuku jari kaki.
toga	kb. jubah.
together	kk. bersama-sama. to study t. belajar bersama-sama. they're always t. mereka selalu bersama-sama.
togetherness	kb. kebersamaan, kekompakan.
togs	kb., j. pakaian.
toil	kb. kerja keras. -kki. bekerja keras, bekerja membanting tulang. to t. up a slope berusaha keras naik tanjakan.
toiler	kb. pekerja.
toilet	kb. 1 kamar kecil, wc, kloset, kakus, toilet. 2 lubang kakus. 3 dandanan, rias. t. articles alat-alat kecantikan/rias. t. paper kertas kloset/kakus. t. soap sabun mandi.
toilsome	ks. berat, melelahkan.
token	kb. 1 tanda. black is a t. of mourning warna hitam adalah tanda berkabung. 2 mata uang, ketipan, dsb. (dipakai untuk telpon otomat, mesin materai dsb). 3 bukti. 4 (tanda) penghargaan. 5 kenang-kenangan.
told	lih tell.
tolerable	ks. 1 dapat ditahankan. 2 lumayan. -tolerably kk. dengan lumayan. t. well lumayan/boleh juga.
tolerance	kb. 1 toleransi, kesabaran, kelapangan dada. to show great t. memperlihatkan sifat sabar. 2 daya tahan. heat t. dayatahan panas. 3 tahan terhadap, dapat menerima (to medicine, drugs).
tolerant	ks. bersikap toleran, sabar. to be t. of bersikap toleran terhadap.
tolerate	kkt. 1 sabar menghadapi (abuse). i won't t. any stubbornness aku tak sabar melihat kedegilan. 2 tahan terhadap (an antibiotic).
toll	kb. 1 bea (cukai). t. charge on a bridge bea untuk melalui jembatan. 2 korban. the disaster took a heavy t. bencana itu meminta banyak korban. 3 bunyi (of bell). -kkt. membunyikan (bell). -kki. berbunyi (of a bell).
tollbooth	kb. pabean.
tollgate	kb. pos cukai/bea.
tom	kb. nama julukan thomas. t., dick and harry orang banyak.
tom-tom	kb. semacam gendang.
tomahawk	kb. kampak orang indian (senjata).
tomato	kb. buah tomat. t. catsup saus tomat. t. juice air/sari tomat.
tomb	kb. kuburan, makam, pusara.
tomboy	tomboy
tombstone	kb. batu nisan.
tomcat	kb. kucing jantan.
tome	kb. buku yang besar dan berat.
tomfoolery	kb. (j. -ries) tindakan gila-gilaan.
tommyrot	kb. sl.: omong/bual kosong.
tomorrow	kb. besok. tomottow's paper suratkabar besok. t. evening besok malam. -kk. besok. i'll see you t. sampai besok.
ton	kb. ton. a t. of coal se-ton batu bara. inf.: he has tons of money uangnya banyak sekali.
tonal	ks. yang mempergunakan gaya suara.
tone	kb. 1 nada. i like the t. of her voice aku senang pada nada suaranya. 2 sifat. colors with soft tones warna-warna yang bersifat lembut. 3 bunyi. 4 kesehatan. -kkt. to t. down berbicara lebih pelan. tone-deaf ks. pekak nada.
tongs	kb., j. jepitan, tang.
tongue	kb. lidah. 2 bahasa. 3 batang/kayu penarik (on a wagon). 4 jazirah (of land). 5 lidah, tutup (in shoes). tongue-lashing kb. cacian yang pedas, dampratan, makian. -tongue-tied ks. kaku lidah, lidah seakan-akan lumpuh.
tonic	kb. 1 med.: obat penguat. t. water air penguat/tonikum. 2 obat kuat. the seashore is a t. to many pantai laut itu merupakan obat kuat bagi banyak orang.
tonight	kb. malam ini. the t. show pertunjukan malam ini. -kk. nanti malam, malam ini. what are you doing t. ? apa kerjamu nanti malam ?
tonnage	kb. tonasi.
tonsil	kb. amandel
tonsillectomy	kb. (j. -mies) pembedahan/operasi amandel.
tonsillitis	kb. radang amandel.
too	kk. terlalu. t. many terlalu banyak. 2 sekali. 3 juga.she's hungry t. dia juga lapar. 4 -pun. we t. are going kamipun akan pergi.
took	lih take.
tool	kb. 1 alat. useful t. alat yang berguna. 2 perkakas, alat. t. box peti perkakas. 3 kakitangan, alat (of gangsters). -kki. to t. up menyesuaikan peralatan. -tooling kb. hiasan yang dibuat dengan alat. leather t. penghiasan kulit dengan alat.
toolmaker	kb. pembuat perkakas.
toot	kb. lengkingan (of a whistle). -kkt. membunyikan. to t. the horn membunyikan klakson. -kki. berbunyi "tutut".
tooth	kb. (j. teeth) gigi. which t. hurts ? gigi mana yang sakit ? -teeth j. gigi. to show o's teeth 1 menunjukkan gigi. 2 bersikap mengancam.
toothache	kb. sakit gigi.
toothbrush	kb. sikat gigi.
toothless	ks. ompong.
toothpick	kb. tusuk/ (pen) cungkil gigi.
toothpowder	kb. tepung gosok gigi.
toothsome	ks. 1 lezat, enak (of food). 2 menggiurkan, menyenangkan (of a girl).
toothy	ks. memeperlihatkan (banyak gigi).
tootsy	kb. (j. -sies) inf.: 1 kaki bayi/kecil. 2 jari kaki.
top	kb. 1 puncak (of a mountain, tree). 2 juara yang terpandai (in a group, class). 3 kap (of car). 4 bubungan (of a roof). 5 tutup. 6 daun-daun. 7 gasing. -ks. 1 paling atas, teratas. 2 tertinggi, paling tinggi. 3 maksimum, paling tinggi. 4 utama.
topaz	kb. ratna cempaka.
topcoat	kb. mantel, jas luar.
topic	kb. 1 pokok (pembicaraan). topics of the day pokok pembicaraan/soal yang hangat hari ini. 2 yang ramai dibaicarakan, buah mulut/bibir.
topknot	kb. jambul (rambut atau bulu).
topless	ks. tanpa penutup dada, dengan dada terbuka.
topmost	ks. (yang paling atas).
topnotch	ks. inf.: ulung, nomor wahid, jempolan.
topographic(al)	ks. yang berkaitan dengan topografi. t. map peta topografi.
topography	kb. (j. -phies) topografi.
topology	kb. topologi.
toponymy	kb. ilmu nama-nama tempat-tempat.
topped	kkt. 1 mengalahkan, melebihi. 2 mengatasi. 3 memangkas puncak (a tree). top-drawer ks. yang paling penting. top-grade ks. bermutu paling baik. top-seeded ks. digolongkan di kelas tertinggi. -topping kb. lapisan diatas (of a cake).
topple	kkt. merobohkan, menjatuhkan (a ruler or government, tree). -kki. tumbang, rebah. the tree toppled to the ground pohon itu rebah di tanah.
topside	kb. geladak/dek atas. to be t. ada di dek atas.
topsoil	kb. bunga tanah (humus).
topsy-turvy	ks. 1 tunggang balik. 2 kacau-balau, kucar-kacir. to turn everything t. membuat semuanya menjadi kacau-balau.
torch	kb. obor, suluh. sl.: to carry a t. for s.o. mencintai seseorang (tapi tidak dibalas).
torchbearer	kb. pembawa obor.
torchlight	kb. cahaya obor. t. procession pawai obor.
tore	lih tear/taer/kkt.
torement	kb. 1 siksaan. 2 kesakitan. 3 kesengsaraan. -kkt. menyiksa.
tormentor	kb. penyiksa.
torn	lih tear/taer/kkt.
tornado	kb. angin taufan.
torpedo	kb. 1 torpedo. t. kapal torpedo. 2 semacam petasan, periuk api. -kkt. 1 mentorpedir (a ship). 2 menggagalkan (a meeting, conference).
torpid	ks. lamban, tumpul.
torpor	kb. kelambanan, ketumpulan.
torque	kb. tenaga putaran.
torrent	kb. 1 aliran air yang deras. the rain came down in torrents hujan turun dengan derasnya. 2 semburan. t. of words semburan kata-kata.
torrential	ks. amat deras, sangat lebat. t. rains hujan-hujan yang amat lebat.
torrid	ks. 1 panas sekali, terik (of weather). t. zone daerah panas/tropis. 2 penuh berahi, bernafsu (of a love scene).
torsion	kb. pilinan, puntiran.
torso	kb. batang tubuh.
tort	kb. law : kesalahan, kerugian.
tortoise	kb. kura-kura darat.
tortuous	ks. 1 berliku-liku (of a road). 2 berbelit-belit (of a line of reasoning).
torture	kb. 1 siksaan. 2 penyiksaan. 3 penderitaan, siksaan. -kkt. menyiksa, penganiaya.
torturer	kb. penyiksa, penganiaya.
toss	kb. 1 lemparan. 2 lenggokan. -kkt. 1 melemparkan, melontarkan (a ball). 2 melambungkan.. 3 menegakkan. 4 melantunkan, memantulkan. 5 menggoyangkan selada supaya kuahnya merata (a salad).
tossup	kb. 1 inf.: kemungkinan yang sama. 2 (peng) undian.
tot	kb. anak kecil.
tot.	[total] jumlah, total.
total	kb. jumlah, total. -ks. 1 total, semesta. 2 mutlak. 3 jumlah. -kkt. 1 berjumlah. 2 menjumlahkan. 3 sl.: menghancurkan samasekali (a car). t.eclipse gerhana sempurna. -totally kk. sama sekali. he is t. blind ia buta samasekali..
totalitarian	ks. totaliter. t. state negara totaliter.
totalitarianisme	kb. totaliterisme.
totality	kb. (j. -ties) 1 keseluruhan. 2 kemutlakan (of an eclipse).
tote	kkt. inf.: menggendong, memikul.
totem	kb. gambar atau patung ukiran yang merupakan lambang suku. t. pole tiang totem.
totter	kki. berjalan terhuyung-huyung. -tottering ks. yang berjalan terhuyung-huyung (of old person).
touch	kb. 1 sentuhan. 2 sedikit. 3 suasana. 4 ketrampilan, kemahiran, kecekatan (of a surgeon). 5 agak. 6 tekanan. 7 sentuhan, goresan (of a brush).
touch-and-go	ks. tak menentu. -touched ks. inf.: sinting, edan. -touching ks. mengharukan.
touchdown	kb. 1 sport : pembuatan, pencetakan, gol. 2 av.: pendaratan.
touchiness	kb. keadaan sangat perasa, keadaan lekas tersinggung.
touchstone	kb. batu ujian.
touchy	ks. tipis telinga, bengkeng.
tough	kb. penjahat. -ks. 1 keras, liat (of meat). 2 kuat (of animals). 3 buruk (of an area). 4 kasar. 5 berat, sulit, sukar (of a job). 6 kuat (of an athlete). -kk. keras. tough-minded ks. keras hati.
toughen	kkt. menguatkan. -kki. menjadi kuat.
toughness	kb. kekerasan.
toupee	kb. rambut palsu.
tour	kb. 1 perjalanan (keliling). 2 tamasya. -kkt. mengelilingi/berkeliling di (europe). t. guide 1 buku petunjuk pariwisata. 2 pengantar tamasya, pengantar perjalanan keliling. t. of duty 1 perpindahan dalam rangka dinas. 2 mil.: pergiliran tugas.
tourism	kb. turisme, kepariwisataan.
tourist	kb. 1 kepariwisataan, turis, orang pelancongan. 2 lih motel.
tournament	kb. turnamen, pertandingan. golf t. turnamen golf.
tourniquet	kb. turniket, alat guna menghentikan perdarahan.
tousle	kkt. mengusutkan. tousled hair rambut kusut.
tout	kkt. memuji, menggebar-gemborkan. he was highly touted for... ia sangat dipuji-puji untuk...
tow	kb. 1 eretan, gandengan, tarikan. a t. of barges seeretan perahu-perahu muatan. 2 tali pengeret (for skiers). -kkt. menyeret, menunda (boat, stalled car). -towing kb. gandengan, eretan, tarikan. t. car/truck mobil penyeret/penarik.
toward(s)	ks. 1 terhadap. 2 ke arah. 3 untuk. 4 menjelang, hampir. 5 kepada.
towel	kb. 1 (h)anduk, tuala. bath t. anduk mandi. 2 lap. 3 serbet. -kki. mengeringkan badan dengan handuk.
tower	kb. menara. observation t. menara pengintai. -kki. menjulang tinggi. -towering ks. tinggi, meluap-luap.
towhead	kb. seorang yang warna rambutnya kuning pucat.
towline	kb. tali/kabel penyeret.
town	kb. kota. country t. kota kecil di pedalaman. to go into t. pergi ke kota.
townsfolk	kb. orang-orang kota.
township	kb. kotapraja.
townsman	kb. (j. -men) orang kota.
townspeople	kb., j. warga-warga kota.
towny	towny
towrope	kb. tali penyeret.
toxic	ks. mengandung racun.
toxicologist	kb. ahli (tentang racun).
toxicology	kb. toksikologi, ilmu tentang racun.
toy	kb. mainan, main-main. t. car mobil-mobilan. t. dog anjing-anjingan. -kki. memepermainkan (beads).
toyshop	kb. toko mainan.
tpk(e)	[turnpike] jalan raya lintas.
tr.	1 [transitive] transitip. 2 [translation] terjemahan.
trace	kb. 1 bekas. 2 jejak (of animals). 3 sedikit. 4 tali-temali. -kkt. mencari (a lost package). 2 menjiplak, meniru (s.t. on paper). 3 mengikuti jejak (animals). 4 menyusut. 5 mengikuti asal (a phone call). 6 menemukan. 7 mencatat. -tracing kb. jiplakan.
tracer	kb. pengusutan (for a missing person, letter). t. bullet peluru bercahaya/(ber)api.
trachea	kb. batang tenggorokan.
trachoma	kb. trakhom(a).
track	kb. 1 rel. to jum the t. keluar rel. 2 jejak, bekas (animal, human). 3 jalan (of a hurricane). 4 olahraga lari. 5 jurusan. -kkt. 1 mengikuti jalan (a satellite). 2 membawa. -tracking kb. pekerjaan mengikuti jalan (hurricanes, satellites).
tracker	kb. 1 pemburu binatang (of animals). 2 alat untuk mengikuti jejak (of satellite).
tract	kb. 1 bidang. t. of land bidang tanah. 2 brosur, buku kecil, risalat. 3 sistim. respiratory t. sistim pernapasan. digestive t. alat pencerna makanan.
tractable	ks. 1 penurut, ta'at (of a child or dog). 2 mudah dikerjakan (of metals).
traction	kb. 1 daya tarik. 2 tenaga tarik. electrik t. tenaga tarik listerik.
tractor	kb. traktor. tracktor-trailer mobil gandeng(an) yang ditarik traktor.
trade	kb. 1 perdagangan. 2 kejuruan, ketrampilan. 3 pembeli, langganan. 4 tukar-menukar. trade-in kb. penukar-tambah. -trading kb. perdagangan.
trademark	kb. cap/merek dagang.
trader	kb. pedagang.
tradesman	kb. (j. -men) pedagang, saudagar.
tradition	kb. tradisi.
traditional	ks. tradisionil.
traffic	kb. 1 lalu-lintas. t. is heavy lalu-lintas sangat ramai. 2 perdagangan. -kki. to t. in berdagang/menjual-beli.
tragedian	kb. 1 pelaku lakon sedih. 2 penulis cerita sedih.
tragedienne	kb. pelaku wanita lakon sedih.
tragedy	kb. (j. -dies) 1 tragedi, lakon sedih, cerita sedih. 2 tragedi, kejadian yang menyedihkan, peristiwa yang sedih.
tragic	ks. tragis.
trailblazer	kb. pelopor, perintis, pembuka jalan.
trailer	kb. 1 rumah gandengan. 2 (kereta) gandengan. 3 pilem yang memperkenalkan pilem yang akan datang.
train	kb. 1 kereta api. 2 pancung (of a dress). 3 deretan. 4 gerombolan. 5 ekor (of a come). 6 jalan. 7 rentetan. -trained ks. terlatih. -training kb. 1 latihan. 2 pendidikan.
trainee	kb. siswa/pengikut latihan.
traineeship	kb. kedudukan sebagai siswa latihan.
trainer	kb. 1 sport : pelatih (of animal). 2 penggembleng. the army is a t. men angkatan darat merupakan penggembeleng bagi orang-orang lelaki.
trainload	kb. sekereta-api penuh.
trainman	kb. (j. -men) 1 pegawai kereta api. 2 pekerja/karyawan kereta-api.
traintime	kb. waktu berangkat kereta api.
traipse	kki. inf.: berjalan kesana-kesini tak tentu arah. to t. through a yard berjalan-jalan tanpa tujuan/tanpa maksud tertentu melewati halaman.
trait	kb. ciri, sifat. character t. ciri pembawaan.
traitor	kb. penghianat. to turn t. menjadi penghianat.
traitorous	ks. bersifat khianat. t. deed perbuatan penghianatan.
trajectory	kb. (j. -ries) jalan/lintasan peluru.
tram	kb. trem (listrik).
trammel	kkt. mengungkung, mengekang.
tramp	kb. 1 orang gelandangan, petualang. 2 derap langkah, celam-celum (of marchers). 3 inf.: wanita "p", pelacur. 4 perjalanan kaki (through the woods). -kkt.,kki berjalan kaki.
trample	kkt. menginjak-injak. to t. s.o. to death menginjak-injak seseorang sampai mati.
trampoline	kb. kain layar yang direntang diatas tanah untuk menampung jatuhnya akrobat-akrobat.
trance	kb. keadaan tak sadarkan diri. she went iinto a t. ia kerasukan, ia tak sadarkan diri. he was like a man in a t. ia seperti seorang yang lupa daratan.
tranguility	kb. kesentosaan, ketenangan.
tranguilize	kkt. menenangkan, meredakan.
tranguilizer	kb. obat penenang.
tranquil	ks. tenang, hening, sentosa.
trans.	1 [transitive] transitip. 2 [translation] terjemahan. 3 [translated] diterjemahkan.
transact	kkt. mengadakan/melakukan transaksi (business).
transaction	kb. 1 transaksi (of business). 2 notulen, catatan.
transatlantic	ks. melintasi samudera atlantik, transatlantik.
transcend	kkt. melebihi, lebih penting dari. national interests t. personal feelings kepentingan-kepentingan nasional lebih penting daripada perasaan-perasaan pribadi.
transcendent	ks. sangat, teramat. of t. importance sangat penting.
transcendental	ks. 1 sangat, teramat. 2 sukar dipahamkan, diluar pengertian dan pengalaman manusia biasa.
transcontinental	ks. antar-benua, melintasi benua.
transcribe	kkt. 1 menulis catatan dengan tulisan biasa. 2 merekam. 3 menuliskan. to t. a word phonemically menuliskan sebuah kata secara fonemis.
transcript	kb. catatan (kata demi kata). academic t. turunan angka-angka akademis.
transcription	kb. rekaman, turunan, tulisan. to make a t. membuat rekaman. phonetic t. tulisan fonetik.
transfer	kb. pergantian (replacement). 2 karcis untuk ganti trem atau bis. 3 serah-terima (of command). 4 pemindahan. 5 pemindahan/pengiriman (of funds). -kkt. (transferred) 1 memindahkan . 2 memindah-tangankan. 3 menyerah-terimakan (command,power) 4 memindahkan.
transferable	ks. dapat dioperkan. "not t." tidak dapat dioperkan.
transference	kb. pemindahan (of power).
transfiguration	kb. perubahan rupa atau bentuk.
transfigure	kkt. merubah rupa atau roman.
transfix	kkt. 1 menombak, menusuk (dengan tombak). 2 memancangkan, menancapkan. to t. s.o. with a spear memancangkan tombak kepada seseorang. 3 membuat terpaku (from terror).
transform	kb. perubahan/pergantian bentuk. -kkt. 1 mengubah (bentuk), menjelmakan. 2 merobah. to t. heat into energy merobah panas menjadi tenaga.
transformation	kb. perubahan (bentuk), transformasi (into menjadi).
transformer	kb. transformator, trafo.
transfusion	kb. transfusi, pemindahan. blood t. transfusi/pemindahan darah.
transgress	kkt. melewati, melampaui. to t. the accepted bounds melanggar batas-batas yang diterima.
transgression	kb. pelanggaran (hukum).
transgressor	kb. pelanggar, orang yang berdosa.
transient	kb. orang pemondok sementara. t. hotel hotel yang didiami untuk sementara waktu saja.
transistor	kb. transistor. t. radio radio transistor.
transistorize	kkt. memperlengkapi dengan transistor. transistorized radio yang memakai transistor.
transit	kb. 1 teodolit. 2 transito, dalam perjalanan. 3 pengangkutan. -kkt. melintasi.
transition	kb. peralihan, transisi. period of t. masa peralihan, pancaroba.
transitive	kb. katakerja transitip. -ks. transitip, berlengkap.
transitory	ks. fana, tidak kekal.
transl.	1 [translated] diterjemahkan. 2 [translation] terjemahan.
translatable	ks. dapat diterjemahkan.
translate	kkt. 1 menterjemahkan, mengalihbasakan (a book). 2 mewujudkan.
translation	kb. 1 terjemahan (of book). 2 (translating) penterjemahan.
translator	kb. penterjemah, alihbahasa.
transliterate	kkt. menyalin huruf dari satu abjad ke huruf abjad lain.
transliteration	kb. penyalinan huruf dari satu abjad ke huruf abjad lainnya.
translucent	ks. tembus cahaya.
transmigrant	kb. transmigran.
transmigrate	kki. berpindah (to ke). to t. into berpindah kedalam (of a soul).
transmigration	kb. transmigrasi, perpindahan, pemboyongan.
transmission	kb. 1 pengiriman (of a message). 2 penularan, penyebaran, penjangkitan (of a disease). 3 auto.: persneling. t. belt pita/tali mesin.
transmit	kkt. (transmitted) 1 mengirimkan (a message, money). 2 menjangkitkan, menularkan, menyebarkan (disease). 3 meneruskan, membawa.
transmittal	kb. pengiriman.
transmitter	kb. pemancar.
transmutation	kb. perubahan.
transmute	kkt. mengubah.
transoceanic	ks. melintasi samudera. t. crossing penyebrangan samudera.
transom	kb. jendela (kecil) diatas pintu.
transparency	kb. (j. -cies) 1 sifat tembus (of material). 2 kelemahan (of an argument).
transparent	ks. 1 jernih, tembus cahaya (of glass). 2 nyata, jelas (of a lie).
transpire	kki. terjadi, berlangsung.
transplant	kb. pencangkokan, cangkok. heart t. pencangkokan/cangkok jantung. -kkt. 1 memindahkan (flowers, a family). 2 mencangkok (an organ, skin).
transplantation	kb. pencangkokan, transplantasi.
transport	kb. 1 pengangkutan. t. company perusahaan pengangkutan. 2 angkutan. 3 kapal pengangkut. -kkt. 1 mengangkut (s.t.). 2 membuat sangat gembira. t. plane pesawat pengangkut.
transportation	kb. 1 pengangkutan. 2 kendaraan.
transpose	kkt. 1 mengubah urutan. 2 mus.: mengubah nada.
transposition	kb. perubahan.
transship	kkt. memindahkan dari satu alat pengangkut ke alat pengangkut lain.
transshipment	kb. pemindahan dari satu alat pengangkut ke alat pengangkut lain.
transverse	kb. garis melintang/potong.
transvestite	kb. orang banci, wadam, orang papak.
trap	kb. perangkap. to lay/set a t. memasang perangkap. 2 lekukan (in a pipe). 3 sl.: mulut. -kkt. (trapped) 1 menjerat, menangkap dengan perangkap (animals). 2 menjebak.
trapeze	kb. rekstok gantung.
trapezoid	kb. segi-empat yang dua sisinya sejalan.
trapper	kb. penjebak, pemasang perangkap/jerat.
trappings	kb., j. hiasan-hiasan.
trash	kb. 1 sampah. the t. is collected today sampah diangkut hari ini. 2 barang rosokan, barang yang tidak berharga. 3 rosokan (of a book, magazine).
trashy	ks. tak bermutu, rosokan.
trauma	kb. luka berat.
traumatic	ks. yang berhubungan dengan luka. t. experience pengalaman menggoncangkan jiwa, pengalaman yang dahsyat.
travel	kb. perjalanan. t. book buku (kisah) perjalanan. -travels j. perjalanan-perjalanan. -kkt. melalui. -kki. 1 mengadakan perjalanan. 2 bepergian. 3 berjaja, berkeliling (for a film). 4 berjalan. 5 pergi. 6 melintas. 7 menempuh.
traveler	kb. 1 orang bepergian, pelancong. 2 wisatawan. 3 (moslem) musafir. traveler's check cek perjalanan/turis.
travelogue	kb. ceramah tentang perjalanan.
traverse	kb. garis melintang. -kkt. melintasi, melewati.
travesty	kb. (j. -ties) 1 parodi, karikatur. 2 ejekan. t. of justice ejekan terhadap keadilan.
trawl	kb. pukat, jaring ikan. -kki. memukat, menjaring.
trawler	kb. kapal pemukat, kapal penarik pukat, kapal pukat ikan.
tray	kb. baki, talam, dulang, penampan.
treacherous	ks. 1 khianat, curang (of a person). 2 berbahaya. t. shoals beting-beting yang berbahaya.
treachery	kb. (j. -ries) penghianatan.
tread	kb. 1 tapak, telapak(an) (on a tire). 2 langkah-langkah (of feet). 3 anak-anak tangga (on stairs). 4 telapak (on rubbers shoes). -kkt. (trod, trodden atau trod) 1 menempuh (a path). 2 menginjak-injak (grapes, water). -kki. to t. on menginjak.
treadle	kb. pedal, tempat injakan kaki.
treadmill	kb. 1 semacam alat jentera yang dijalankan dengan menginjak-injaknya. 2 pekerjaan yang membosankan.
treas.	1 [treasurer] bendahara. 2 [treasury] perbendaharaan.
treason	kb. penghianatan.
treasonable	ks. berkhianat, bersifat khianat.
treasonous	ks. berkhianat.
treasure	kb. 1 harta benda. buried t. harta terpendam/karun. 2 sesuatu yang berharga. -kkt. menghargai (s.o.'s friendship). t. house tempat simpanan barang-barang yang berharga.
treasurer	kb. bendaharawan.
treasury	kb. (j. -ries) 1 perbendaharaan. 2 bunga rampai.
treat	kb. 1 sesuatu yang menyenangkan. 2 sungguhan. -kkt. 1 memperlakukan. 2 merawat (a cut). 3 menghilangkan. 4 mengobati. 5 mentraktir. 6 membeicarakan tentang. -kki. membayar, mentraktir.
treatise	kb. risalat.
treatment	kb. 1 perlakuan. 2 cara untuk mengobat, pengobatan (for a cold). 3 laporan, reportase. 4 cara memperlakukan (of the main character). 5 perawatan.
treaty	kb. (j. -ties) perjanjian, pakta.
treble	kb. suara soprano. -ks. tiga kali (l9pat). -kkt. melipat-tigakan.
tree	kb. pohon. a t. sebatang pohon. up a t. 1 dipuncak pohon. 2 inf.: dalam keadaan sulit, dalam kesulitan. -kkt. memburu, mengejar, naik keatas pohon (of an animal).
treelined	ks. berpinggiran pohon-pohon (street).
treetop	kb. puncak pohon.
trek	kb. perjalanan. -kki. (trekked) 1 melakukan perjalanan. 2 lekas berangkat. to t. down to the office (lekas) berangkat ke kantor.
trellis	kb. terali, jari-jari.
tremble	kb. getaran (in o's voice). -kki. 1 menggigil, gemetar (of a person). 2 bergetar. the house trembled from the wind rumah itu bergetar karena angin.
tremendous	ks. 1 hebat sekali, mahahebat, dahsyat. 2. besar. -tremendously kk. amat, sangat, dengan hebat/dahsyat. t. successful sangat sukses/berhasil sekali.
tremor	kb. 1 gemetaran, getaran (in the voice). 2 (earth) gempa bumi.
tremulous	ks. yang gemetar. t. voice suara yang gemetar.
trench	kb. 1 parit. 2 mil.: parit perlindungan t. coat jas hujan (tentara). t. mouth semacam penyakit mulut.
trenchant	ks. tajam (reply).
trend	kb. 1 kecenderungan. 2 jurusan, arah gejala, jalan. -kki. cenderung (towards kepada).
trepidation	kb. ragu-ragu bercampur takut. i accepted the post with some t. agak gentar aku menerima jabatan itu.
trespass	kb. 1 kesalahan, dosa. 2 pelanggaran, penyalahgunaan (on s.o.'s kindness). -kki. 1 masuk tanpa izin. 2 manyalah-gunakan.
trespasser	kb. pelanggar, penyalah-guna.
tress	kb. ikal (rambut) tresses j. rambut (wanita).
trestle	kb. 1 rr.: jembatan (dari batang-batang besi atau kayu). 2 carp.: kuda-kuda.
triad	kb. tritunggal, tiga serangkai.
trial	kb. 1 pemeriksaan pengadilan. 2 percobaan. 3 godaan. on t. sedang diadili. 2 sebagai percobaan. t. lawyer pengacara.
triangle	kb. 1 segitiga. 2 mus.: kerincing.
triangular	ks. bersegitiga. t. shape bentuk segitiga.
triangulation	kb. triangulasi.
tribal	ks. mengenai suku. t. customs adat-adat suku/kesukuan.
tribe	kb. suku(-bangsa), rumpun.
tribesman	kb. (j. -men) anggota suku.
tribulation	kb. kesengsaraan, godaan.
tribunal	kb. pengadilan.
tribune	kb. mimbar.
tributary	kb. (j. -ries) 1 geog.: anak sungai. 2 jajahan, pembayar upeti.
tribute	kb. 1 upeti. 2 penghormatan, penghargaan.
trice	kb. in a t. sekejap mata.
trichinosis	kb. penyakit yang disebabkan cacing pita babi.
trick	kb. 1 akal, muslihat. 2 permainan, tipu musliaht (of cards). 3 seluk-beluk, cara. 4 bridge : tarikan kartu. 5 giliran. 6 inf.: gadis. 7 maksud, hasil. -ks. lemah. -kki. memperdayakan, menipu.
trickery	kb. (j. -ries) penipuan, tipu daya.
trickle	kb. 1 sedikit, aliran kecil (of goods). 2 cucur. -kki. menetes (of tears, water).
trickster	kb. penipu.
tricky	ks. 1 licin, penuh akal (of a person or animal). 2 rumit (of a problem). thatt's a t. question itu sebuah pertanyaan yang mengandung muslihat.
tricolor	kb. triwarna (bendera perancis, belanda).
tried	lih try.
triennial	kb. tiap tiga tahun. -ks. tiga tahunan. t. report laporan tigatahunan.
tries	lih try.
trifle	kb. barang sepele, sesuatu yang tak berharga. -kkt. membuang-buang. -kki. menyia-nyiakan. -trifling ks. 1 (no-good) suka membuang-buang waktu. 2 (unimportant) ramah-tamah.
trig	kb. sl.: trigonometri, ilmu ukur segitiga.
trigger	kb. pelatuk, picu. to be quick on the t. 1 cepat menembak. 2 cepat bertindak. -kkt. mencetuskan, menggerakkan (a revolt, a successful compaign). trigger-happy ks. keburu/gatal menembak.
trigonometry	kb. (j. -ries) trigonometri, ilmu ukur segitiga.
trilateral	ks. segitiga, trilateral (of an agreement, geometric figure).
trilingual	ks. (menguasai) tiga bahasa.
trill	kb. bunyi (ber)getar (of a bird, of a sound). -kkt. menggetar (an "r"). -kki. 1 meragam/menyanyi/berlagu (of a bird). 2 bernyanyi dengan suara getar.
trillion	kb. trilyun.
trilogy	kb. (j. -gies) karangan tiga-serangkai, trilogi.
trim	kb.1 garis hiasan. 2 keseimbangan (of a ship). 3 keadaan, kondisi. 4 potong sedikit. -ks. langsing, ramping (of s.o's figure). -kkt. (trimmed) 1 memangkas (hair, shrubbery). 2 menghias(i) (a christmas tree). 3 memotong (o's nails) . 4 mengalahkan.
trimmer	kb. penghias. window t. penghias jendela (pajangan).
trimness	kb. kelangsingan, kerampingan (of figure).
trinity	kb. (j. -ties) trinitas, tritunggal. (holy) t. trimurti.
trinket	kb. perhiasan kecil.
trio	kb. trio, kelompok tiga orang. string t. trio pemain gesek. vocal t. trio penyanyi.
trip	kb. 1 perjalanan. 2 sl.: melawat ke alam mimpi/khayal (lsd). -kkt. (tripped) 1 menyebabkan tersandung. 2 menjegal/mengait kaki (s.o). 3 menjebloskan. -kki. 1 tersandung. 2 membuat kekeliruan.
tripartite	ks. tiga pihak. t. agreement persetujuan antara tiga pihak.
