cuka	vinegar.
cukai, cuke	1 (customs) duty, toll, tax. 2 excise duty. 3 tariff.
cuki	1.game of draughts. 2. (vulg.) have sexual intercourse.
cukil	see cungkil.
cukin	bib.
cukit	1 pick. 2 fork (for eating0.
cukong	1 well-to-do financier, financial backer. 2 capitalist (engaged in illegal practices). 3 broker, wholesale distributor.
cukongisme	a mode of (often illegal) cooperation between authorities and (us. china) financiers.
cukulele	ukulele.
cukup	1 enough, sufficient, adequate. 2 exactly, precisely. 3 well-to-do, prosperous. 4 complete. 5 quite, rather.
cukur	1 razor, shaver. 2 tonsure.
cula	rhinoceros horn.
culan	k.o. shrub, the flowers of which are used to perfume tea and clothes.
culas	1. 1) lazy, indolen. 2) slow, plodding, poky. 3) clumsy, awkward. 2. deceitful, dishonest, not straightforward.
culik	men-culik kidnap, abduct.
cuma	1 only, merely. 2 only, but.
cuman	(coll.) only.
cumbu	1 flattery. 2 sweet talk, honeyed words. 3 joke, jest, good-natured banter.
cumi-cumi	1. squid. 2. 1) evildoer, criminal. 2) traitor. 3 enemy spy.
cumlaud	(kumlot) with distinction (esp. of academic achievements).
cumpang-camping	see compang-camping.
cun	1. inch. 2. (child language) kiss.
cunam	pliers, pincers.
cunang-cuning	time at random.
cuncum	k.o. cone-shaped pastry with sweet filling.
cunda	see cucunda.
cundang	1. defeat. 2. incite, instigate, foment.
cundrik	k.o. small kris.
cunduk	large pin for holding a chignon in place.
cung	1. (java) laddy, sonny, aterm of address. 2. k.o. machine gun.
cungap	pant, gasp (for breath).
cungkil	crowbar, lever.
cungkilan	chunks peried from s.t. (coconut, etc.)
cungkup	dome or cover over grave.
cunguk	see cecunguk.
cungul	see congol.
cungur	see jungur.
cuosangiin	indonesian advisory body assisting the japanese occupation.
cup	1. smack (of kiss). 2. that is mine ! (assertive exclamation).
cupai	neglect, ignore.
cupak	1. a measure of volume, esp. for rice. 2. bowl (of an opium pipe).
cupang	(coll.) love-bite, hickey.
cupar	1. deride, sneer at. 2. a man who is stingy and a busybody in the kitchen.
cupat	/cupet/ 1 inadequate, short, insufficient, skimpy. 2 shortsighted. 3 petty, narrow, bigoted.
cuping	ear lobe.
cuplak	see celupak.
cuplik	pick out a small portion.
cupu	/cupu-cupu/ 1 box for pills. 2 posthole, hole for mast.
cupul	too short.
cur	sound of spouting.
cura	joke, jest.
curah	men-curah fall (of rain).
curai	1 loose, detached, apart. 2 clear, evident, real.
curam	steep, precipitous, sheer, abrupt (cliff, abyss, etc.).
curang	dishonest, fraudulent, deceitful.
curat	spout, nozzle. men-curat gush out, spew forth, spout.
curat-coret	see corat-coret.
cureng	deep-socketed (of eyes). ny- (nyureng) (java) put on serious face, frown.
curi	1 steal. 2 surreptitious.
curiga	suspicious, distrusful.
curu-curu	diarhea or dysentery.
curuk	(java) waterfall.
cus	sound of fizzing or sizzling (i.e. water poured on a fire).
cutbrai	/cutbray/ see celana.
cuti	leave, furlough.
cuwil	see cuil.
cv	(commanditaire vennootschop) limited partnership.
d	d, the 4th letter of the alphabet.
d-1	(diploma satu) o.-year diploma program.
d-2	(diploma dua) two-year diploma program.
d-3	(diploma tiga) three-year diploma program.
d.	(danau) lake.
d.a.	(dengan alamat) c/o., in care of.
d/p	(dengan perantaraan) via s.o.
da	1. (china) at, on, in. 2. daa, daag (coll.) goodbye.
da'wa	see dakwa.
da'wah	see dakwah.
dab	men-dab dub a film.
dabing	dubbing.
dabung	(lit.) ber-, men- file teeth (for aesthetic or religious reasons).
dabus	see debus 2.
dacin, dacing	k.o. portable balances scale. men-dacin weigh items with such a scale.
dada	1 chest, thorax. 2 bosom.
dadah	1. medicine, medicinal herb. 2. (coll.) wave goodbye, bye-bye.
dadak	men-dadak sudden.
dadal	fall down or burst apart (as of dike or dam).
dadap	flowering trees of erythrina spp.
dadar	1 fry a mixture spread into a pan. 2 omelette.
dadih	(lit.) fermented water buffalo milk.
dadu	1. 1) dice. 2) cube. 2. pink, light brownish-red.
daduh	/dadung/ 1. (lit.) sing a lullaby. 2. (java, sunda, naut.) hawser.
daeng	(makassar) 1 tittle of rank in s. sulawesi. 2 respectful term of address for pedicab drivers.
daerah	1 territory, esp. the size of a province. 2 area, region. 3 outlying district. se-daerah from the same region.
daerahisme	provincialism.
daftar	1 list, roster. 2 (pol.) slate.
dag-dig-dug	sensation rapid heartbeat (caused by fear, anxiety, etc.).
daga	1. (m) resistance, civil unrest. 2. see dahaga.
dagang	1. from outside the region. 2. trade, commerce. 3. men-dagang carry on shoulder.
dagel	men-dagel joke, clown about.
dagelan	1 joking, clowning. 2 short humorous skit.
dagi	see dahagi.
daging	1 meat. 2 flesh.
dagu	chin.
dah	1. see deh. 2. see da 2. 3. see sudah.
dahaga	1. thirst. 2. 1) opposition. 2) subordination.
dahagi	oppose orders.
dahak	phlegm, sputum.
daham	see deham.
dahan	bough, branch.
dahar	(java) eat (referring to respected person).
dahi	forehead, brow.
dahlia	dahlia.
dahsat, dahsyat	1 horrifying, terrifying. 2 awe-inspiring, imposing.
dahulu	(lit.) previous.
dahyang	(java) guardian spirit.
dai	(islam) 1 proselytizer. 2 revival mullah.
daidan	(japanese) battalion.
daidancho, daidanco	(japanese) battalion commander.
daif	1 weak, powerless. 2 incompetent.
daim	(islam) eternal, enduring.
daing	dried fish or meat.
dajal	1 (islam) a being of the days preceding the last judgment who tempts humans to evil, esp. licentious activities. 2 (islam) irreligious person who tempts others to be antireligious and licentious. 3 liar, deceiver. 4 (coll.) christian usage) k.o. devil.
dak	1. see tidak. 2. (coll.) roof. 3. sound of s.t. exploding.
dakap	see dekap 1.
dakar	1. stubborn, obstinate, hardheaded. 2. see zakar.
dakep	see dekap 1.
dakhil	1 inner life. 2 intimate.
daki	1. grime, esp. on o,'s body. 2. men-daki climb (hill, mountain).
dakocan	/dakocang/ 1 k.o. black inflatable doll. 2 defamatory nickname for malaysia (1960s).
dakon	game played on board with depressions to be filled with cowrie shells.
dakron	dacron.
daksa	1 skilled, able. 2 proper.
daksina	(lit.) 1 right side. 2 south.
daktiloskopi	dactylography.
daktur	see redaktur.
daku	(lit.) me.
dakwa	charge, accusation, indictment.
dakwah	religious proselytizing, missionary endeavor.
dal	(java) 5th in series of eight years.
dalal	1 go-between, intermediary. 2 agent, broker.
dalam	1 interior, inside. 2 in, within. 3 deep. 4 thoughtful, serious, deep.
dalang	1 narrator and puppeteer of traditional shadow plays. 2 matermind, power behind the scenes.
dalem	1. (java) 1) residence of high official, palace of king. 2) tittle for person who possesses such a residence. 2. see dalam.
dalfin	dolphin.
dalih	excuse, pretext.
dalil	1 (islam) argumentation. 2 proposition, theorem.
dalu	(java, sunda, jakarta) ripe.
daluwarsa	1 overdue, expired.
dam	1. 1) checkers. 2) checkered (design) 2. sound of thump of drum. 3. (china) greedy. 4. dam.
damai	peace, tranquillity.
damak	blowpipe dart.
daman	(naut.) sheet (of large sail).
damar	1 resin of certain trees collected as an article of trade. 2 resin torch.3 oil lamp.
damast	damask.
damba	long , yearn.
damban	see lamban.
dambin	sound of thud, plop, or thump.
dambun	sound of sonorous thud.
dame	see damai.
damen	(java) rice straw.
dami	see damai.
damir	symbol in arabic script to indicate closed syllable.
dampak	impact. bump into, collid with.
dampar	men-dampar 1 cast s.t. ashore. 2 break (of nerves).
damping	close, near. contiguous, side by side.
damprat	abuse, scolding.
damsyik	damascus.
dan	1. and. 2. particle requesting confirmation, right ? 3. (sort) ranking.
dana	1 donation. 2 fund.
danau	lake.
danawa	ogre.
dandan	1. grooming, personal embellishment. 2. (lit.) additional platform on a ship's deck.
dandang	1. large metal vessel for steaming rice. 2. (lit.) cormorant.
dandi	1 (lit.) k.o. drum. 2 (bib.) k.o. lyre.
dang	(lit.) title for female nobility.
dang dang dut, dangdut	1 beating of drums (in indian movies). 2 popular music with strong beat reminiscent of hindi and arabic music. 3 dance to such music.
dangai	k.o. cake.
dangau	1. loom up. 2. small temporary hut in agricultural fields.
dangir	(java) men-dangir (i) hoe before planting.
dangkal	1 shallow. 2 superficial (of knowlwdge, etc.).
dangkung	k.o. leprosy.
dangsa	see dansa.
danguk	ber-, men-, ter- sit with chin in hands and stare.
danramil	(komandan rayon militer) commander of the army administrative unit at the level of the camat.
dansa	western-style dance.
dansanak	(m) relative, kin.
dansi	see dansa.
danta	(lit.) elephant tusk, ivory.
danu	/danuh/ (zod.) sagittarius.
dapat	1 can, be able. 2 may. 3 get, obtain. be obtained. 5 be found.
daptar	see daftar.
dapur	1 kitchen, galley. 2 stove, kiln. 3 firebox (in furnace, locomotive). 4 (coll.) place where s.t. other than food is cooked up.
dar	sound of loud crash or explosion.
dara	1. virgin, young girl. 2. see burung.
darab	(math.) multiplication.
darah	blood.
darajat	see derajah.
daras	men-daras 1 (islam) recite the koran. 2 study, investigate deeply.
darat	1 land, shore. 2 upland, hinterland.
dari	1 from. 2 (coll.) of. 3 out of (a series). 4 starting at or from. 5 than.
daripada	1 (lit.) from. 2 than. 3 better than.
darma	(lit.) 1 duty, obligation. 2 service, good deed.
darmabakti	volunteer work, service of value to the state.
darmasiswa	(lit.) student scholarship, fellowship.
darmatamu	(lit.) leadership grant.
darmawisata	1 excursion, outing. 2 field trip.
darmawisatawan	excursionist.
darsana, darsono	see jambu.
daru-daru	k.o. tree used for commercial timber.
darulbaka	(islam) the hereafter.
darulfana	(islam) present transitory world.
darun	se-darun in unison.
darurat	emergency.
darus	see daras.
darusalam	1 jerusalem. 2 (lit.) abode of happiness.
darwis	dervish, fakir.
das	boom (of gun), bang (of gun).
dasa	(lit.) inintervals of 10.
dasadarma	the 10 duties of indonesian boy scouts.
dasalomba	decathlon.
dasar	1 base, foundation. 2 basis. 3 nature. 4 (so-and-so) is like that because that is the way people of his or her type are. 5 background.
dasariah	basic.
dasasila	the ten commandments.
dasawarsa	decade, decennial.
dasi	necktie.
daster	1 house dress, lounging grown. 2 doctor's lab coat.
dasun	(lit.). k.o. garlic.
daswati	(daerah swatantra tingkat) autonomous administrative region (pre-1970s).
data	data. men-data encode for processing (on computer).
datang	1 come. 2 arrive.
datar	1 flat, level, smooth. 2 superficial.
dati	(daerah swantantra tingkat) autonomous administrative region.
datu	(in some region only) title of headman.
datuk	1 oldest male of family clan, headman. 2 grandfather (in some parts of indonesia and malaysia). 3 honorific term of reference and address (for strangers, dangerous animals). 4 term of adress to persons in high positions, us. as tuk or to.
dauk	1 gray. 2 roan.
daulat	(lit.) 1 good fortune. 2 expression of deference to nobility.
daun	1 leaf. 2 playing card. 3 balade or other flat thing.
daur	1 cycle (of years). 2 rotation.
dawai	fine wire. dawai-dawai strings (for musical instruments).
dawat, dawet	1. ink. 2. cold drink made from rice or arrowroot flour, coconut milk and palm sugar.
dawuh	(java) order, command.
daya	1. 1) power, energy, capacity. 2) effort. 2. trick, ruse. 3. see barat.
dayah	1 foster mother. 2 wet nurse.
dayak	1 native ethnic groups of kalimantan. 2 (coll.) american indian.
dayang	(lit.) lady-in-waiting.
dayu	men-dayu rumble like distant thunder.
dayung	1 oar. 2 pedal (bicycle).
db	(drum band) marching band.
db.	(di bawah) below, under, beneath.
dbb	(daerah bebas becak) area in which pedicabs are not allowed to operate.
dbp.	(di bawah pimpinan) under the direction of (referring to bands).
de facto, de fakto	de facto.
debak	sound of thud, esp. blow hitting the mark.
debam	sound of heavy object falling with resonant thud (such as coconut falling to ground).
debap	sound of object hitting ground.
debar	sensation of pulse beat.
debarkasi	debarkation.
debas	sound of exhaling.
debat	debate, discussion.
debet	debit.
debik	sound of a goat bleat.
debil	mentally retarded, psychologically unstable.
debing	sound of light object falling.
debirokratisasi	debureaucratization.
debit	rate of flow, discharge (of water).
debitor	debtor.
deboasasi	deforestation.
debos	(coll.) nge-debos boasting.
debu	dust, grit.
debuk	sound of thud.
debum	sound of muffled blow (such as when striking mattress).
debung	sound of resonant blow such as drum beat.
debup	sound of light object falling.
debur	1 sound of splashing (object falling into water, surf, etc). 2 pounding of heart.
debus	1. sound whistling, sound of howling wind. 2. ritual display of invulnerability in west java.
debut	sound of light popping (e.g. breaking wind).
decak	sound of click, esp. of tongue to express astonishment, enjoyment, etc.
decap	sound of smacking o.'s lips.
deceh, decih	sound of clicking with tongue and teeth to express disapproval, tsk tsk.
decing	sound of light metallic ringing.
decit	sound of chirp (of chicks, etc.).
decur	sound of water spraying.
dedah	exposed, uncovered.
dedak	mixture of rice and bran, by-product of milling used as animal feed.
dedangkot	see dedengkot.
dedas	sound of crackling of small arms.
dedau	men-dedau cry out loudly, scream.
dedaunan	foliage, leaves.
dede	see dideh.
dedek	(java, jakarta) see dedak.
dedel	ripped. rip out (a seam, etc.).
dedemenan	(jakarta) o.'s favorite thing or person.
dedemitan	1 ghost, apparition. 2 (java) do s.t. secretly.
dedengkot	(coll.) prominent figure, big shot.
dedes	1. 1) civet cat. 2) musk. 2. men-dedes slice thinly.
dedikasi	dedication.
dedolarisasi	(fin.) removal of dollar as standard of currency valuation.
deduksi	deduction.
deduktif	deductive.
deeskalasi	de-escalation.
defaitis	(lit.) defeatist.
defaitisme	defeatism.
defensif	defensive.
defile	1 (mil.) review, march past. 2 file past (a coffin).
definisi	definition.
definitif	definitive.
defisiensi	deficiensy.
defisit	deficit.
deflasi	deflation.
defleksi	deflection.
deformasi	deformation.
degam	sound of boom, such as thunder, cannon, etc.
degan	(java) young coconut.
degap	1. sturdy, robust. 2. 1) sound of nonmetallic surface being struck. 2) heartbeat.
degar	1 sound of a surface being struck hard. 2 sound of breaking down a door.
degdeg, degdegan	sensation of pounding (of heart).
degen	(sport) foil in fencing.
degenerasi	degeneration.
degil	obstinate, headstrong.
deging	ber-deging persevere through thick and thin.
degleng	slanting (of walls of decrepit buildings).
degradasi	degradation.
degub	see degup.
deguk	sound of gurgle.
degum	sound of boom, such as cannon being fired.
degung	1 sound of gong. 2 (sunda) gamelan.
degup	sound of gulp.
degur	sound of surf.
deh	(jakarta 1 come on, please do (an urging particle). 2 oh, all right, iwill agree. 3 that is the way it is, i guarantee you.
dehem	clearing of throat.
dehidrasi	dehydration.
dehoi	see indehoi.
dek	1. (naut.) deck. 2. (coll.) blanket.
dekaden	decadent.
dekadensi	decadence.
dekah-dekah	see tawa.
dekak-dekak	abacus.
dekam	ber-men 1 be in crouching position (of cat, etc.). 2 be cooped up. 3 be incarcerated.
dekan	bamboo rat.
dekap	1. with folded arms. ber-, men- embrace, hug. 2. near. 3. noise of heartbeat.
dekar	men-dekar fight with a sword.
dekat	1 near, close by. 2 vicinity.
dekih	sound of a chuckle.
dekik	small indentation.
dekil	caked with dirt.
deking	1 protection, shelter, cover. 2 patron, protector. 3 (fin.) reserve
deklamasi	formal stylized recitation of poetry, etc.
deklamator	orator (esp. of poetry).
deklarasi	1 customs declaration. 2 voucher.
deklerer	(crd.) declarer.
deklinasi	1 (astr.) declination. 2 (ling.) declension.
dekolonisasi	decolonization.
dekon	(deklarasi ekonomi) economic declaration (enunciated by sukarno in 1963).
dekonsentrasi	decontration.
dekor	decor.
dekorasi	1 decoration, decor. 2 (mil.) medal, ribbon.
dekret	/dekrit/ decree, edict.
dekuk	work hard.
dekur	see dekut.
dekus	sound of hissing or snorting.
dekut	sound of cooing.
delah	k.o. saltwalter fish.
delapan	eight.
delegasi	delegation.
delep	(java) 1 sink, go below surface. 2 make o.s unobstrusive.
deles	pure-blooded.
deligir	delegate (power).
delik	wide-open (of eyes).
delikan	(java) game of hide and seek.
delikuensi	deliquency.
delima	pomegranate.
delman	k.o. two-wheeled buggy.
delong	sunken (of eye).
delta	delta.
delujur	see jelujur.
dema	(dewan mahasiswa) student council.
demagog	demagogue.
demagogi	demagoguery.
demah	warm compress.
demam	1 fever, feverish. 2 (coll.) fad.
deman	like, be fond of.
demang	1 village headman in java. 2 customary law expert. 3 village gvt. officer.
demarkasi	demarcation.
dembam	see debam.
dembum	see debum.
demek	moist, still wet.
demen	see deman.
demes	flat (of nose).
demi	1. 1) for the sake of. 2) by (in oaths). 2. 1) as soon as. 2) (immediately) after , by.
demikian	1 such. 2 thus, such was the case.
demiliterisasi	demilitarization.
demisioner	1 ask for resignation of a cabinet. 2 strip (of authority, power).
demit	see dedemitan.
demo	1. (delman bermotor) small motorized threewheeled vehicle used for public transportation. 2. see demonstrasi.
demobilisan	demobilized member of armed forces.
demobilisasi	demobilization.
demograf	demographer.
demografi	demography.
demografis	demographic.
demokrasi	democracy.
demokrat	democrat.
demokratis	democratic.
demokratisasi	democratization.
demokratiser	/demokratisir/ democratize.
demonstarsi	1 demonstration, protest. 2 demonstration (of cars, radios, etc.).
demonstran	participant in demonstration, protester
demoralisasi	demoralization.
demoralisir	men-demoralisir demoralization.
demotrasi	see demonstrasi.
dempak	1 low and flat. 2 stocky.
dempal	(java) physically strong.
dempang	hollow sounding (as the fall of empty barrel).
dempel	near to.
dempet,dempet	stuck together.
dempir	sound made by cymbal.
dempit	see dempet.
demplon	(jakarta) cute, pretty.
dempok,dempuk	ber-dempok bump against, collide with.
dempul	glazier's putty, boat caulking.
dempung	sound of s.t. falling into water.
den	see raden.
denah	sketch, blueprint, ground plan.
denai	trail, track (of wild game).
denak	decoy (used in hunting).
denas	(dewan nasional) national council.
dencang	ber-dencang rattle, clang.
dencing	see denting.
dencis	see sarden.
denda	fine.
dendam	1 reverenge, vengeance. 2 grudge, resentment. 3 yearning, longing.
dendang	1. crow (bird). 2. see dandang 1.
dendeng	jerked meat.
denderang	sound of drum or heavy steps.
dengan	1 with, accompanying. 2 and. 3 by, by means of. 4 in. 5 by way of. 56 in the manner of.
dengap	ber-dengap 1pound, beat (of heart). 2 pant, be out of breath, gasp (for breath).
dengar	hear.
denger	(java, jakarta) see dengar.
dengih	sound of rapid breathing or gasping.
denging	sound of ringing (in ears). ber-, men- buzz, ring (in ears).
dengkang	sound of croaking frogs.
dengkang-dengkol	crooked, bent and bowed (of hand, tree branch, etc.).
dengki	envy, spite.
dengkik	become weak from lack of food.
dengking	1 sound of dog yelping. 2 a yelp, squeal, or scream.
dengkir	men-dengkir chirp.
dengklang	lame, limping.
dengkul	(java, jakarta) knee.
dengkung	1growl (of dog). 2 sound of metal on metal.
dengkur	1 snore, snoring. 2 grunt. 3 purr.
dengkus	/dengu/ 1. whinny, snort. 2. dengu see dungu.
denguk	sound of sobbing.
dengung	sound of droning, buzzing, purring, etc.
dengus	1 snort (of animals). 2 deride with a snort.
dengut	sound of murmuring (of quail), sound of vibrating (of xylophone, gong).
denok	(java) term of address to young girl, esp as nok.
denotasi	denotation.
densitas	density.
dentam	sound of gunfire, pounding on anvil, etc.
dentang	sound of clanging or loud explosion.
dentar	clang.
denting	sound of jingle or tinkle (of money, piano, keys, etc.).
dentum	sound of boom (explosion, cannon, etc.).
dentung	sound of clap of thunder.
dentur	sound of pop, small explosion, etc. ber-, men- crackle, pop.
denudasi	denudation.
denyak	see enyak.
denyar	flash.
denyit	sound of shrieking and high-pitched noises.
denyut	throb, beat.
deodoran	deodorant.
dep	men-, menge- pigeonhole, shelve (a question).
depa	fathom.
depag	(departemen agama) department of rreligious affairs.
depak	1. akick. 2. sound of clap, clip-clop (esp. of horses'hoofs, etc.).
depan	1 fron. 2 ahead. 3 coming, next.
depang	ber-depang stretch out both arms sideways.
depap	sound of slap (i.e. palm of o.'s hand striking table, etc.).
deparlu	(departemen luar negeri) department of foreign affairs.
deparpolisasi	(pol.) simplification of political party structures, decreasing of number of political parties.
departemen	ministry.
depdagri	(departemen dalam negeri) department of internal affairs.
dependensi	1 dependency, dependence. 2 (colonial) possession.
deperdag	(departemen perdagangan) department of commerce.
depersonalisir	men-depersonalisir depersonalize.
depertan	(departemen pertanian) department of agriculture.
depinisi	see definisi.
depisen	see devisa.
depkeh	(departemen kehakiman) department of justice.
depkes	(departemen kesehatan) department of health.
depkeu	(departemen keuangan) department of finance.
deplu	(departemen luar negeri) department of foreign affairs.
depnaker	(departemen tenaga kerja) department of labor.
depnakertranskop	(departemen tenaga kerja transmigrasi dan koperasi) department of labor, population resettlement, and cooperatives (until 1978).
depo	see depot.
depok	reside.
depolitisasi	depoliticization.
deponir	men-deponir delay, put on ice.
deportasi	deportation.
deposan	depositor.
deposito	(fin.) fixed deposit (us. bearing high interest).
depot	refreshment stand.
deppen	(departemen penerangan) department of information.
depresi	financial depression.
depresiasi	(fin.) depreciation.
deprok	(me)n-1 sit on floor without folding legs. 2 (coll.) sit s.w. uninvited.
depsos	(departemen sosial) department of social services.
depteri	diphtheria.
depus	sound of sighing, exhaling air, etc.
deputasi	deputation, delegation.
deputi	deputy.
der	sound of explosion.
dera	lash (of whip), lashing.
derai	1. sound of water dripping on or beating against glass, etc. 2. grain.
derajat,derajah	1 degree. 2 rank, level. 3 standard. 4 latinate qualifiers of university degree (e.g. cum laude, etc.).
derak	sound of snap (such as tree branch breaking, gnashing of teeth, etc.).
deram	sound of rumble (thunder, tigers roar, drum roll, etc.).
derang	sound of ringing clank (chains or coins falling, of small gongs, etc.). ber-, men- make a resonant, often metalic sound.
derap	sound of stamping on flat surface (horse's) trot, marching feet, etc.), trop, clop.
deras	1. swift (esp. of flowing liquids). 2. sound of trash or sand being stepped on. 3. see daras.
derau	sound of roaring (wind-borne rain, etc.).
derek	1. crane, cargo boom. 2 see deret.
derep	men-derep harvest rice.
deres	1. men-deres tap tree to extract sap (suga palm). pen-deres tapper. 2. men-deres recite the koran.
deresi	(r.r.) passenger car.
deret	row, line, series.
deretak	sound of repeated rattling.
derhaka	see durhaka.
deriji	see jeruji.
derik	creaking sound.
deril	see dril.
dering	1 sound of tinkling (bells, etc.). 2 sound of crickets chirping.
deris	sound of rustling (of stepping on dry grass, of cutting cloth, etc.).
derit	sound of squeak (a brake, etc.).
derita	suffering.
derma	alms, donation. pen-derma donor.
dermaga	quay, pier.
dermatalog	dermatologist.
dermatologi	dermatology.
dermawan	donor, philanthropist.
dermimil	(java) 1 mumble. 2 talk incessantly.
derobos	see terobos.
dersana	see jambu.
dersik	sound of sighing or rustling (leaves in wind).
deru	sound made by storm, thunder, large trucks, planes, etc.
deruji	see jeruji.
deruk	sound of heavy object crashing.
derum	1. sound of muffled rumble (distant thunder, whir of engine). 2. see drum.
derun,derung	see derum 1.
derup-derap	sound of many footsteps.
derus,derut	sound of objects being rubbed or shifted.
derwis	/derwisy/ see darwis.
desa	village.
desah	1 sound of wheezing or huffing. 2 swishing (of leaves, etc.). 3 sigh.
desak	1. sound of crumpling paper. 2.
desapraja	see desa.
desar	sound of sizzling or hissing.
desas-desus	1 sound of hissing or whispering. 2 rumor.
desau	sound of soft rustling.
desegregasi	desegregation.
desember	december.
desentralisir	men-desentralisir decentralize.
desersi	desertion.
desertir	deserter, defector.
desik	sound of light snapping (branch breaking, etc.). ber-, men- rustle.
desimal	1 decimal. 2 decimal fracton.
desimeter	10 centimeters.
desinfeksi	disinfectant.
desing	sound of whizzing (wind blowing, shot fired, etc.).
desintegrasi	disintegration.
desir	sound of hissing, rustling, or slurping.
desis,desit	sound of hissing or sizzling.
deskripsi	description. men-deskripsi-kan describe.
deskriptif	descriptive.
despot	despot.
despotisme	despotism.
destar	java head cloth, k.o. turban.
destilasi	see distilasi.
destruksi	destruction.
destruktif	destructive.
desuk	see desak 1.
desur	sound of forceful rustling.
desus	sound of light whispering.
desut	sound of forceful blowing.
detail	see detel.
detailer	medical sales representative.
detak	sound of tapping.
detar	sound of sizzling or whirring (roasting corn, wheels turning, etc.).
detas	sound of light crackling explosion (eggshell breaking, etc.).
detasemen	(mil.) detachment.
detasering	temporary deployment to another place of work.
detasir	men-detasir (mil.) detail, detach to another unit.
detdot	sound of tooting. ber-detdot-detdot sound the horns.
deteksi	detection, discovery.
detektif	/detektip/ detective.
detektor	detector.
detel	detail.
deterjen	detergent.
determinan	determinant.
determinasi	determination, decision.
determinisme	determinism.
detik	1 sound of ticking (of clock). 2 second (unit of time), moment.
detil	see detel.
deting	sound of light twanging (i.e. of plucked guitar string, etc.).
detonator	detonator.
detus,detup	sound of light explosion (gun firing, firecracker, etc.).
devaluasi	(fin.) devaluation.
devaluir	(fin.) men-devaluir devaluate.
deviasi	deviation.
devisa	/devisen, devizen/ (fin.) foreign exchange.
dewa	god, idol.
dewan	1 council. 2 board.
dewangga	k.o. cloth design.
dewani	1 council member. 2 council.
dewasa	1 adult, of age. 2 (lit.) time.
dewasawan	a mature person.
dewata	gods.
dewe,dewek	(java) o.'s own.
dewi	1 goddless. 2 darling, beloved.
dewi-dewi	(naut.) davit.
dg.	(daeng) title in s. sulawesi.
dh.	1. (dahulu) formerly. 2. (dengan hormat) with respectful salutation (in correspondence).
dhalim	see lalim.
dharma	1. term used in names of associations. 2. see darma.
dhat	see zat.
dholim	see lalim.
di	1 in, at, on, upon (general locative preposition). 2 (coll.) at, on (temporal preposition).
di-	3d person passive verbal prefix.
dia	1 he,she. 2 (coll.) it.
diabet	diabetes.
diacon	(rel.) deacon.
diafan	diaphanous.
diafragma	/diafrakma/ (anat.) diaphragm.
diagnosa	/diagnose/ diagnosis.
diagnostik	diagnostic.
diakritis	diacritical.
dialek	(ling.) dialect.
dialektik	/dialektika/ dialectic.
dialektis	dialedtical.
dialog	/dialoog/dialogue.
diam	1. 1) silent, quiet. 2) motionless. 3) idle. 2. reside.
diameter	diameter.
diametrikal	/diametris/ diametrical.
dian	taper or oil lamp.
diancuk	(java, vulg.) dammit ! fuck you !.
diang	1. warm o.s. near the fire (esp. after childbirth). 2. see mendiang.
diare	diarhea.
diaspor	diaspora.
diat	(islam) fine imposed for failure in o.'s religious responsibilities.
didaktik,didaktis	didactic.
dideh	(java) coagulated chicken or beef blood as food.
didih	men-didih 1 boil. 2 boil, rage.
didik	1 educate. 2 bring up, raise (children).
didikan	1 education, upbringing. 2 pupil, product of a certain teacher, alumnus.
didis	1. men-didis slice thinly. 2. (java) men-didis removes nits and lice from o.'s hair.
dido,didong	1. (sl.) 1) frenchman. 2) european. 2. stubbon, obstinate. 3. k.o dance in aceh.
dies-natalis	anniversary (of educational institutions, universities, college departments, etc.).
diesel	1 (coll.) diesel motor, electric generator. 2 diesel fuel.
diet	diet.
diferensial	(math) differential.
diferensiasi	differentation.
difinisi	see definisi.
difraksi	diffraction.
difteri	diphtheria.
diftong	diphthong.
difusi	diffusion.
digdaya	(java) invulnerable.
digital	digital.
digjaya	see digdaya.
digul	boven digul, place of political exile in irian jaya during dutch period.
digulis	orang-digul o. who was exiled at boven digul.
diit	see diet.
dik	see adik.
dikau	(lit.) you.
dikhotomi	see dikotomi.
dikir	(islam) repeatedly chant part of the confession of faith, often in unison, as a form of worship.
dikit	little, small.
diklat	(pendidikan dan latihan) training and education program for gvt. and military personnel.
diko	see duko.
dikol	1 calculated, estimated. 2 collated.
dikotomi	dichotomy.
dikrit	see dekret.
diktat	written summary of lectures, often used as a university texbook.
diktator	dictator. men-i rule over (with iron hand).
diktatoris	dictatorial.
diktatur	dictatiorial gvt.
dikte	diction.
diktum	decision of a high authority.
dilak	men-dilak roll o.'s eyes.
dilalah	(java) by god's will, by chance.
dilema	dilemma.
diletan	dilettante.
diletantisme	dilettantism.
dim	1. a linear measurement, decimeter. 2. (auto.) bright headlights.
dimas	(java) term of address for younger brother.
dimensi	dimension.
dimesionir	see demisioner.
dimpit	see dempet.
dina	of low esteem, ignoble.
dinamik	dynamic.
dinamika	dynamics.
dinamis	dynamic.
dinamisasi	dynamicization.
dinamisator	dynamist.
dinamisir	men-dinamisir make dynamic.
dinamisme	dynamism.
dinamit	dynamite.
dinamo	dynamo.
dinar	1 various k.o. gold coins, now used as jewelry. 2 unit of money in middle east.
dinas	1 official (gvt.). 2 agency, department. 3 gvt. service, official duty. 4 church service.
dinasti	dynasty.
dinda	see adinda.
dinding	1 interior wall, partition. 2 buttress.
dines	see dinas.
ding	(coll.). particle that contradicts o.'s own statement.
dingdong	arcade games, esp. pinball and video.
dingin	cold.
dingkik	men-dingkik watch, spy on.
dingklik	stool, seat with no back.
dini	early.
diniyah	religious (in school names).
dioksid,dioksida	dioxide.
diorama	diorama.
diosis	diocese.
dip	(daftar isisan proyek) budget proposal for a project.
dipan	divan, sofa.
dipati	see adipati.
dipisi	see divisi.
diploma	diploma, certificate.
diplomasi	diplomacy.
diplomat	diplomat.
diplomatik	/diplomatis/ diplomatic.
direksi	management, administration.
direksi, direktris	1 directress, headmistress. 2 catholic mother superior.
direktif,direktip	directive.
direktorat	1 directorate. 2 department, division.
direktori	directory.
direktur	director, headmaster.
dirgahayu	long live ! long life.
dirgantara	sky, upper atmosphere.
diri	1. self. 2.
dirigen	musical director, conductor.
dirigir	men-dirigir direct (an orchestra).
diris	men-diris water (plants).
dirjen	(direktor jenderal) director general.
dirus	men-dirus flush with water.
dirut	(direktor utama) managing director.
dis	1. (dinas) service, agency. 2 (diskualifikasi) disqualification.
disain	design, pattern.
disainer	fashion designer.
disel	see diesel.
disembarkasi	disembarkation.
disen	see disain.
disenteri,disentri	dysentery.
disersi	see desersi.
disertasi	dissertation.
disertir	see desertir.
disharmoni	disharmony.
disiden	dissident.
disintegrasi	organizational disintegration (of parties, cabinets,etc).
disipasi	dissipation.
disipel	disciple.
disiplin	discipline.
disipliner	disciplinary.
disjoki	(coll.) disc jockey.
disket	floppy disc.
disko	discotheque. dance to disco music.
diskontinuitas	discontinuity.
diskonto	(fin.) discount.
diskotek	/diskotik/ 1 discotheque. 2 collection of phonograph records. 3 producer of music cassettes.
diskredit	discredit.
diskrepansi	discrepancy.
diskridit	see diskredit.
diskriminasi	discrimination.
diskriminatif	discriminatory.
diskualifikasi	disqualification.
diskualifisir	men-diskualifisir disqualify.
diskusi	discussion.
dislokasi	1 (med.) dislocation. 2 disturbance.
disonan	dissonant.
disonansi	dissonance.
disorganisasi	disorganization.
disparitas	disparity.
dispensasi	1 (rel.) dispensation. 2 exemption (from tax, official responsibility, etc.).
dispersi	men-dispersi-kan disperse.
disposisi	authorizing signature.
disproporsi	disproportion.
disproporsional	disproportionate.
distilasi	distillation.
distilat	distillate.
distilir	men-distilir distill.
distorsi	distortion.
distribusi	distribution.
distrik	administrative district.
ditangsel	(jakarta) stuffed to the gills.
diteksi	see deteksi.
ditektif	see detektif.
ditel	see detel.
diter.	(diterjemahkan) translated.
ditjen	(direktorat jendral) directorate general.
dito	ditto.
diunggulkan	1 be considered or proposed as superior. 2 (sport) seeded.
div.	(divisi) division.
divan	see dipan.
diversifikasi	diversification.
divide-et-impera	divide and rule.
dividen	dividend.
divisi	1 (mil.) division. 2 (bio.) phylum.
diy	(daerah istimewa yogyakarta) special district of yogyakarta.
dk	(daya kuda) horsepower.
dki	(jaya) (daerah khusus ibukota) special capital district (of jakarta).
dkk.	(dengan kawan-kawan) et al.
dl.	(dalam) in.
dleweran	(java) ooze and trickle down slowly.
dll.	(dan lain-lain) and others, etc.
dlm.	(dalam) in.
dls.,dlsh.	(dan lain sebagainya) and so forth.
dn	[ (departemen) dalam negeri ] (department) of internal affairs.
dng.	(dengan) with, by means of.
doa	(do'a) prayer.
doane	see duane.
doang,doangan	(jakarta) only, no more than.
dobel	1 double. 2 (sport) doubles.
dobelop	double-barreled rifle.
dobi	(lit.) laundryman.
dobis	caps (for toy guns).
doble	gold-plated.
dobol	1. perforated, torn. men-dobol-kan pierce, puncture. 2. see dobel.
dobrak	smashed, broken open (of door, gate, fence, etc.).
dodet	(sl.) men-dodet rip open the belly.
dodok	1. (java) squat, kneel sitting on the hams. 2. men-dodok smooth out a metal sheet by hammering.
dodol	k.o. taffy made of sticky rice, coconut milk, and palm sugar (often with durian).
dodor	ke-dodor-an loose and ill-fitting (of clothing).
dodos	plane s.t.
dodot	(java) k.o. batik wraparound worn by courtiers and bridgrooms.
dogdog	1 sound of repeated knocking (at door, etc.). 2 make such a sound. 3 (sunda) small drum.
doger	(sunda) k.o. folk dance performed by women.
dogma	dogma.
dogmatika	(rel.) dogmatics.
dogmatis	dogmatic.
dogol	1 without horns (of horned animals). 2 without combs(of fowl). 3 stupid.
doha	(islam) nonobligatory prayertime around 10 a.m.
doi	(do'i) (sl.) he or she (of o.'s lover).
dok	1. (navy) dock. 2. see dokter.
dokar	horse-drawn buggy.
doking	docking (of ship, etc.).
doklonyo	(coll.) collogne.
dokoh	1. pendant for a necklace. 2. see dukuh.
dokok-dokok	see kue.
dokter	doctor, physician, esp.
doktor	holder of doctorate.
doktoral	doctoral studies.
doktoranda	1 female holder of postgraduate degree in humanities below doctoral rank. 2 female college graduate (post-1980).
doktorandus	1 s.o. with postgraduate degree in humanities below doctoral rank (pre-1980). 2 academic degree in humanitiesequivalent to baccalaureate (post-1980).
doktrin	doctrine.
doktriner	doctrinaire.
doku	(sl.) money.
dokumen	document.
dokumentalis	documentalist.
dokumentasi	documentation.
dol	1 damaged or worn because of overuse. 2 (coll.) crazy, mad.
dolak-dalik	constantly changing, vacillating.
dolan	(java) 1 make a visit for pleasire. 2 play.
dolar	1 dollar, esp. the us currency. 2 (coll.) any gold coin. 3 k.o. round, sweet wafer.
dolarsen	(coll.) cent of us currency.
dolfin	dolphin.
dolim	see lalim.
dollar	see dolar.
dolle-mina	radical feminist.
dolog	(depot logistik) warehouse for foodstuff.
dolok	(batak) mountain.
dom	(coll.) compass.
domba	1 sheep. 2 (rel.) the congregation.
domblong	(java) open-mouthed due to surprise.
dombrong	ke-dombrong-an baggy, fitting too loose (of clothes).
domein	domain (of authority).
domestik	domestic.
domina	term of reference for female protestant minister.
dominan	dominant.
dominasi	domination.
domine	term of reference for protestant minister.
dominir	men-dominir dominate.
domino	dominoes.
domisili	(leg.) domicile.
dompak	1 ber-dompak 1) leap, jump (in fighting). 2) prance (of horses). 2. densely packed (of houses, etc.).
dompet	1 wallet. 2 relief fund (often organized by a publication).
domplang	see-saw.
dompleng	men-dompleng join, double up. pen-dompleng non paying passenger.
dompol	bunch.
don-juan	see don-yuan.
don-yuan	womanizer.
donasi	donation.
donat	doughnut.
donatir,donatur	donor, benefactor.
donau	danube river.
doncang	men-doncang jump, leap.
dondang	cradle.
donder	(coll.) scolding.
dong	1. (coll.) partical asserting that interlocutor should already know or do what o. is asserting. 2. (e. indonesia) they.
dongak	men-,ter- 1 pointed upward (of head, rifle muzzle, etc.). 2 gaze up(ward).
dongeng	1 fairy tale, legend. 2 nonsense.
dongkak	leap up.
dongkel	lever, jack.
dongkol	1. 1) resentful, acrimonious. 2) irked, vexed. 2. ex-, former.
dongkrak	(auto.) jack.
dongkrok	(java) n- dongkrok remain motionless.
dongok	1 ponderous, hulking. 2 stupid.
dongong	men-dongong stare open-mouthed.
donor	donor.
doorslag	see dorslag.
dop	1. 1) hubcap. 2) caps (for toy guns). 2. (coll.) baptism. 3. lightbulb.
dopercis,doperten	(coll.) canned sweet peas.
dopis	see dumpis.
dor	sound of gunshot.
doraka	see durhaka.
dorang	1. k.o. fish. 2. (e. indonesia) they.
doreng	(coll.) striped.
dorna	see durna.
dorong	men-dorong 1 push. 2 motivate, provide the impetus. 3 urge.
dorslag,dorslah	onionskin paper.
dortrap	k.o. bicycle with pedal brakes.
dos	1 small box. 2 carton, case.
dosa	sin.
dosen	university-level instructor.
dosin	see lusin.
dosir	dossier.
dosis	(med.) dose. men-dosos-kan determine the dosage.
dot	1. 1) nipple. 2) pacifier. 2. sound of a car horn.
dower	(java) having a drooping lower lip.
